date,match_string,total_hospitalized_symptomatic,current_intensive_care,current_hospitalized,total_quarantined,current_confirmed,new_current_confirmed,new_confirmed,total_recovered,total_deceased,total_confirmed,total_tested,cases_tested?,country_code,key,new_hospitalized_symptomatic,new_quarantined,new_recovered,new_deceased,new_tested,total_current_confirmed
2020-02-24,Abruzzo,0,0,0,0,0,0,0,0,0,0,5,,IT,IT_65,,,,,,0
2020-02-25,Abruzzo,0,0,0,0,0,0,0,0,0,0,5,,IT,IT_65,0,0,0,0,0,0
2020-02-26,Abruzzo,0,0,0,0,0,0,0,0,0,0,13,,IT,IT_65,0,0,0,0,8,0
2020-02-27,Abruzzo,1,0,1,0,1,1,1,0,0,1,33,,IT,IT_65,1,0,0,0,20,1
2020-02-28,Abruzzo,1,0,1,0,1,0,0,0,0,1,33,,IT,IT_65,0,0,0,0,0,1
2020-02-29,Abruzzo,2,0,2,0,2,1,1,0,0,2,43,,IT,IT_65,1,0,0,0,10,2
2020-03-01,Abruzzo,3,0,3,2,5,3,3,0,0,5,52,,IT,IT_65,1,2,0,0,9,5
2020-03-02,Abruzzo,3,0,3,2,5,0,0,0,0,5,52,,IT,IT_65,0,0,0,0,0,5
2020-03-03,Abruzzo,5,0,5,1,6,1,1,0,0,6,52,,IT,IT_65,2,-1,0,0,0,6
2020-03-04,Abruzzo,7,0,7,0,7,1,1,0,0,7,85,,IT,IT_65,2,-1,0,0,33,7
2020-03-05,Abruzzo,8,0,8,0,8,1,1,0,0,8,96,,IT,IT_65,1,0,0,0,11,8
2020-03-06,Abruzzo,9,0,9,0,9,1,1,0,0,9,96,,IT,IT_65,1,0,0,0,0,9
2020-03-07,Abruzzo,11,0,11,0,11,2,2,0,0,11,123,,IT,IT_65,2,0,0,0,27,11
2020-03-08,Abruzzo,14,0,14,3,17,6,6,0,0,17,163,,IT,IT_65,3,3,0,0,40,17
2020-03-09,Abruzzo,25,0,25,5,30,13,13,0,0,30,237,,IT,IT_65,11,2,0,0,74,30
2020-03-10,Abruzzo,17,9,26,11,37,7,8,0,1,38,310,,IT,IT_65,-8,6,0,1,73,37
2020-03-11,Abruzzo,17,9,26,11,37,0,0,0,1,38,310,,IT,IT_65,0,0,0,0,0,37
2020-03-12,Abruzzo,47,12,59,19,78,41,46,4,2,84,867,,IT,IT_65,30,8,4,1,557,78
2020-03-13,Abruzzo,42,14,56,27,83,5,5,4,2,89,958,,IT,IT_65,-5,8,0,0,91,83
2020-03-14,Abruzzo,51,14,65,41,106,23,23,4,2,112,1232,,IT,IT_65,9,14,0,0,274,106
2020-03-15,Abruzzo,72,28,100,28,128,22,25,6,3,137,1419,,IT,IT_65,21,-13,2,1,187,128
2020-03-16,Abruzzo,71,37,108,57,165,37,39,7,4,176,1533,,IT,IT_65,-1,29,1,1,114,165
2020-03-17,Abruzzo,94,32,126,90,216,51,53,7,6,229,1688,,IT,IT_65,23,33,0,2,155,216
2020-03-18,Abruzzo,99,41,140,109,249,33,34,7,7,263,2054,,IT,IT_65,5,19,0,1,366,249
2020-03-19,Abruzzo,181,47,228,138,366,117,122,8,11,385,2409,,IT,IT_65,82,29,1,4,355,366
2020-03-20,Abruzzo,190,48,238,184,422,56,64,10,17,449,2695,,IT,IT_65,9,46,2,6,286,422
2020-03-21,Abruzzo,185,44,229,265,494,72,80,13,22,529,3035,,IT,IT_65,-5,81,3,5,340,494
2020-03-22,Abruzzo,218,49,267,272,539,45,58,15,33,587,3375,,IT,IT_65,33,7,2,11,340,539
2020-03-23,Abruzzo,228,52,280,325,605,66,76,20,38,663,3674,,IT,IT_65,10,53,5,5,299,605
2020-03-24,Abruzzo,234,57,291,331,622,17,26,21,46,689,4294,,IT,IT_65,6,6,1,8,620,622
2020-03-25,Abruzzo,248,59,307,431,738,116,124,23,52,813,4982,,IT,IT_65,14,100,2,6,688,738
2020-03-26,Abruzzo,280,64,344,516,860,122,133,23,63,946,5488,,IT,IT_65,32,85,0,11,506,860
2020-03-27,Abruzzo,289,71,360,565,925,65,71,24,68,1017,6109,,IT,IT_65,9,49,1,5,621,925
2020-03-28,Abruzzo,311,70,381,646,1027,102,116,30,76,1133,7003,,IT,IT_65,22,81,6,8,894,1027
2020-03-29,Abruzzo,329,68,397,772,1169,142,160,36,88,1293,7730,,IT,IT_65,18,126,6,12,727,1169
2020-03-30,Abruzzo,322,69,391,778,1169,0,52,74,102,1345,7948,,IT,IT_65,-7,6,38,14,218,1169
2020-03-31,Abruzzo,335,73,408,783,1191,22,56,95,115,1401,8758,,IT,IT_65,13,5,21,13,810,1191
2020-04-01,Abruzzo,342,71,413,798,1211,20,35,102,123,1436,9610,,IT,IT_65,7,15,7,8,852,1211
2020-04-02,Abruzzo,341,75,416,835,1251,40,61,113,133,1497,10647,,IT,IT_65,-1,37,11,10,1037,1251
2020-04-03,Abruzzo,361,76,437,864,1301,50,66,116,146,1563,11890,,IT,IT_65,20,29,3,13,1243,1301
2020-04-04,Abruzzo,354,71,425,931,1356,55,65,119,153,1628,12837,,IT,IT_65,-7,67,3,7,947,1356
2020-04-05,Abruzzo,347,67,414,1006,1420,64,75,125,158,1703,13598,,IT,IT_65,-7,75,6,5,761,1420
2020-04-06,Abruzzo,340,66,406,1019,1425,5,18,127,169,1721,14198,,IT,IT_65,-7,13,2,11,600,1425
2020-04-07,Abruzzo,337,67,404,1087,1491,66,78,136,172,1799,14904,,IT,IT_65,-3,68,9,3,706,1491
2020-04-08,Abruzzo,331,62,393,1141,1534,43,60,146,179,1859,15846,,IT,IT_65,-6,54,10,7,942,1534
2020-04-09,Abruzzo,306,57,363,1203,1566,32,72,171,194,1931,16847,,IT,IT_65,-25,62,25,15,1001,1566
2020-04-10,Abruzzo,305,53,358,1277,1635,69,83,181,198,2014,18088,,IT,IT_65,-1,74,10,4,1241,1635
2020-04-11,Abruzzo,315,54,369,1355,1724,89,106,190,206,2120,19441,,IT,IT_65,10,78,9,8,1353,1724
2020-04-12,Abruzzo,346,54,400,1342,1742,18,40,206,212,2160,20594,,IT,IT_65,31,-13,16,6,1153,1742
2020-04-13,Abruzzo,351,54,405,1373,1778,36,53,211,224,2213,20667,,IT,IT_65,5,31,5,12,73,1778
2020-04-14,Abruzzo,345,52,397,1403,1800,22,32,213,232,2245,20935,,IT,IT_65,-6,30,2,8,268,1800
2020-04-15,Abruzzo,341,44,385,1425,1810,10,29,224,240,2274,22500,,IT,IT_65,-4,22,11,8,1565,1810
2020-04-16,Abruzzo,324,42,366,1484,1850,40,72,253,243,2346,23786,,IT,IT_65,-17,59,29,3,1286,1850
2020-04-17,Abruzzo,319,43,362,1580,1942,92,97,255,246,2443,25436,,IT,IT_65,-5,96,2,3,1650,1942
2020-04-18,Abruzzo,321,41,362,1609,1971,29,44,263,253,2487,27016,,IT,IT_65,2,29,8,7,1580,1971
2020-04-19,Abruzzo,317,40,357,1630,1987,16,34,276,258,2521,27791,22424,IT,IT_65,-4,21,13,5,775,1987
2020-04-20,Abruzzo,320,38,358,1704,2062,75,91,287,263,2612,27942,22552,IT,IT_65,3,74,11,5,151,2062
2020-04-21,Abruzzo,318,35,353,1714,2067,5,55,329,271,2667,29906,23901,IT,IT_65,-2,10,42,8,1964,2067
2020-04-22,Abruzzo,309,35,344,1764,2108,41,66,349,276,2733,30348,24317,IT,IT_65,-9,50,20,5,442,2108
2020-04-23,Abruzzo,322,31,353,1747,2100,-8,52,405,280,2785,31187,24751,IT,IT_65,13,-17,56,4,839,2100
2020-04-24,Abruzzo,327,28,355,1724,2079,-21,18,438,286,2803,32397,25397,IT,IT_65,5,-23,33,6,1210,2079
2020-04-25,Abruzzo,323,26,349,1712,2061,-18,29,478,293,2832,33624,25959,IT,IT_65,-4,-12,40,7,1227,2061
2020-04-26,Abruzzo,324,24,348,1720,2068,7,27,496,295,2859,33820,26184,IT,IT_65,1,8,18,2,196,2068
2020-04-27,Abruzzo,328,23,351,1679,2030,-38,15,545,299,2874,34176,26443,IT,IT_65,4,-41,49,4,356,2030
2020-04-28,Abruzzo,312,21,333,1657,1990,-40,25,599,310,2899,35356,27054,IT,IT_65,-16,-22,54,11,1180,1990
2020-04-29,Abruzzo,309,19,328,1648,1976,-14,24,632,315,2923,36614,27703,IT,IT_65,-3,-9,33,5,1258,1976
2020-04-30,Abruzzo,306,16,322,1593,1915,-61,7,695,320,2930,37996,28351,IT,IT_65,-3,-55,63,5,1382,1915
2020-05-01,Abruzzo,297,16,313,1598,1911,-4,18,713,324,2948,39385,29024,IT,IT_65,-9,5,18,4,1389,1911
2020-05-02,Abruzzo,303,16,319,1560,1879,-32,16,758,327,2964,39916,29308,IT,IT_65,6,-38,45,3,531,1879
2020-05-03,Abruzzo,300,16,316,1552,1868,-11,32,798,330,2996,40699,29788,IT,IT_65,-3,-8,40,3,783,1868
2020-05-04,Abruzzo,301,15,316,1521,1837,-31,4,831,332,3000,41108,30047,IT,IT_65,1,-31,33,2,409,1837
2020-05-05,Abruzzo,289,11,300,1509,1809,-28,25,881,335,3025,42489,30835,IT,IT_65,-12,-12,50,3,1381,1809
2020-05-06,Abruzzo,285,11,296,1495,1791,-18,22,915,341,3047,43803,31502,IT,IT_65,-4,-14,34,6,1314,1791
2020-05-07,Abruzzo,263,12,275,1495,1770,-21,25,954,348,3072,45021,32186,IT,IT_65,-22,0,39,7,1218,1770
2020-05-08,Abruzzo,250,10,260,1453,1713,-57,6,1014,351,3078,46103,32619,IT,IT_65,-13,-42,60,3,1082,1713
2020-05-09,Abruzzo,246,10,256,1420,1676,-37,8,1055,355,3086,47190,33013,IT,IT_65,-4,-33,41,4,1087,1676
2020-05-10,Abruzzo,233,10,243,1428,1671,-5,17,1073,359,3103,48110,33876,IT,IT_65,-13,8,18,4,920,1671
2020-05-11,Abruzzo,231,9,240,1369,1609,-62,4,1132,366,3107,48903,34428,IT,IT_65,-2,-59,59,7,793,1609
2020-05-12,Abruzzo,222,8,230,1318,1548,-61,8,1197,370,3115,50295,35241,IT,IT_65,-9,-51,65,4,1392,1548
2020-05-13,Abruzzo,214,7,221,1268,1489,-59,12,1263,375,3127,51361,35898,IT,IT_65,-8,-50,66,5,1066,1489
2020-05-14,Abruzzo,215,6,221,1261,1482,-7,9,1275,379,3136,52860,36844,IT,IT_65,1,-7,12,4,1499,1482
2020-05-15,Abruzzo,205,6,211,1243,1454,-28,12,1313,381,3148,54028,37587,IT,IT_65,-10,-18,38,2,1168,1454
2020-05-16,Abruzzo,195,7,202,1221,1423,-31,30,1372,383,3178,55672,38681,IT,IT_65,-10,-22,59,2,1644,1423
2020-05-17,Abruzzo,193,6,199,1223,1422,-1,8,1379,385,3186,57217,39788,IT,IT_65,-2,2,7,2,1545,1422
2020-05-18,Abruzzo,191,6,197,1216,1413,-9,7,1392,388,3193,57897,40345,IT,IT_65,-2,-7,13,3,680,1413
2020-05-19,Abruzzo,188,6,194,1195,1389,-24,4,1419,389,3197,58945,41162,IT,IT_65,-3,-21,27,1,1048,1389
2020-05-20,Abruzzo,185,6,191,1126,1317,-72,8,1499,389,3205,61123,42244,IT,IT_65,-3,-69,80,0,2178,1317
2020-05-21,Abruzzo,175,5,180,1092,1272,-45,7,1549,391,3212,62161,42768,IT,IT_65,-10,-34,50,2,1038,1272
2020-05-22,Abruzzo,157,4,161,1018,1179,-93,8,1647,394,3220,63956,43904,IT,IT_65,-18,-74,98,3,1795,1179
2020-05-23,Abruzzo,156,4,160,1008,1168,-11,1,1659,394,3221,65290,44680,IT,IT_65,-1,-10,12,0,1334,1168
2020-05-24,Abruzzo,149,3,152,940,1092,-76,5,1736,398,3226,66486,45516,IT,IT_65,-7,-68,77,4,1196,1092
2020-05-25,Abruzzo,149,3,152,894,1046,-46,1,1781,400,3227,67468,46146,IT,IT_65,0,-46,45,2,982,1046
2020-05-26,Abruzzo,142,3,145,764,909,-137,3,1921,400,3230,68733,46960,IT,IT_65,-7,-130,140,0,1265,909
2020-05-27,Abruzzo,138,3,141,725,866,-43,5,1969,400,3235,70473,48112,IT,IT_65,-4,-39,48,0,1740,866
2020-05-28,Abruzzo,128,3,131,693,824,-42,2,2011,402,3237,71788,49084,IT,IT_65,-10,-32,42,2,1315,824
2020-05-29,Abruzzo,122,3,125,645,770,-54,0,2063,404,3237,73301,50043,IT,IT_65,-6,-48,52,2,1513,770
2020-05-30,Abruzzo,122,3,125,645,770,0,0,2063,404,3237,73301,50043,IT,IT_65,0,0,0,0,0,770
2020-05-31,Abruzzo,104,4,108,667,775,5,7,2064,405,3244,75652,50050,IT,IT_65,-18,22,1,1,2351,775
2020-06-01,Abruzzo,113,6,119,625,744,-31,1,2093,408,3245,76924,52646,IT,IT_65,9,-42,29,3,1272,744
2020-06-02,Abruzzo,113,6,119,624,743,-1,4,2093,413,3249,77892,53279,IT,IT_65,0,-1,0,5,968,743
2020-06-03,Abruzzo,112,3,115,621,736,-7,3,2102,414,3252,78356,53555,IT,IT_65,-1,-3,9,1,464,736
2020-06-04,Abruzzo,109,3,112,592,704,-32,3,2136,415,3255,79720,54527,IT,IT_65,-3,-29,34,1,1364,704
2020-06-05,Abruzzo,103,4,107,563,670,-34,2,2172,415,3257,80972,55295,IT,IT_65,-6,-29,36,0,1252,670
2020-06-06,Abruzzo,96,3,99,554,653,-17,1,2187,418,3258,82332,56223,IT,IT_65,-7,-9,15,3,1360,653
2020-06-07,Abruzzo,88,4,92,561,653,0,7,2194,418,3265,83020,56702,IT,IT_65,-8,7,7,0,688,653
2020-06-08,Abruzzo,89,4,93,539,632,-21,0,2215,418,3265,83715,57165,IT,IT_65,1,-22,21,0,695,632
2020-06-09,Abruzzo,91,4,95,472,567,-65,1,2248,451,3266,84700,57880,IT,IT_65,2,-67,33,33,985,567
2020-06-10,Abruzzo,83,5,88,462,550,-17,0,2263,453,3266,86082,58766,IT,IT_65,-8,-10,15,2,1382,550
2020-06-11,Abruzzo,81,5,86,453,539,-11,1,2275,453,3267,87566,59505,IT,IT_65,-2,-9,12,0,1484,539
2020-06-12,Abruzzo,76,4,80,448,528,-11,4,2290,453,3271,88739,60229,IT,IT_65,-5,-5,15,0,1173,528
2020-06-13,Abruzzo,72,4,76,433,509,-19,4,2312,454,3275,90340,61177,IT,IT_65,-4,-15,22,1,1601,509
2020-06-14,Abruzzo,71,4,75,436,511,2,4,2312,456,3279,91445,61873,IT,IT_65,-1,3,0,2,1105,511
2020-06-15,Abruzzo,71,3,74,412,486,-25,0,2337,456,3279,91700,62048,IT,IT_65,0,-24,25,0,255,486
2020-06-16,Abruzzo,67,3,70,398,468,-18,1,2355,457,3280,92874,62709,IT,IT_65,-4,-14,18,1,1174,468
2020-06-17,Abruzzo,61,2,63,375,438,-30,2,2386,457,3281,94391,63630,IT,IT_65,-6,-23,31,0,1517,438
2020-06-18,Abruzzo,58,2,60,374,434,-4,2,2389,458,3281,95546,64327,IT,IT_65,-3,-1,3,1,1155,434
2020-06-19,Abruzzo,53,1,54,353,407,-27,1,2414,459,3280,96581,64987,IT,IT_65,-5,-21,25,1,1035,407
2020-06-20,Abruzzo,49,3,52,352,404,-3,1,2418,459,3281,97625,65606,IT,IT_65,-4,-1,4,0,1044,404
2020-02-24,Basilicata,0,0,0,0,0,0,0,0,0,0,0,,IT,IT_77,,,,,,0
2020-02-25,Basilicata,0,0,0,0,0,0,0,0,0,0,0,,IT,IT_77,0,0,0,0,0,0
2020-02-26,Basilicata,0,0,0,0,0,0,0,0,0,0,0,,IT,IT_77,0,0,0,0,0,0
2020-02-27,Basilicata,0,0,0,0,0,0,0,0,0,0,0,,IT,IT_77,0,0,0,0,0,0
2020-02-28,Basilicata,0,0,0,0,0,0,0,0,0,0,0,,IT,IT_77,0,0,0,0,0,0
2020-02-29,Basilicata,0,0,0,0,0,0,0,0,0,0,32,,IT,IT_77,0,0,0,0,32,0
2020-03-01,Basilicata,0,0,0,0,0,0,0,0,0,0,39,,IT,IT_77,0,0,0,0,7,0
2020-03-02,Basilicata,0,0,0,0,0,0,0,0,0,0,39,,IT,IT_77,0,0,0,0,0,0
2020-03-03,Basilicata,0,0,0,1,1,1,1,0,0,1,42,,IT,IT_77,0,1,0,0,3,1
2020-03-04,Basilicata,0,0,0,1,1,0,0,0,0,1,48,,IT,IT_77,0,0,0,0,6,1
2020-03-05,Basilicata,0,0,0,1,1,0,0,0,0,1,54,,IT,IT_77,0,0,0,0,6,1
2020-03-06,Basilicata,1,0,1,2,3,2,2,0,0,3,63,,IT,IT_77,1,1,0,0,9,3
2020-03-07,Basilicata,1,0,1,2,3,0,0,0,0,3,75,,IT,IT_77,0,0,0,0,12,3
2020-03-08,Basilicata,2,0,2,2,4,1,1,0,0,4,123,,IT,IT_77,1,0,0,0,48,4
2020-03-09,Basilicata,2,0,2,3,5,1,1,0,0,5,135,,IT,IT_77,0,1,0,0,12,5
2020-03-10,Basilicata,2,0,2,5,7,2,2,0,0,7,148,,IT,IT_77,0,2,0,0,13,7
2020-03-11,Basilicata,1,1,2,6,8,1,1,0,0,8,155,,IT,IT_77,-1,1,0,0,7,8
2020-03-12,Basilicata,1,1,2,6,8,0,0,0,0,8,155,,IT,IT_77,0,0,0,0,0,8
2020-03-13,Basilicata,1,1,2,8,10,2,2,0,0,10,155,,IT,IT_77,0,2,0,0,0,10
2020-03-14,Basilicata,0,2,2,8,10,0,0,0,0,10,155,,IT,IT_77,-1,0,0,0,0,10
2020-03-15,Basilicata,0,2,2,9,11,1,1,0,0,11,208,,IT,IT_77,0,1,0,0,53,11
2020-03-16,Basilicata,1,2,3,9,12,1,1,0,0,12,230,,IT,IT_77,1,0,0,0,22,12
2020-03-17,Basilicata,5,2,7,13,20,8,8,0,0,20,262,,IT,IT_77,4,4,0,0,32,20
2020-03-18,Basilicata,9,2,11,16,27,7,7,0,0,27,262,,IT,IT_77,4,3,0,0,0,27
2020-03-19,Basilicata,8,5,13,24,37,10,10,0,0,37,353,,IT,IT_77,-1,8,0,0,91,37
2020-03-20,Basilicata,8,5,13,39,52,15,15,0,0,52,443,,IT,IT_77,0,15,0,0,90,52
2020-03-21,Basilicata,12,7,19,47,66,14,14,0,0,66,522,,IT,IT_77,4,8,0,0,79,66
2020-03-22,Basilicata,13,10,23,58,81,15,15,0,0,81,643,,IT,IT_77,1,11,0,0,121,81
2020-03-23,Basilicata,15,12,27,62,89,8,9,0,1,90,696,,IT,IT_77,2,4,0,1,53,89
2020-03-24,Basilicata,14,12,26,65,91,2,2,0,1,92,744,,IT,IT_77,-1,3,0,0,48,91
2020-03-25,Basilicata,20,14,34,78,112,21,21,0,1,113,857,,IT,IT_77,6,13,0,0,113,112
2020-03-26,Basilicata,22,16,38,95,133,21,21,0,1,134,1046,,IT,IT_77,2,17,0,0,189,133
2020-03-27,Basilicata,22,15,37,110,147,14,17,1,3,151,1254,,IT,IT_77,0,15,1,2,208,147
2020-03-28,Basilicata,26,19,45,133,178,31,31,1,3,182,1421,,IT,IT_77,4,23,0,0,167,178
2020-03-29,Basilicata,32,18,50,147,197,19,20,1,4,202,1585,,IT,IT_77,6,14,0,1,164,197
2020-03-30,Basilicata,36,18,54,154,208,11,12,1,5,214,1833,,IT,IT_77,4,7,0,1,248,208
2020-03-31,Basilicata,37,17,54,162,216,8,12,3,7,226,2043,,IT,IT_77,1,8,2,2,210,216
2020-04-01,Basilicata,39,15,54,171,225,9,11,3,9,237,2262,,IT,IT_77,2,9,0,2,219,225
2020-04-02,Basilicata,38,19,57,176,233,8,9,3,10,246,2427,,IT,IT_77,-1,5,0,1,165,233
2020-04-03,Basilicata,41,19,60,187,247,14,15,3,11,261,2622,,IT,IT_77,3,11,0,1,195,247
2020-04-04,Basilicata,44,19,63,181,244,-3,3,9,11,264,2765,,IT,IT_77,3,-6,6,0,143,244
2020-04-05,Basilicata,46,18,64,190,254,10,14,11,13,278,2931,,IT,IT_77,2,9,2,2,166,254
2020-04-06,Basilicata,46,18,64,198,262,8,9,12,13,287,3061,,IT,IT_77,0,8,1,0,130,262
2020-04-07,Basilicata,47,17,64,201,265,3,4,12,14,291,3160,,IT,IT_77,1,3,0,1,99,265
2020-04-08,Basilicata,48,17,65,205,270,5,6,13,14,297,3296,,IT,IT_77,1,4,1,0,136,270
2020-04-09,Basilicata,50,17,67,208,275,5,6,13,15,303,3474,,IT,IT_77,2,3,0,1,178,275
2020-04-10,Basilicata,59,15,74,205,279,4,5,14,15,308,3696,,IT,IT_77,9,-3,1,0,222,279
2020-04-11,Basilicata,60,12,72,209,281,2,4,14,17,312,4050,,IT,IT_77,1,4,0,2,354,281
2020-04-12,Basilicata,61,12,73,204,277,-4,3,20,18,315,4355,,IT,IT_77,1,-5,6,1,305,277
2020-04-13,Basilicata,64,12,76,194,270,-7,4,31,18,319,4545,,IT,IT_77,3,-10,11,0,190,270
2020-04-14,Basilicata,62,12,74,191,265,-5,0,35,19,319,4759,,IT,IT_77,-2,-3,4,1,214,265
2020-04-15,Basilicata,60,12,72,189,261,-4,1,38,21,320,5037,,IT,IT_77,-2,-2,3,2,278,261
2020-04-16,Basilicata,60,9,69,204,273,12,16,41,22,336,5349,,IT,IT_77,0,15,3,1,312,273
2020-04-17,Basilicata,59,9,68,198,266,-7,1,49,22,337,5710,,IT,IT_77,-1,-6,8,0,361,266
2020-04-18,Basilicata,60,8,68,194,262,-4,2,54,23,339,6056,,IT,IT_77,1,-4,5,1,346,262
2020-04-19,Basilicata,59,8,67,180,247,-15,3,71,24,342,6528,6528,IT,IT_77,-1,-14,17,1,472,247
2020-04-20,Basilicata,59,7,66,176,242,-5,0,76,24,342,6868,6868,IT,IT_77,0,-4,5,0,340,242
2020-04-21,Basilicata,64,7,71,174,245,3,8,81,24,350,7470,7470,IT,IT_77,5,-2,5,0,602,245
2020-04-22,Basilicata,65,7,72,160,232,-13,4,98,24,354,8040,8040,IT,IT_77,1,-14,17,0,570,232
2020-04-23,Basilicata,61,7,68,161,229,-3,2,103,24,356,8511,8511,IT,IT_77,-4,1,5,0,471,229
2020-04-24,Basilicata,59,7,66,163,229,0,4,107,24,360,9026,9026,IT,IT_77,-2,2,4,0,515,229
2020-04-25,Basilicata,58,7,65,153,218,-11,1,118,25,361,9792,9792,IT,IT_77,-1,-10,11,1,766,218
2020-04-26,Basilicata,57,7,64,155,219,1,5,122,25,366,10077,10077,IT,IT_77,-1,2,4,0,285,219
2020-04-27,Basilicata,57,7,64,153,217,-2,0,124,25,366,10364,10364,IT,IT_77,0,-2,2,0,287,217
2020-04-28,Basilicata,56,7,63,142,205,-12,0,136,25,366,10889,10889,IT,IT_77,-1,-11,12,0,525,205
2020-04-29,Basilicata,51,4,55,139,194,-11,0,147,25,366,11331,11331,IT,IT_77,-5,-3,11,0,442,194
2020-04-30,Basilicata,49,4,53,139,192,-2,1,150,25,367,12774,12774,IT,IT_77,-2,0,3,0,1443,192
2020-05-01,Basilicata,49,4,53,140,193,1,11,160,25,378,13269,13269,IT,IT_77,0,1,10,0,495,193
2020-05-02,Basilicata,48,4,52,139,191,-2,2,164,25,380,13722,13722,IT,IT_77,-1,-1,4,0,453,191
2020-05-03,Basilicata,48,3,51,143,194,3,6,167,25,386,14210,14210,IT,IT_77,0,4,3,0,488,194
2020-05-04,Basilicata,50,3,53,120,173,-21,0,188,25,386,14901,14455,IT,IT_77,2,-23,21,0,691,173
2020-05-05,Basilicata,50,3,53,124,177,4,10,194,25,396,15476,15028,IT,IT_77,0,4,6,0,575,177
2020-05-06,Basilicata,47,3,50,122,172,-5,3,202,25,399,16103,15619,IT,IT_77,-3,-2,8,0,627,172
2020-05-07,Basilicata,48,2,50,105,155,-17,-16,202,26,383,16272,15780,IT,IT_77,1,-17,0,1,169,155
2020-05-08,Basilicata,48,2,50,102,152,-3,-1,204,26,382,16777,16285,IT,IT_77,0,-3,2,0,505,152
2020-05-09,Basilicata,45,1,46,99,145,-7,0,210,27,382,17433,16941,IT,IT_77,-3,-3,6,1,656,145
2020-05-10,Basilicata,45,1,46,97,143,-2,3,215,27,385,17916,17424,IT,IT_77,0,-2,5,0,483,143
2020-05-11,Basilicata,46,1,47,95,142,-1,1,217,27,386,18266,17774,IT,IT_77,1,-2,2,0,350,142
2020-05-12,Basilicata,47,1,48,92,140,-2,1,220,27,387,19100,18608,IT,IT_77,1,-3,3,0,834,140
2020-05-13,Basilicata,42,1,43,88,131,-9,2,231,27,389,19678,19186,IT,IT_77,-5,-4,11,0,578,131
2020-05-14,Basilicata,34,1,35,92,127,-4,0,235,27,389,20285,19789,IT,IT_77,-8,4,4,0,607,127
2020-05-15,Basilicata,33,1,34,86,120,-7,0,242,27,389,20851,20359,IT,IT_77,-1,-6,7,0,566,120
2020-05-16,Basilicata,29,1,30,83,113,-7,1,250,27,390,21496,20966,IT,IT_77,-4,-3,8,0,645,113
2020-05-17,Basilicata,29,1,30,74,104,-9,2,261,27,392,22167,21627,IT,IT_77,0,-9,11,0,671,104
2020-05-18,Basilicata,29,1,30,63,93,-11,0,272,27,392,22581,22016,IT,IT_77,0,-11,11,0,414,93
2020-05-19,Basilicata,26,1,27,57,84,-9,1,282,27,393,23347,22767,IT,IT_77,-3,-6,10,0,766,84
2020-05-20,Basilicata,22,1,23,50,73,-11,0,293,27,393,23986,23376,IT,IT_77,-4,-7,11,0,639,73
2020-05-21,Basilicata,15,1,16,44,60,-13,1,307,27,394,24537,23903,IT,IT_77,-7,-6,14,0,551,60
2020-05-22,Basilicata,15,1,16,33,49,-11,0,318,27,394,25045,24395,IT,IT_77,0,-11,11,0,508,49
2020-05-23,Basilicata,14,1,15,26,41,-8,4,330,27,398,25511,24841,IT,IT_77,-1,-7,12,0,466,41
2020-05-24,Basilicata,13,1,14,25,39,-2,1,333,27,399,26111,25431,IT,IT_77,-1,-1,3,0,600,39
2020-05-25,Basilicata,13,0,13,23,36,-3,0,336,27,399,26634,25944,IT,IT_77,0,-2,3,0,523,36
2020-05-26,Basilicata,8,0,8,28,36,0,0,336,27,399,27197,26807,IT,IT_77,-5,5,0,0,563,36
2020-05-27,Basilicata,7,0,7,29,36,0,0,336,27,399,27734,27344,IT,IT_77,-1,1,0,0,537,36
2020-05-28,Basilicata,6,0,6,28,34,-2,0,338,27,399,28342,27952,IT,IT_77,-1,-1,2,0,608,34
2020-05-29,Basilicata,5,0,5,28,33,-1,0,339,27,399,28909,28209,IT,IT_77,-1,0,1,0,567,33
2020-05-30,Basilicata,5,0,5,26,31,-2,0,341,27,399,29421,28685,IT,IT_77,0,-2,2,0,512,31
2020-05-31,Basilicata,4,0,4,25,29,-2,0,343,27,399,29880,29130,IT,IT_77,-1,-1,2,0,459,29
2020-06-01,Basilicata,4,0,4,24,28,-1,0,344,27,399,29956,29196,IT,IT_77,0,-1,1,0,76,28
2020-06-02,Basilicata,4,0,4,20,24,-4,0,348,27,399,30424,29664,IT,IT_77,0,-4,4,0,468,24
2020-06-03,Basilicata,4,0,4,19,23,-1,0,349,27,399,30708,29938,IT,IT_77,0,-1,1,0,284,23
2020-06-04,Basilicata,3,0,3,17,20,-3,0,352,27,399,31096,30706,IT,IT_77,-1,-2,3,0,388,20
2020-06-05,Basilicata,0,0,0,18,18,-2,0,354,27,399,31485,30705,IT,IT_77,-3,1,2,0,389,18
2020-06-06,Basilicata,0,0,0,17,17,-1,0,355,27,399,31882,31102,IT,IT_77,0,-1,1,0,397,17
2020-06-07,Basilicata,0,0,0,14,14,-3,0,358,27,399,32147,31357,IT,IT_77,0,-3,3,0,265,14
2020-06-08,Basilicata,0,0,0,13,13,-1,0,359,27,399,32720,31930,IT,IT_77,0,-1,1,0,573,13
2020-06-09,Basilicata,1,0,1,13,14,1,1,359,27,400,33185,32395,IT,IT_77,1,0,0,0,465,14
2020-06-10,Basilicata,1,0,1,10,11,-3,0,362,27,400,33551,32761,IT,IT_77,0,-3,3,0,366,11
2020-06-11,Basilicata,0,1,1,11,12,1,1,362,27,401,33957,33167,IT,IT_77,-1,1,0,0,406,12
2020-06-12,Basilicata,0,1,1,11,12,0,0,362,27,401,34377,33587,IT,IT_77,0,0,0,0,420,12
2020-06-13,Basilicata,0,1,1,10,11,-1,0,363,27,401,34681,33891,IT,IT_77,0,-1,1,0,304,11
2020-06-14,Basilicata,0,1,1,10,11,0,0,363,27,401,35139,34349,IT,IT_77,0,0,0,0,458,11
2020-06-15,Basilicata,0,1,1,10,11,0,0,363,27,401,35233,34443,IT,IT_77,0,0,0,0,94,11
2020-06-16,Basilicata,0,1,1,9,10,-1,0,364,27,401,35666,34876,IT,IT_77,0,-1,1,0,433,10
2020-06-17,Basilicata,0,1,1,9,10,0,0,364,27,401,36011,35221,IT,IT_77,0,0,0,0,345,10
2020-06-18,Basilicata,0,1,1,9,10,0,0,364,27,401,36382,35592,IT,IT_77,0,0,0,0,371,10
2020-06-19,Basilicata,0,1,1,7,8,-2,0,366,27,401,36705,35915,IT,IT_77,0,-2,2,0,323,8
2020-06-20,Basilicata,0,1,1,7,8,0,0,366,27,401,36975,36185,IT,IT_77,0,0,0,0,270,8
2020-02-24,P.A. Bolzano,0,0,0,0,0,0,0,0,0,0,1,,IT,IT_BZ,,,,,,0
2020-02-25,P.A. Bolzano,1,0,1,0,1,1,1,0,0,1,1,,IT,IT_BZ,1,0,0,0,0,1
2020-02-26,P.A. Bolzano,1,0,1,0,1,0,0,0,0,1,1,,IT,IT_BZ,0,0,0,0,0,1
2020-02-27,P.A. Bolzano,1,0,1,0,1,0,0,0,0,1,2,,IT,IT_BZ,0,0,0,0,1,1
2020-02-28,P.A. Bolzano,1,0,1,0,1,0,0,0,0,1,2,,IT,IT_BZ,0,0,0,0,0,1
2020-02-29,P.A. Bolzano,1,0,1,0,1,0,0,0,0,1,16,,IT,IT_BZ,0,0,0,0,14,1
2020-03-01,P.A. Bolzano,1,0,1,0,1,0,0,0,0,1,20,,IT,IT_BZ,0,0,0,0,4,1
2020-03-02,P.A. Bolzano,1,0,1,0,1,0,0,0,0,1,20,,IT,IT_BZ,0,0,0,0,0,1
2020-03-03,P.A. Bolzano,1,0,1,0,1,0,0,0,0,1,20,,IT,IT_BZ,0,0,0,0,0,1
2020-03-04,P.A. Bolzano,1,0,1,0,1,0,0,0,0,1,20,,IT,IT_BZ,0,0,0,0,0,1
2020-03-05,P.A. Bolzano,1,0,1,0,1,0,0,0,0,1,20,,IT,IT_BZ,0,0,0,0,0,1
2020-03-06,P.A. Bolzano,4,0,4,0,4,3,3,0,0,4,36,,IT,IT_BZ,3,0,0,0,16,4
2020-03-07,P.A. Bolzano,8,0,8,1,9,5,5,0,0,9,36,,IT,IT_BZ,4,1,0,0,0,9
2020-03-08,P.A. Bolzano,8,0,8,1,9,0,0,0,0,9,36,,IT,IT_BZ,0,0,0,0,0,9
2020-03-09,P.A. Bolzano,8,0,8,1,9,0,0,0,0,9,36,,IT,IT_BZ,0,0,0,0,0,9
2020-03-10,P.A. Bolzano,17,1,18,20,38,29,29,0,0,38,36,,IT,IT_BZ,9,19,0,0,0,38
2020-03-11,P.A. Bolzano,8,4,12,63,75,37,37,0,0,75,75,,IT,IT_BZ,-9,43,0,0,39,75
2020-03-12,P.A. Bolzano,21,4,25,78,103,28,29,0,1,104,607,,IT,IT_BZ,13,15,0,1,532,103
2020-03-13,P.A. Bolzano,20,5,25,98,123,20,21,0,2,125,811,,IT,IT_BZ,-1,20,0,1,204,123
2020-03-14,P.A. Bolzano,26,7,33,137,170,47,48,0,3,173,1135,,IT,IT_BZ,6,39,0,1,324,170
2020-03-15,P.A. Bolzano,50,4,54,145,199,29,31,0,5,204,1497,,IT,IT_BZ,24,8,0,2,362,199
2020-03-16,P.A. Bolzano,53,11,64,171,235,36,37,0,6,241,1740,,IT,IT_BZ,3,26,0,1,243,235
2020-03-17,P.A. Bolzano,71,11,82,200,282,47,50,1,8,291,2149,,IT,IT_BZ,18,29,1,2,409,282
2020-03-18,P.A. Bolzano,79,18,97,269,366,84,85,1,9,376,2844,,IT,IT_BZ,8,69,0,1,695,366
2020-03-19,P.A. Bolzano,87,18,105,316,421,55,60,1,14,436,3568,,IT,IT_BZ,8,47,0,5,724,421
2020-03-20,P.A. Bolzano,99,24,123,407,530,109,112,1,17,548,4433,,IT,IT_BZ,12,91,0,3,865,530
2020-03-21,P.A. Bolzano,127,30,157,443,600,70,73,1,20,621,5179,,IT,IT_BZ,28,36,0,3,746,600
2020-03-22,P.A. Bolzano,146,32,178,470,648,48,57,7,23,678,5718,,IT,IT_BZ,19,27,6,3,539,648
2020-03-23,P.A. Bolzano,145,33,178,510,688,40,46,7,29,724,6084,,IT,IT_BZ,-1,40,0,6,366,688
2020-03-24,P.A. Bolzano,166,38,204,495,699,11,57,44,38,781,6509,,IT,IT_BZ,21,-15,37,9,425,699
2020-03-25,P.A. Bolzano,190,40,230,518,748,49,77,67,43,858,6649,,IT,IT_BZ,24,23,23,5,140,748
2020-03-26,P.A. Bolzano,223,43,266,525,791,43,48,67,48,906,7744,,IT,IT_BZ,33,7,0,5,1095,791
2020-03-27,P.A. Bolzano,249,45,294,539,833,42,97,110,60,1003,8520,,IT,IT_BZ,26,14,43,12,776,833
2020-03-28,P.A. Bolzano,225,51,276,653,929,96,106,116,64,1109,9168,,IT,IT_BZ,-24,114,6,4,648,929
2020-03-29,P.A. Bolzano,234,56,290,744,1034,105,105,116,64,1214,10137,,IT,IT_BZ,9,91,0,0,969,1034
2020-03-30,P.A. Bolzano,231,62,293,805,1098,64,111,153,74,1325,10640,,IT,IT_BZ,-3,61,37,10,503,1098
2020-03-31,P.A. Bolzano,249,62,311,831,1142,44,46,153,76,1371,11275,,IT,IT_BZ,18,26,0,2,635,1142
2020-04-01,P.A. Bolzano,269,57,326,786,1112,-30,47,190,116,1418,11951,,IT,IT_BZ,20,-45,37,40,676,1112
2020-04-02,P.A. Bolzano,279,60,339,821,1160,48,61,190,129,1479,12677,,IT,IT_BZ,10,35,0,13,726,1160
2020-04-03,P.A. Bolzano,291,60,351,858,1209,49,80,211,139,1559,13976,,IT,IT_BZ,12,37,21,10,1299,1209
2020-04-04,P.A. Bolzano,291,61,352,849,1201,-8,33,245,146,1592,15045,,IT,IT_BZ,0,-9,34,7,1069,1201
2020-04-05,P.A. Bolzano,239,53,292,934,1226,25,52,260,158,1644,15723,,IT,IT_BZ,-52,85,15,12,678,1226
2020-04-06,P.A. Bolzano,245,52,297,963,1260,34,78,298,164,1722,16825,,IT,IT_BZ,6,29,38,6,1102,1260
2020-04-07,P.A. Bolzano,325,64,389,912,1301,41,89,336,174,1811,17761,,IT,IT_BZ,80,-51,38,10,936,1301
2020-04-08,P.A. Bolzano,268,65,333,948,1281,-20,24,371,183,1835,18865,,IT,IT_BZ,-57,36,35,9,1104,1281
2020-04-09,P.A. Bolzano,263,64,327,988,1315,34,68,401,187,1903,19875,,IT,IT_BZ,-5,40,30,4,1010,1315
2020-04-10,P.A. Bolzano,258,58,316,1001,1317,2,52,447,191,1955,20866,,IT,IT_BZ,-5,13,46,4,991,1317
2020-04-11,P.A. Bolzano,246,56,302,967,1269,-48,2,488,200,1957,22186,,IT,IT_BZ,-12,-34,41,9,1320,1269
2020-04-12,P.A. Bolzano,183,45,228,1287,1515,246,141,378,205,2098,23246,,IT,IT_BZ,-63,320,-110,5,1060,1515
2020-04-13,P.A. Bolzano,190,41,231,1306,1537,22,51,400,212,2149,24157,,IT,IT_BZ,7,19,22,7,911,1537
2020-04-14,P.A. Bolzano,177,39,216,1348,1564,27,35,406,214,2184,24457,,IT,IT_BZ,-13,42,6,2,300,1564
2020-04-15,P.A. Bolzano,166,32,198,1378,1576,12,40,425,223,2224,25370,,IT,IT_BZ,-11,30,19,9,913,1576
2020-04-16,P.A. Bolzano,180,34,214,1379,1593,17,43,449,225,2267,26416,,IT,IT_BZ,14,1,24,2,1046,1593
2020-04-17,P.A. Bolzano,181,32,213,1369,1582,-11,29,480,234,2296,27698,,IT,IT_BZ,1,-10,31,9,1282,1582
2020-04-18,P.A. Bolzano,179,28,207,1349,1556,-26,29,530,239,2325,28888,,IT,IT_BZ,-2,-20,50,5,1190,1556
2020-04-19,P.A. Bolzano,162,23,185,1381,1566,10,55,569,245,2380,30361,14783,IT,IT_BZ,-17,32,39,6,1473,1566
2020-04-20,P.A. Bolzano,160,19,179,1361,1540,-26,14,605,249,2394,31381,15089,IT,IT_BZ,-2,-20,36,4,1020,1540
2020-04-21,P.A. Bolzano,159,20,179,1357,1536,-4,16,623,251,2410,31987,15405,IT,IT_BZ,-1,-4,18,2,606,1536
2020-04-22,P.A. Bolzano,157,19,176,1336,1512,-24,6,648,256,2416,32722,15736,IT,IT_BZ,-2,-21,25,5,735,1512
2020-04-23,P.A. Bolzano,141,17,158,1336,1494,-18,19,680,261,2435,33994,16442,IT,IT_BZ,-16,0,32,5,1272,1494
2020-04-24,P.A. Bolzano,148,16,164,929,1093,-401,21,1100,263,2456,35062,17024,IT,IT_BZ,7,-407,420,2,1068,1093
2020-04-25,P.A. Bolzano,141,14,155,880,1035,-58,20,1176,265,2476,36608,17573,IT,IT_BZ,-7,-49,76,2,1546,1035
2020-04-26,P.A. Bolzano,138,14,152,842,994,-41,5,1218,269,2481,37431,17895,IT,IT_BZ,-3,-38,42,4,823,994
2020-04-27,P.A. Bolzano,150,16,166,774,940,-54,15,1286,270,2496,38640,18423,IT,IT_BZ,12,-68,68,1,1209,940
2020-04-28,P.A. Bolzano,136,15,151,759,910,-30,2,1316,272,2498,39130,18567,IT,IT_BZ,-14,-15,30,2,490,910
2020-04-29,P.A. Bolzano,119,14,133,712,845,-65,9,1388,274,2507,40218,18844,IT,IT_BZ,-17,-47,72,2,1088,845
2020-04-30,P.A. Bolzano,126,13,139,663,802,-43,11,1441,275,2518,41297,19178,IT,IT_BZ,7,-49,53,1,1079,802
2020-05-01,P.A. Bolzano,112,11,123,634,757,-45,10,1493,278,2528,42903,19705,IT,IT_BZ,-14,-29,52,3,1606,757
2020-05-02,P.A. Bolzano,113,10,123,580,703,-54,7,1553,279,2535,43804,20036,IT,IT_BZ,1,-54,60,1,901,703
2020-05-03,P.A. Bolzano,109,11,120,545,665,-38,1,1590,281,2536,44240,20166,IT,IT_BZ,-4,-35,37,2,436,665
2020-05-04,P.A. Bolzano,103,10,113,523,636,-29,5,1621,284,2541,44673,20333,IT,IT_BZ,-6,-22,31,3,433,636
2020-05-05,P.A. Bolzano,99,11,110,502,612,-24,1,1644,286,2542,45264,20561,IT,IT_BZ,-4,-21,23,2,591,612
2020-05-06,P.A. Bolzano,99,11,110,469,579,-33,1,1678,286,2543,46228,20872,IT,IT_BZ,0,-33,34,0,964,579
2020-05-07,P.A. Bolzano,87,11,98,453,551,-28,9,1715,286,2552,47091,21284,IT,IT_BZ,-12,-16,37,0,863,551
2020-05-08,P.A. Bolzano,78,9,87,415,502,-49,6,1767,289,2558,47908,21572,IT,IT_BZ,-9,-38,52,3,817,502
2020-05-09,P.A. Bolzano,55,9,64,409,473,-29,9,1804,290,2567,48858,21969,IT,IT_BZ,-23,-6,37,1,950,473
2020-05-10,P.A. Bolzano,61,8,69,390,459,-14,2,1820,290,2569,49571,22265,IT,IT_BZ,6,-19,16,0,713,459
2020-05-11,P.A. Bolzano,63,7,70,377,447,-12,3,1835,290,2572,50019,22500,IT,IT_BZ,2,-13,15,0,448,447
2020-05-12,P.A. Bolzano,56,7,63,374,437,-10,0,1845,290,2572,50381,22731,IT,IT_BZ,-7,-3,10,0,362,437
2020-05-13,P.A. Bolzano,56,7,63,350,413,-24,3,1872,290,2575,51181,23120,IT,IT_BZ,0,-24,27,0,800,413
2020-05-14,P.A. Bolzano,54,7,61,319,380,-33,3,1908,290,2578,52015,23487,IT,IT_BZ,-2,-31,36,0,834,380
2020-05-15,P.A. Bolzano,50,5,55,304,359,-21,0,1929,290,2578,52939,23969,IT,IT_BZ,-4,-15,21,0,924,359
2020-05-16,P.A. Bolzano,48,5,53,290,343,-16,0,1945,290,2578,53703,24316,IT,IT_BZ,-2,-14,16,0,764,343
2020-05-17,P.A. Bolzano,50,5,55,259,314,-29,3,1977,290,2581,54428,24677,IT,IT_BZ,2,-31,32,0,725,314
2020-05-18,P.A. Bolzano,52,6,58,249,307,-7,1,1984,291,2582,54861,24930,IT,IT_BZ,2,-10,7,1,433,307
2020-05-19,P.A. Bolzano,46,6,52,256,308,1,5,1988,291,2587,55526,25263,IT,IT_BZ,-6,7,4,0,665,308
2020-05-20,P.A. Bolzano,43,5,48,224,272,-36,0,2024,291,2587,56310,25601,IT,IT_BZ,-3,-32,36,0,784,272
2020-05-21,P.A. Bolzano,50,5,55,195,250,-22,0,2046,291,2587,57104,25999,IT,IT_BZ,7,-29,22,0,794,250
2020-05-22,P.A. Bolzano,34,5,39,185,224,-26,3,2075,291,2590,58188,26585,IT,IT_BZ,-16,-10,29,0,1084,224
2020-05-23,P.A. Bolzano,35,5,40,174,214,-10,0,2085,291,2590,59671,27549,IT,IT_BZ,1,-11,10,0,1483,214
2020-05-24,P.A. Bolzano,30,5,35,160,195,-19,3,2107,291,2593,60573,27938,IT,IT_BZ,-5,-14,22,0,902,195
2020-05-25,P.A. Bolzano,29,5,34,150,184,-11,0,2118,291,2593,61075,28189,IT,IT_BZ,-1,-10,11,0,502,184
2020-05-26,P.A. Bolzano,28,5,33,146,179,-5,0,2123,291,2593,61464,28401,IT,IT_BZ,-1,-4,5,0,389,179
2020-05-27,P.A. Bolzano,27,5,32,139,171,-8,0,2131,291,2593,62247,28809,IT,IT_BZ,-1,-7,8,0,783,171
2020-05-28,P.A. Bolzano,16,5,21,136,157,-14,2,2147,291,2595,63289,28809,IT,IT_BZ,-11,-3,16,0,1042,157
2020-05-29,P.A. Bolzano,17,5,22,132,154,-3,0,2150,291,2595,64105,29680,IT,IT_BZ,1,-4,3,0,816,154
2020-05-30,P.A. Bolzano,13,4,17,120,137,-17,1,2168,291,2596,65405,30308,IT,IT_BZ,-4,-12,18,0,1300,137
2020-05-31,P.A. Bolzano,13,4,17,110,127,-10,1,2179,291,2597,66247,30790,IT,IT_BZ,0,-10,11,0,842,127
2020-06-01,P.A. Bolzano,13,4,17,106,123,-4,1,2184,291,2598,67121,31254,IT,IT_BZ,0,-4,5,0,874,123
2020-06-02,P.A. Bolzano,13,3,16,104,120,-3,0,2187,291,2598,67643,31610,IT,IT_BZ,0,-2,3,0,522,120
2020-06-03,P.A. Bolzano,13,3,16,104,120,0,0,2187,291,2598,67965,31800,IT,IT_BZ,0,0,0,0,322,120
2020-06-04,P.A. Bolzano,7,2,9,103,112,-8,0,2194,292,2598,68513,32135,IT,IT_BZ,-6,-1,7,1,548,112
2020-06-05,P.A. Bolzano,10,2,12,89,101,-11,1,2206,292,2599,69466,32665,IT,IT_BZ,3,-14,12,0,953,101
2020-06-06,P.A. Bolzano,7,2,9,91,100,-1,1,2208,292,2600,70578,33291,IT,IT_BZ,-3,2,2,0,1112,100
2020-06-07,P.A. Bolzano,7,2,9,88,97,-3,3,2214,292,2603,71755,33944,IT,IT_BZ,0,-3,6,0,1177,97
2020-06-08,P.A. Bolzano,7,2,9,88,97,0,1,2215,292,2604,72257,34307,IT,IT_BZ,0,0,1,0,502,97
2020-06-09,P.A. Bolzano,7,2,9,86,95,-2,0,2217,292,2604,72652,34607,IT,IT_BZ,0,-2,2,0,395,95
2020-06-10,P.A. Bolzano,7,2,9,85,94,-1,0,2218,292,2604,73404,35148,IT,IT_BZ,0,-1,1,0,752,94
2020-06-11,P.A. Bolzano,8,2,10,89,99,5,2,2215,292,2606,74106,35553,IT,IT_BZ,1,4,-3,0,702,99
2020-06-12,P.A. Bolzano,8,2,10,91,101,2,2,2216,291,2608,74859,35974,IT,IT_BZ,0,2,1,-1,753,101
2020-06-13,P.A. Bolzano,7,2,9,86,95,-6,2,2224,291,2610,75735,36393,IT,IT_BZ,-1,-5,8,0,876,95
2020-06-14,P.A. Bolzano,8,2,10,85,95,0,3,2227,291,2613,76195,36607,IT,IT_BZ,1,-1,3,0,460,95
2020-06-15,P.A. Bolzano,8,1,9,85,94,-1,0,2225,292,2611,76345,36698,IT,IT_BZ,0,0,-2,1,150,94
2020-06-16,P.A. Bolzano,8,1,9,84,93,-1,0,2226,292,2611,76661,36931,IT,IT_BZ,0,-1,1,0,316,93
2020-06-17,P.A. Bolzano,8,1,9,78,87,-6,0,2232,292,2611,77230,37210,IT,IT_BZ,0,-6,6,0,569,87
2020-06-18,P.A. Bolzano,8,2,10,75,85,-2,2,2236,292,2613,77954,37563,IT,IT_BZ,0,-3,4,0,724,85
2020-06-19,P.A. Bolzano,3,1,4,71,75,-10,2,2248,292,2615,78580,37858,IT,IT_BZ,-5,-4,12,0,626,75
2020-06-20,P.A. Bolzano,3,1,4,72,76,1,0,2250,292,2618,79333,38276,IT,IT_BZ,0,1,2,0,753,76
2020-02-24,Calabria,0,0,0,0,0,0,0,0,0,0,1,,IT,IT_78,,,,,,0
2020-02-25,Calabria,0,0,0,0,0,0,0,0,0,0,2,,IT,IT_78,0,0,0,0,1,0
2020-02-26,Calabria,0,0,0,0,0,0,0,0,0,0,3,,IT,IT_78,0,0,0,0,1,0
2020-02-27,Calabria,0,0,0,0,0,0,0,0,0,0,14,,IT,IT_78,0,0,0,0,11,0
2020-02-28,Calabria,0,0,0,1,1,1,1,0,0,1,21,,IT,IT_78,0,1,0,0,7,1
2020-02-29,Calabria,0,0,0,1,1,0,0,0,0,1,27,,IT,IT_78,0,0,0,0,6,1
2020-03-01,Calabria,0,0,0,1,1,0,0,0,0,1,35,,IT,IT_78,0,0,0,0,8,1
2020-03-02,Calabria,0,0,0,1,1,0,0,0,0,1,39,,IT,IT_78,0,0,0,0,4,1
2020-03-03,Calabria,0,0,0,1,1,0,0,0,0,1,39,,IT,IT_78,0,0,0,0,0,1
2020-03-04,Calabria,0,0,0,1,1,0,0,0,0,1,46,,IT,IT_78,0,0,0,0,7,1
2020-03-05,Calabria,1,0,1,1,2,1,1,0,0,2,53,,IT,IT_78,1,0,0,0,7,2
2020-03-06,Calabria,2,0,2,2,4,2,2,0,0,4,99,,IT,IT_78,1,1,0,0,46,4
2020-03-07,Calabria,2,0,2,2,4,0,0,0,0,4,113,,IT,IT_78,0,0,0,0,14,4
2020-03-08,Calabria,5,0,5,4,9,5,5,0,0,9,113,,IT,IT_78,3,2,0,0,0,9
2020-03-09,Calabria,8,0,8,1,9,0,2,2,0,11,173,,IT,IT_78,3,-3,2,0,60,9
2020-03-10,Calabria,8,2,10,1,11,2,2,2,0,13,360,,IT,IT_78,0,0,0,0,187,11
2020-03-11,Calabria,10,2,12,5,17,6,6,2,0,19,405,,IT,IT_78,2,4,0,0,45,17
2020-03-12,Calabria,14,2,16,16,32,15,14,1,0,33,483,,IT,IT_78,4,11,-1,0,78,32
2020-03-13,Calabria,18,3,21,16,37,5,5,1,0,38,504,,IT,IT_78,4,0,0,0,21,37
2020-03-14,Calabria,22,4,26,33,59,22,22,1,0,60,711,,IT,IT_78,4,17,0,0,207,59
2020-03-15,Calabria,32,6,38,28,66,7,8,1,1,68,884,,IT,IT_78,10,-5,0,1,173,66
2020-03-16,Calabria,36,7,43,44,87,21,21,1,1,89,1030,,IT,IT_78,4,16,0,0,146,87
2020-03-17,Calabria,45,10,55,57,112,25,25,1,1,114,1293,,IT,IT_78,9,13,0,0,263,112
2020-03-18,Calabria,45,11,56,70,126,14,15,2,1,129,1668,,IT,IT_78,0,13,1,0,375,126
2020-03-19,Calabria,60,13,73,91,164,38,40,2,3,169,2342,,IT,IT_78,15,21,0,2,674,164
2020-03-20,Calabria,71,16,87,114,201,37,38,2,4,207,2690,,IT,IT_78,11,23,0,1,348,201
2020-03-21,Calabria,73,16,89,136,225,24,28,5,5,235,3050,,IT,IT_78,2,22,3,1,360,225
2020-03-22,Calabria,77,17,94,166,260,35,38,5,8,273,3666,,IT,IT_78,4,30,0,3,616,260
2020-03-23,Calabria,82,20,102,178,280,20,19,5,7,292,4073,,IT,IT_78,5,12,0,-1,407,280
2020-03-24,Calabria,88,21,109,195,304,24,27,5,10,319,4486,,IT,IT_78,6,17,0,3,413,304
2020-03-25,Calabria,93,23,116,217,333,29,32,7,11,351,5058,,IT,IT_78,5,22,2,1,572,333
2020-03-26,Calabria,101,23,124,248,372,39,42,7,14,393,5933,,IT,IT_78,8,31,0,3,875,372
2020-03-27,Calabria,103,22,125,344,469,97,101,7,18,494,6901,,IT,IT_78,2,96,0,4,968,469
2020-03-28,Calabria,107,22,129,394,523,54,61,11,21,555,7760,,IT,IT_78,4,50,4,3,859,523
2020-03-29,Calabria,124,19,143,434,577,54,59,12,25,614,8485,,IT,IT_78,17,40,1,4,725,577
2020-03-30,Calabria,130,18,148,454,602,25,33,14,31,647,9013,,IT,IT_78,6,20,2,6,528,602
2020-03-31,Calabria,132,17,149,457,606,4,12,17,36,659,9327,,IT,IT_78,2,3,3,5,314,606
2020-04-01,Calabria,144,16,160,450,610,4,10,21,38,669,9983,,IT,IT_78,12,-7,4,2,656,610
2020-04-02,Calabria,163,19,182,445,627,17,22,23,41,691,10679,,IT,IT_78,19,-5,2,3,696,627
2020-04-03,Calabria,183,17,200,462,662,35,42,26,45,733,11608,,IT,IT_78,20,17,3,4,929,662
2020-04-04,Calabria,178,15,193,469,662,0,8,30,49,741,12314,,IT,IT_78,-5,7,4,4,706,662
2020-04-05,Calabria,174,13,187,519,706,44,54,33,56,795,13077,,IT,IT_78,-4,50,3,7,763,706
2020-04-06,Calabria,170,14,184,538,722,16,22,37,58,817,13633,,IT,IT_78,-4,19,4,2,556,722
2020-04-07,Calabria,169,14,183,550,733,11,16,40,60,833,14072,,IT,IT_78,-1,12,3,2,439,733
2020-04-08,Calabria,170,15,185,570,755,22,26,44,60,859,14977,,IT,IT_78,1,20,4,0,905,755
2020-04-09,Calabria,168,15,183,582,765,10,15,48,61,874,15698,,IT,IT_78,-2,12,4,1,721,765
2020-04-10,Calabria,168,14,182,604,786,21,27,50,65,901,16637,,IT,IT_78,0,22,2,4,939,786
2020-04-11,Calabria,169,15,184,608,792,6,14,57,66,915,17493,,IT,IT_78,1,4,7,1,856,792
2020-04-12,Calabria,165,14,179,616,795,3,8,62,66,923,18211,,IT,IT_78,-4,8,5,0,718,795
2020-04-13,Calabria,160,12,172,619,791,-4,5,70,67,928,18596,,IT,IT_78,-5,3,8,1,385,791
2020-04-14,Calabria,161,12,173,643,816,25,28,72,68,956,19014,,IT,IT_78,1,24,2,1,418,816
2020-04-15,Calabria,156,11,167,652,819,3,15,81,71,971,19662,,IT,IT_78,-5,9,9,3,648,819
2020-04-16,Calabria,157,9,166,681,847,28,38,90,72,1009,20642,,IT,IT_78,1,29,9,1,980,847
2020-04-17,Calabria,154,7,161,658,819,-28,-18,99,73,991,21657,,IT,IT_78,-3,-23,9,1,1015,819
2020-04-18,Calabria,152,7,159,673,832,13,20,106,73,1011,22794,,IT,IT_78,-2,15,7,0,1137,832
2020-04-19,Calabria,142,6,148,696,844,12,24,116,75,1035,23760,22234,IT,IT_78,-10,23,10,2,966,844
2020-04-20,Calabria,140,7,147,681,828,-16,3,135,75,1038,24373,22847,IT,IT_78,-2,-15,19,0,613,828
2020-04-21,Calabria,133,7,140,679,819,-9,9,152,76,1047,25440,23914,IT,IT_78,-7,-2,17,1,1067,819
2020-04-22,Calabria,128,7,135,686,821,2,13,163,76,1060,26560,24878,IT,IT_78,-5,7,11,0,1120,821
2020-04-23,Calabria,129,7,136,687,823,2,9,170,76,1069,27869,26187,IT,IT_78,1,1,7,0,1309,823
2020-04-24,Calabria,123,7,130,691,821,-2,10,178,80,1079,28764,26811,IT,IT_78,-6,4,8,4,895,821
2020-04-25,Calabria,125,7,132,679,811,-10,9,197,80,1088,29959,28006,IT,IT_78,2,-12,19,0,1195,811
2020-04-26,Calabria,118,8,126,671,797,-14,1,212,80,1089,30853,28900,IT,IT_78,-7,-8,15,0,894,797
2020-04-27,Calabria,114,6,120,662,782,-15,7,231,83,1096,31787,29834,IT,IT_78,-4,-9,19,3,934,782
2020-04-28,Calabria,113,6,119,645,764,-18,1,248,85,1097,33755,31802,IT,IT_78,-1,-17,17,2,1968,764
2020-04-29,Calabria,107,6,113,640,753,-11,5,263,86,1102,34914,32961,IT,IT_78,-6,-5,15,1,1159,753
2020-04-30,Calabria,105,6,111,629,740,-13,6,282,86,1108,35903,33950,IT,IT_78,-2,-11,19,0,989,740
2020-05-01,Calabria,105,3,108,619,727,-13,4,299,86,1112,37054,35101,IT,IT_78,0,-10,17,0,1151,727
2020-05-02,Calabria,100,4,104,609,713,-14,0,311,88,1112,37928,35975,IT,IT_78,-5,-10,12,2,874,713
2020-05-03,Calabria,95,4,99,603,702,-11,2,324,88,1114,38835,36874,IT,IT_78,-5,-6,13,0,907,702
2020-05-04,Calabria,93,4,97,577,674,-28,4,356,88,1118,39438,37390,IT,IT_78,-2,-26,32,0,603,674
2020-05-05,Calabria,92,4,96,554,650,-24,1,381,88,1119,40509,38461,IT,IT_78,-1,-23,25,0,1071,650
2020-05-06,Calabria,87,3,90,554,644,-6,3,389,89,1122,41828,39780,IT,IT_78,-5,0,8,1,1319,644
2020-05-07,Calabria,81,2,83,550,633,-11,3,403,89,1125,42854,40806,IT,IT_78,-6,-4,14,0,1026,633
2020-05-08,Calabria,73,2,75,544,619,-14,1,417,90,1126,43980,41902,IT,IT_78,-8,-6,14,1,1126,619
2020-05-09,Calabria,68,2,70,542,612,-7,3,427,90,1129,45071,42993,IT,IT_78,-5,-2,10,0,1091,612
2020-05-10,Calabria,66,2,68,528,596,-16,3,445,91,1132,46111,44284,IT,IT_78,-2,-14,18,1,1040,596
2020-05-11,Calabria,64,1,65,503,568,-28,2,473,93,1134,47265,45438,IT,IT_78,-2,-25,28,2,1154,568
2020-05-12,Calabria,65,1,66,502,568,0,4,477,93,1138,48420,46593,IT,IT_78,1,-1,4,0,1155,568
2020-05-13,Calabria,64,1,65,486,551,-17,2,496,93,1140,49787,47960,IT,IT_78,-1,-16,19,0,1367,551
2020-05-14,Calabria,59,2,61,463,524,-27,3,524,95,1143,51050,49196,IT,IT_78,-5,-23,28,2,1263,524
2020-05-15,Calabria,56,2,58,447,505,-19,1,544,95,1144,52701,50847,IT,IT_78,-3,-16,20,0,1651,505
2020-05-16,Calabria,56,2,58,416,474,-31,7,582,95,1151,54091,52257,IT,IT_78,0,-31,38,0,1390,474
2020-05-17,Calabria,56,2,58,364,422,-52,0,634,95,1151,55304,53470,IT,IT_78,0,-52,52,0,1213,422
2020-05-18,Calabria,53,2,55,346,401,-21,0,655,95,1151,56167,54333,IT,IT_78,-3,-18,21,0,863,401
2020-05-19,Calabria,50,2,52,330,382,-19,2,676,95,1153,57310,55270,IT,IT_78,-3,-16,21,0,1143,382
2020-05-20,Calabria,49,1,50,303,353,-29,3,707,96,1156,58468,56209,IT,IT_78,-1,-27,31,1,1158,353
2020-05-21,Calabria,47,1,48,278,326,-27,0,734,96,1156,59724,57465,IT,IT_78,-2,-25,27,0,1256,326
2020-05-22,Calabria,47,1,48,254,302,-24,1,759,96,1157,60847,58588,IT,IT_78,0,-24,25,0,1123,302
2020-05-23,Calabria,43,1,44,244,288,-14,0,773,96,1157,61892,59633,IT,IT_78,-4,-10,14,0,1045,288
2020-05-24,Calabria,43,1,44,231,275,-13,0,786,96,1157,62952,60693,IT,IT_78,0,-13,13,0,1060,275
2020-05-25,Calabria,42,1,43,221,264,-11,0,797,96,1157,63508,61249,IT,IT_78,-1,-10,11,0,556,264
2020-05-26,Calabria,41,1,42,196,238,-26,0,823,96,1157,64514,62255,IT,IT_78,-1,-25,26,0,1006,238
2020-05-27,Calabria,35,1,36,154,190,-48,1,872,96,1158,65631,63372,IT,IT_78,-6,-42,49,0,1117,190
2020-05-28,Calabria,31,1,32,138,170,-20,0,892,96,1158,66956,64697,IT,IT_78,-4,-16,20,0,1325,170
2020-05-29,Calabria,25,1,26,133,159,-11,0,902,97,1158,68131,65872,IT,IT_78,-6,-5,10,1,1175,159
2020-05-30,Calabria,23,1,24,127,151,-8,0,910,97,1158,69334,67075,IT,IT_78,-2,-6,8,0,1203,151
2020-05-31,Calabria,22,1,23,121,144,-7,0,917,97,1158,70274,68015,IT,IT_78,-1,-6,7,0,940,144
2020-06-01,Calabria,20,1,21,114,135,-9,0,926,97,1158,70892,68633,IT,IT_78,-2,-7,9,0,618,135
2020-06-02,Calabria,20,1,21,91,112,-23,0,949,97,1158,71617,69419,IT,IT_78,0,-23,23,0,725,112
2020-06-03,Calabria,20,0,20,90,110,-2,0,951,97,1158,72237,69978,IT,IT_78,0,-1,2,0,620,110
2020-06-04,Calabria,19,0,19,83,102,-8,0,959,97,1158,73072,70813,IT,IT_78,-1,-7,8,0,835,102
2020-06-05,Calabria,18,0,18,79,97,-5,1,965,97,1159,74186,72124,IT,IT_78,-1,-4,6,0,1114,97
2020-06-06,Calabria,18,0,18,73,91,-6,0,971,97,1159,75290,73228,IT,IT_78,0,-6,6,0,1104,91
2020-06-07,Calabria,18,0,18,73,91,0,0,971,97,1159,76142,74080,IT,IT_78,0,0,0,0,852,91
2020-06-08,Calabria,18,0,18,59,77,-14,0,985,97,1159,76501,74439,IT,IT_78,0,-14,14,0,359,77
2020-06-09,Calabria,18,0,18,50,68,-9,0,994,97,1159,77216,75154,IT,IT_78,0,-9,9,0,715,68
2020-06-10,Calabria,18,0,18,36,54,-14,0,1008,97,1159,78174,76112,IT,IT_78,0,-14,14,0,958,54
2020-06-11,Calabria,16,1,17,35,52,-2,2,1012,97,1161,79025,76963,IT,IT_78,-2,-1,4,0,851,52
2020-06-12,Calabria,16,1,17,30,47,-5,0,1017,97,1161,80063,78001,IT,IT_78,0,-5,5,0,1038,47
2020-06-13,Calabria,15,1,16,29,45,-2,1,1020,97,1162,81255,79193,IT,IT_78,-1,-1,3,0,1192,45
2020-06-14,Calabria,15,1,16,28,44,-1,0,1021,97,1162,81981,79919,IT,IT_78,0,-1,1,0,726,44
2020-06-15,Calabria,17,1,18,19,37,-7,0,1028,97,1162,82392,80330,IT,IT_78,2,-9,7,0,411,37
2020-06-16,Calabria,18,0,18,18,36,-1,0,1029,97,1162,83281,81219,IT,IT_78,1,-1,1,0,889,36
2020-06-17,Calabria,18,0,18,15,33,-3,0,1032,97,1162,84265,82203,IT,IT_78,0,-3,3,0,984,33
2020-06-18,Calabria,18,0,18,17,35,2,3,1033,97,1165,85222,83171,IT,IT_78,0,2,1,0,957,35
2020-06-19,Calabria,18,0,18,16,34,-1,0,1034,97,1165,86273,84222,IT,IT_78,0,-1,1,0,1051,34
2020-06-20,Calabria,18,0,18,12,30,-4,3,1040,97,1167,87292,85241,IT,IT_78,0,-4,6,0,1019,30
2020-02-24,Campania,0,0,0,0,0,0,0,0,0,0,10,,IT,IT_72,,,,,,0
2020-02-25,Campania,0,0,0,0,0,0,0,0,0,0,10,,IT,IT_72,0,0,0,0,0,0
2020-02-26,Campania,0,0,0,0,0,0,0,0,0,0,10,,IT,IT_72,0,0,0,0,0,0
2020-02-27,Campania,2,0,2,1,3,3,3,0,0,3,10,,IT,IT_72,2,1,0,0,0,3
2020-02-28,Campania,2,0,2,2,4,1,1,0,0,4,213,,IT,IT_72,0,1,0,0,203,4
2020-02-29,Campania,3,0,3,10,13,9,9,0,0,13,373,,IT,IT_72,1,8,0,0,160,13
2020-03-01,Campania,4,0,4,13,17,4,4,0,0,17,373,,IT,IT_72,1,3,0,0,0,17
2020-03-02,Campania,4,0,4,13,17,0,0,0,0,17,373,,IT,IT_72,0,0,0,0,0,17
2020-03-03,Campania,11,0,11,19,30,13,13,0,0,30,405,,IT,IT_72,7,6,0,0,32,30
2020-03-04,Campania,11,0,11,20,31,1,1,0,0,31,429,,IT,IT_72,0,1,0,0,24,31
2020-03-05,Campania,12,0,12,33,45,14,14,0,0,45,471,,IT,IT_72,1,13,0,0,42,45
2020-03-06,Campania,12,0,12,45,57,12,12,0,0,57,471,,IT,IT_72,0,12,0,0,0,57
2020-03-07,Campania,16,0,16,45,61,4,4,0,0,61,612,,IT,IT_72,4,0,0,0,141,61
2020-03-08,Campania,30,7,37,63,100,39,40,1,0,101,980,,IT,IT_72,14,18,1,0,368,100
2020-03-09,Campania,42,8,50,69,119,19,19,1,0,120,980,,IT,IT_72,12,6,0,0,0,119
2020-03-10,Campania,33,8,41,85,126,7,7,1,0,127,1141,,IT,IT_72,-9,16,0,0,161,126
2020-03-11,Campania,56,11,67,82,149,23,27,4,1,154,1375,,IT,IT_72,23,-3,3,1,234,149
2020-03-12,Campania,56,11,67,107,174,25,25,4,1,179,1551,,IT,IT_72,0,25,0,0,176,174
2020-03-13,Campania,60,19,79,134,213,39,41,5,2,220,1671,,IT,IT_72,4,27,1,1,120,213
2020-03-14,Campania,72,17,89,154,243,30,52,23,6,272,1936,,IT,IT_72,12,20,18,4,265,243
2020-03-15,Campania,73,22,95,201,296,53,61,28,9,333,2213,,IT,IT_72,1,47,5,3,277,296
2020-03-16,Campania,103,22,125,238,363,67,67,28,9,400,2517,,IT,IT_72,30,37,0,0,304,363
2020-03-17,Campania,127,24,151,272,423,60,60,28,9,460,2685,,IT,IT_72,24,34,0,0,168,423
2020-03-18,Campania,127,24,151,272,423,0,0,28,9,460,2685,,IT,IT_72,0,0,0,0,0,423
2020-03-19,Campania,213,36,249,356,605,182,192,30,17,652,3544,,IT,IT_72,86,84,2,8,859,605
2020-03-20,Campania,130,41,171,531,702,97,97,30,17,749,3845,,IT,IT_72,-83,175,0,0,301,702
2020-03-21,Campania,233,87,320,473,793,91,95,29,22,844,4448,,IT,IT_72,103,-58,-1,5,603,793
2020-03-22,Campania,243,99,342,524,866,73,92,41,29,936,4943,,IT,IT_72,10,51,12,7,495,866
2020-03-23,Campania,266,110,376,553,929,63,90,48,49,1026,5813,,IT,IT_72,23,29,7,20,870,929
2020-03-24,Campania,345,181,526,466,992,63,75,53,56,1101,6297,,IT,IT_72,79,-87,5,7,484,992
2020-03-25,Campania,318,123,441,631,1072,80,98,53,74,1199,6972,,IT,IT_72,-27,165,0,18,675,1072
2020-03-26,Campania,448,114,562,607,1169,97,111,58,83,1310,8346,,IT,IT_72,130,-24,5,9,1374,1169
2020-03-27,Campania,456,113,569,723,1292,123,144,64,98,1454,9613,,IT,IT_72,8,116,6,15,1267,1292
2020-03-28,Campania,463,132,595,812,1407,115,138,76,109,1592,10616,,IT,IT_72,7,89,12,11,1003,1407
2020-03-29,Campania,476,135,611,945,1556,149,167,86,117,1759,11805,,IT,IT_72,13,133,10,8,1189,1556
2020-03-30,Campania,468,126,594,1145,1739,183,193,88,125,1952,12969,,IT,IT_72,-8,200,2,8,1164,1739
2020-03-31,Campania,501,133,634,1237,1871,132,140,88,133,2092,14403,,IT,IT_72,33,92,0,8,1434,1871
2020-04-01,Campania,478,129,607,1369,1976,105,139,107,148,2231,15728,,IT,IT_72,-23,132,19,15,1325,1976
2020-04-02,Campania,503,120,623,1517,2140,164,225,149,167,2456,17404,,IT,IT_72,25,148,42,19,1676,2140
2020-04-03,Campania,532,115,647,1705,2352,212,221,144,181,2677,19237,,IT,IT_72,29,188,-5,14,1833,2352
2020-04-04,Campania,567,114,681,1815,2496,144,151,146,186,2828,21534,,IT,IT_72,35,110,2,5,2297,2496
2020-04-05,Campania,609,108,717,1904,2621,125,132,150,189,2960,23139,,IT,IT_72,42,89,4,3,1605,2621
2020-04-06,Campania,610,101,711,1987,2698,77,98,156,204,3058,24526,,IT,IT_72,1,83,6,15,1387,2698
2020-04-07,Campania,603,103,706,2059,2765,67,90,167,216,3148,25779,,IT,IT_72,-7,72,11,12,1253,2765
2020-04-08,Campania,608,97,705,2154,2859,94,120,188,221,3268,27784,,IT,IT_72,5,95,21,5,2005,2859
2020-04-09,Campania,604,94,698,2175,2873,14,76,244,227,3344,29664,,IT,IT_72,-4,21,56,6,1880,2873
2020-04-10,Campania,600,90,690,2273,2963,90,98,248,231,3442,31745,,IT,IT_72,-4,98,4,4,2081,2963
2020-04-11,Campania,582,85,667,2335,3002,39,75,277,238,3517,33781,,IT,IT_72,-18,62,29,7,2036,3002
2020-04-12,Campania,526,82,608,2449,3057,55,87,305,242,3604,35448,,IT,IT_72,-56,114,28,4,1667,3057
2020-04-13,Campania,606,80,686,2376,3062,5,66,360,248,3670,36770,,IT,IT_72,80,-73,55,6,1322,3062
2020-04-14,Campania,618,82,700,2394,3094,32,99,415,260,3769,38094,,IT,IT_72,12,18,55,12,1324,3094
2020-04-15,Campania,607,86,693,2394,3087,-7,38,442,278,3807,39534,,IT,IT_72,-11,0,27,18,1440,3087
2020-04-16,Campania,618,76,694,2424,3118,31,80,483,286,3887,41296,,IT,IT_72,11,30,41,8,1762,3118
2020-04-17,Campania,622,76,698,2329,3027,-91,64,631,293,3951,43697,,IT,IT_72,4,-95,148,7,2401,3027
2020-04-18,Campania,605,76,681,2364,3045,18,37,643,300,3988,46294,,IT,IT_72,-17,35,12,7,2597,3045
2020-04-19,Campania,590,61,651,2371,3022,-23,41,703,304,4029,48187,34994,IT,IT_72,-15,7,60,4,1893,3022
2020-04-20,Campania,586,61,647,2372,3019,-3,45,746,309,4074,51090,36153,IT,IT_72,-4,1,43,5,2903,3019
2020-04-21,Campania,532,58,590,2356,2946,-73,61,872,317,4135,53548,37505,IT,IT_72,-54,-16,126,8,2458,2946
2020-04-22,Campania,523,53,576,2422,2998,52,50,860,327,4185,55701,38679,IT,IT_72,-9,66,-12,10,2153,2998
2020-04-23,Campania,539,47,586,2392,2978,-20,53,928,332,4238,58324,38679,IT,IT_72,16,-30,68,5,2623,2978
2020-04-24,Campania,524,44,568,2375,2943,-35,44,1003,336,4282,61331,40053,IT,IT_72,-15,-17,75,4,3007,2943
2020-04-25,Campania,543,55,598,2337,2935,-8,17,1023,341,4299,64521,41399,IT,IT_72,19,-38,20,5,3190,2935
2020-04-26,Campania,536,45,581,2343,2924,-11,32,1062,345,4331,67218,42279,IT,IT_72,-7,6,39,4,2697,2924
2020-04-27,Campania,541,37,578,2299,2877,-47,18,1120,352,4349,68727,42463,IT,IT_72,5,-44,58,7,1509,2877
2020-04-28,Campania,544,33,577,2225,2802,-75,31,1220,358,4380,70566,42690,IT,IT_72,3,-74,100,6,1839,2802
2020-04-29,Campania,518,31,549,2233,2782,-20,30,1269,359,4410,73094,43449,IT,IT_72,-26,8,49,1,2528,2782
2020-04-30,Campania,484,29,513,2260,2773,-9,13,1291,359,4423,76108,44233,IT,IT_72,-34,27,22,0,3014,2773
2020-05-01,Campania,478,29,507,2246,2753,-20,21,1332,359,4444,79940,44975,IT,IT_72,-6,-14,41,0,3832,2753
2020-05-02,Campania,470,27,497,2224,2721,-32,15,1376,362,4459,83592,45955,IT,IT_72,-8,-22,44,3,3652,2721
2020-05-03,Campania,455,30,485,2241,2726,5,25,1394,364,4484,86498,47027,IT,IT_72,-15,17,18,2,2906,2726
2020-05-04,Campania,438,24,462,2249,2711,-15,14,1421,366,4498,90543,48275,IT,IT_72,-17,8,27,2,4045,2711
2020-05-05,Campania,408,25,433,2097,2530,-181,20,1619,369,4518,93068,48733,IT,IT_72,-30,-152,198,3,2525,2530
2020-05-06,Campania,433,25,458,1882,2340,-190,14,1816,376,4532,96548,49478,IT,IT_72,25,-215,197,7,3480,2340
2020-05-07,Campania,415,27,442,1697,2139,-201,9,2023,379,4541,101025,50463,IT,IT_72,-18,-185,207,3,4477,2139
2020-05-08,Campania,418,28,446,1566,2012,-127,21,2164,386,4562,105399,51402,IT,IT_72,3,-131,141,7,4374,2012
2020-05-09,Campania,415,26,441,1524,1965,-47,14,2223,388,4576,110811,52593,IT,IT_72,-3,-42,59,2,5412,1965
2020-05-10,Campania,435,20,455,1460,1915,-50,12,2282,391,4588,114819,53475,IT,IT_72,20,-64,59,3,4008,1915
2020-05-11,Campania,436,23,459,1450,1909,-6,14,2301,392,4602,119042,54822,IT,IT_72,1,-10,19,1,4223,1909
2020-05-12,Campania,414,20,434,1443,1877,-32,13,2345,393,4615,121253,55406,IT,IT_72,-22,-7,44,1,2211,1877
2020-05-13,Campania,402,19,421,1394,1815,-62,15,2421,394,4630,124370,56390,IT,IT_72,-12,-49,76,1,3117,1815
2020-05-14,Campania,387,19,406,1359,1765,-50,9,2480,394,4639,127938,57684,IT,IT_72,-15,-35,59,0,3568,1765
2020-05-15,Campania,341,17,358,1378,1736,-29,15,2522,396,4654,131544,59162,IT,IT_72,-46,19,42,2,3606,1736
2020-05-16,Campania,351,16,367,1343,1710,-26,14,2562,396,4668,136261,61574,IT,IT_72,10,-35,40,0,4717,1710
2020-05-17,Campania,342,17,359,1337,1696,-14,16,2592,396,4684,139787,63039,IT,IT_72,-9,-6,30,0,3526,1696
2020-05-18,Campania,342,17,359,1314,1673,-23,11,2623,399,4695,143478,67155,IT,IT_72,0,-23,31,3,3691,1673
2020-05-19,Campania,330,17,347,1171,1518,-155,12,2790,399,4707,147225,69264,IT,IT_72,-12,-143,167,0,3747,1518
2020-05-20,Campania,318,12,330,1112,1442,-76,7,2871,401,4714,150764,71118,IT,IT_72,-12,-59,81,2,3539,1442
2020-05-21,Campania,312,9,321,1052,1373,-69,9,2947,403,4723,155842,73912,IT,IT_72,-6,-60,76,2,5078,1373
2020-05-22,Campania,312,9,321,971,1292,-81,10,3037,404,4733,161825,76907,IT,IT_72,0,-81,90,1,5983,1292
2020-05-23,Campania,295,10,305,968,1273,-19,11,3067,404,4744,166692,79655,IT,IT_72,-17,-3,30,0,4867,1273
2020-05-24,Campania,311,8,319,949,1268,-5,5,3076,405,4749,172106,80942,IT,IT_72,16,-19,9,1,5414,1268
2020-05-25,Campania,287,7,294,919,1213,-55,6,3137,405,4755,175466,82786,IT,IT_72,-24,-30,61,0,3360,1213
2020-05-26,Campania,286,5,291,893,1184,-29,12,3178,405,4767,179845,85780,IT,IT_72,-1,-26,41,0,4379,1184
2020-05-27,Campania,275,6,281,865,1146,-38,6,3221,406,4773,185724,88874,IT,IT_72,-11,-28,43,1,5879,1146
2020-05-28,Campania,260,6,266,746,1012,-134,4,3355,410,4777,189068,90670,IT,IT_72,-15,-119,134,4,3344,1012
2020-05-29,Campania,236,7,243,743,986,-26,10,3390,411,4787,193669,93464,IT,IT_72,-24,-3,35,1,4601,986
2020-05-30,Campania,236,7,243,738,981,-5,10,3405,411,4797,198033,95903,IT,IT_72,0,-5,15,0,4364,981
2020-05-31,Campania,227,5,232,748,980,-1,5,3410,412,4802,201543,98096,IT,IT_72,-9,10,5,1,3510,980
2020-06-01,Campania,224,6,230,709,939,-41,4,3454,413,4806,203858,99580,IT,IT_72,-3,-39,44,1,2315,939
2020-06-02,Campania,236,7,243,647,890,-49,3,3504,415,4809,206834,100269,IT,IT_72,12,-62,50,2,2976,890
2020-06-03,Campania,206,4,210,659,869,-21,12,3537,415,4821,208854,101664,IT,IT_72,-30,12,33,0,2020,869
2020-06-04,Campania,160,5,165,665,830,-39,1,3572,420,4822,210001,102305,IT,IT_72,-46,6,35,5,1147,830
2020-06-05,Campania,133,7,140,634,774,-56,0,3623,425,4822,212486,104169,IT,IT_72,-27,-31,51,5,2485,774
2020-06-06,Campania,97,7,104,634,738,-36,0,3658,426,4822,215404,105814,IT,IT_72,-36,0,35,1,2918,738
2020-06-07,Campania,86,6,92,633,725,-13,4,3675,426,4826,217898,108785,IT,IT_72,-11,-1,17,0,2494,725
2020-06-08,Campania,82,6,88,629,717,-8,2,3685,426,4828,219033,109534,IT,IT_72,-4,-4,10,0,1135,717
2020-06-09,Campania,73,3,76,599,675,-42,5,3732,426,4833,220662,110583,IT,IT_72,-9,-30,47,0,1629,675
2020-06-10,Campania,74,2,76,566,642,-33,1,3764,428,4834,223302,112309,IT,IT_72,1,-33,32,2,2640,642
2020-06-11,Campania,74,2,76,534,610,-32,3,3797,430,4837,226823,114073,IT,IT_72,0,-32,33,2,3521,610
2020-06-12,Campania,61,2,63,283,346,-264,-229,3832,430,4608,230551,115842,IT,IT_72,-13,-251,35,0,3728,346
2020-06-13,Campania,67,2,69,268,337,-9,0,3841,430,4608,234666,118820,IT,IT_72,6,-15,9,0,4115,337
2020-06-14,Campania,53,2,55,264,319,-18,1,3860,430,4609,240290,121618,IT,IT_72,-14,-4,19,0,5624,319
2020-06-15,Campania,58,2,60,229,289,-30,4,3894,430,4613,241380,122291,IT,IT_72,5,-35,34,0,1090,289
2020-06-16,Campania,57,2,59,214,273,-16,0,3910,430,4613,242662,123167,IT,IT_72,-1,-15,16,0,1282,273
2020-06-17,Campania,48,2,50,208,258,-15,1,3925,431,4614,258207,124041,IT,IT_72,-9,-6,15,1,15545,258
2020-06-18,Campania,52,6,58,184,242,-16,1,3942,431,4615,259655,124683,IT,IT_72,4,-24,17,0,1448,242
2020-06-19,Campania,47,3,50,75,125,-117,0,4059,431,4615,261642,125525,IT,IT_72,-5,-109,117,0,1987,125
2020-06-20,Campania,48,1,49,76,125,0,0,4059,431,4615,263560,126398,IT,IT_72,1,1,0,0,1918,125
2020-02-24,Emilia-Romagna,10,2,12,6,18,0,18,0,0,18,148,,IT,IT_45,,,,,,0
2020-02-25,Emilia-Romagna,15,2,17,9,26,8,8,0,0,26,391,,IT,IT_45,5,3,0,0,243,8
2020-02-26,Emilia-Romagna,20,3,23,23,46,20,21,0,1,47,577,,IT,IT_45,5,14,0,1,186,28
2020-02-27,Emilia-Romagna,36,6,42,54,96,50,50,0,1,97,1033,,IT,IT_45,16,31,0,0,456,78
2020-02-28,Emilia-Romagna,56,6,62,81,143,47,48,0,2,145,1277,,IT,IT_45,20,27,0,1,244,125
2020-02-29,Emilia-Romagna,86,11,97,116,213,70,72,0,4,217,1550,,IT,IT_45,30,35,0,2,273,195
2020-03-01,Emilia-Romagna,127,13,140,137,277,64,68,0,8,285,1795,,IT,IT_45,41,21,0,4,245,259
2020-03-02,Emilia-Romagna,148,16,164,160,324,47,50,0,11,335,1973,,IT,IT_45,21,23,0,3,178,306
2020-03-03,Emilia-Romagna,187,24,211,187,398,74,85,4,18,420,2012,,IT,IT_45,39,27,4,7,39,380
2020-03-04,Emilia-Romagna,256,26,282,234,516,118,124,6,22,544,2500,,IT,IT_45,69,47,2,4,488,498
2020-03-05,Emilia-Romagna,327,32,359,299,658,142,154,10,30,698,2884,,IT,IT_45,71,65,4,8,384,640
2020-03-06,Emilia-Romagna,397,53,450,366,816,158,172,17,37,870,3136,,IT,IT_45,70,67,7,7,252,798
2020-03-07,Emilia-Romagna,464,64,528,409,937,121,140,25,48,1010,3604,,IT,IT_45,67,43,8,11,468,919
2020-03-08,Emilia-Romagna,542,75,617,480,1097,160,170,27,56,1180,4344,,IT,IT_45,78,71,2,8,740,1079
2020-03-09,Emilia-Romagna,576,90,666,620,1286,189,206,30,70,1386,4906,,IT,IT_45,34,140,3,14,562,1268
2020-03-10,Emilia-Romagna,669,98,767,650,1417,131,147,31,85,1533,5494,,IT,IT_45,93,30,1,15,588,1399
2020-03-11,Emilia-Romagna,745,104,849,739,1588,171,206,38,113,1739,6640,,IT,IT_45,76,89,7,28,1146,1570
2020-03-12,Emilia-Romagna,814,112,926,832,1758,170,208,43,146,1947,7600,,IT,IT_45,69,93,5,33,960,1740
2020-03-13,Emilia-Romagna,942,128,1070,941,2011,253,316,51,201,2263,8787,,IT,IT_45,128,109,8,55,1187,1993
2020-03-14,Emilia-Romagna,1076,152,1228,1121,2349,338,381,54,241,2644,10043,,IT,IT_45,134,180,3,40,1256,2331
2020-03-15,Emilia-Romagna,1215,169,1384,1357,2741,392,449,68,284,3093,12054,,IT,IT_45,139,236,14,43,2011,2723
2020-03-16,Emilia-Romagna,1362,197,1559,1529,3088,347,429,88,346,3522,13096,,IT,IT_45,147,172,20,62,1042,3070
2020-03-17,Emilia-Romagna,1566,223,1789,1615,3404,316,409,134,393,3931,14510,,IT,IT_45,204,86,46,47,1414,3386
2020-03-18,Emilia-Romagna,1784,247,2031,1884,3915,511,594,152,458,4525,15461,,IT,IT_45,218,269,18,65,951,3897
2020-03-19,Emilia-Romagna,1900,260,2160,2346,4506,591,689,177,531,5214,18344,,IT,IT_45,116,462,25,73,2883,4488
2020-03-20,Emilia-Romagna,2083,267,2350,2739,5089,583,754,239,640,5968,20753,,IT,IT_45,183,393,62,109,2409,5071
2020-03-21,Emilia-Romagna,2267,265,2532,3129,5661,572,737,329,715,6705,24620,,IT,IT_45,184,390,90,75,3867,5643
2020-03-22,Emilia-Romagna,2429,269,2698,3692,6390,729,850,349,816,7555,28022,,IT,IT_45,162,563,20,101,3402,6372
2020-03-23,Emilia-Romagna,2846,276,3122,4098,7220,830,980,423,892,8535,31200,,IT,IT_45,417,406,74,76,3178,7202
2020-03-24,Emilia-Romagna,2974,291,3265,4446,7711,491,719,558,985,9254,33527,,IT,IT_45,128,348,135,93,2327,7693
2020-03-25,Emilia-Romagna,3180,294,3474,4782,8256,545,800,721,1077,10054,38045,,IT,IT_45,206,336,163,92,4518,8238
2020-03-26,Emilia-Romagna,3354,301,3655,5195,8850,594,762,792,1174,10816,42395,,IT,IT_45,174,413,71,97,4350,8832
2020-03-27,Emilia-Romagna,3461,308,3769,5592,9361,511,772,960,1267,11588,47798,,IT,IT_45,107,397,168,93,5403,9343
2020-03-28,Emilia-Romagna,3695,316,4011,5953,9964,603,795,1075,1344,12383,52991,,IT,IT_45,234,361,115,77,5193,9946
2020-03-29,Emilia-Romagna,3769,333,4102,6433,10535,571,736,1141,1443,13119,52991,,IT,IT_45,74,480,66,99,0,10517
2020-03-30,Emilia-Romagna,3779,351,4130,6636,10766,231,412,1227,1538,13531,50990,,IT,IT_45,10,203,86,95,-2001,10748
2020-03-31,Emilia-Romagna,3765,353,4118,6835,10953,187,543,1477,1644,14074,54532,,IT,IT_45,-14,199,250,106,3542,10935
2020-04-01,Emilia-Romagna,3898,359,4257,7232,11489,536,713,1566,1732,14787,58457,,IT,IT_45,133,397,89,88,3925,11471
2020-04-02,Emilia-Romagna,3944,366,4310,7549,11859,370,546,1663,1811,15333,60507,,IT,IT_45,46,317,97,79,2050,11841
2020-04-03,Emilia-Romagna,3915,364,4279,7899,12178,319,599,1852,1902,15932,63682,,IT,IT_45,-29,350,189,91,3175,12160
2020-04-04,Emilia-Romagna,3859,358,4217,8306,12523,345,608,2040,1977,16540,67075,,IT,IT_45,-56,407,188,75,3393,12505
2020-04-05,Emilia-Romagna,3839,375,4214,8623,12837,314,549,2201,2051,17089,69986,,IT,IT_45,-20,317,161,74,2911,12819
2020-04-06,Emilia-Romagna,3804,372,4176,8875,13051,214,467,2397,2108,17556,72163,,IT,IT_45,-35,252,196,57,2177,13033
2020-04-07,Emilia-Romagna,3750,366,4116,8932,13048,-3,269,2597,2180,17825,75191,,IT,IT_45,-54,57,200,72,3028,13030
2020-04-08,Emilia-Romagna,3769,361,4130,8980,13110,62,409,2890,2234,18234,78367,,IT,IT_45,19,48,293,54,3176,13092
2020-04-09,Emilia-Romagna,3722,355,4077,9181,13258,148,443,3103,2316,18677,81715,,IT,IT_45,-47,201,213,82,3348,13240
2020-04-10,Emilia-Romagna,3596,349,3945,9405,13350,92,451,3381,2397,19128,85884,,IT,IT_45,-126,224,278,81,4169,13332
2020-04-11,Emilia-Romagna,3530,341,3871,9624,13495,145,507,3659,2481,19635,91759,,IT,IT_45,-66,219,278,84,5875,13477
2020-04-12,Emilia-Romagna,3491,335,3826,9846,13672,177,463,3862,2564,20098,96704,,IT,IT_45,-39,222,203,83,4945,13654
2020-04-13,Emilia-Romagna,3490,331,3821,9997,13818,146,342,4007,2615,20440,99047,,IT,IT_45,-1,151,145,51,2343,13800
2020-04-14,Emilia-Romagna,3473,328,3801,9977,13778,-40,312,4269,2705,20752,101896,,IT,IT_45,-17,-20,262,90,2849,13760
2020-04-15,Emilia-Romagna,3388,325,3713,9864,13577,-201,277,4664,2788,21029,106149,,IT,IT_45,-85,-113,395,83,4253,13559
2020-04-16,Emilia-Romagna,3360,316,3676,9987,13663,86,457,4980,2843,21486,112105,,IT,IT_45,-28,123,316,55,5956,13645
2020-04-17,Emilia-Romagna,3330,309,3639,9946,13585,-78,348,5346,2903,21834,116826,,IT,IT_45,-30,-41,366,60,4721,13567
2020-04-18,Emilia-Romagna,3234,296,3530,10054,13584,-1,350,5635,2965,22184,121220,,IT,IT_45,-96,108,289,62,4394,13566
2020-04-19,Emilia-Romagna,3166,289,3455,10097,13552,-32,376,5985,3023,22560,124916,88776,IT,IT_45,-68,43,350,58,3696,13534
2020-04-20,Emilia-Romagna,3144,283,3427,10095,13522,-30,307,6266,3079,22867,129530,90894,IT,IT_45,-22,-2,281,56,4614,13504
2020-04-21,Emilia-Romagna,3045,282,3327,9917,13244,-278,225,6701,3147,23092,134878,93367,IT,IT_45,-99,-178,435,68,5348,13226
2020-04-22,Emilia-Romagna,2964,282,3246,9838,13084,-160,342,7146,3204,23434,140874,96824,IT,IT_45,-81,-79,445,57,5996,13066
2020-04-23,Emilia-Romagna,2889,266,3155,9690,12845,-239,289,7609,3269,23723,146146,99714,IT,IT_45,-75,-148,463,65,5272,12827
2020-04-24,Emilia-Romagna,2807,264,3071,9438,12509,-336,247,8158,3303,23970,151505,102495,IT,IT_45,-82,-252,549,34,5359,12491
2020-04-25,Emilia-Romagna,2718,246,2964,9383,12347,-162,239,8515,3347,24209,156883,105628,IT,IT_45,-89,-55,357,44,5378,12329
2020-04-26,Emilia-Romagna,2695,245,2940,9401,12341,-6,241,8723,3386,24450,161928,109192,IT,IT_45,-23,18,208,39,5045,12323
2020-04-27,Emilia-Romagna,2640,247,2887,9338,12225,-116,212,9006,3431,24662,164979,111041,IT,IT_45,-55,-63,283,45,3051,12207
2020-04-28,Emilia-Romagna,2574,228,2802,9201,12003,-222,252,9439,3472,24914,172589,116624,IT,IT_45,-66,-137,433,41,7610,11985
2020-04-29,Emilia-Romagna,2527,226,2753,9109,11862,-141,263,9803,3512,25177,176865,118881,IT,IT_45,-47,-92,364,40,4276,11844
2020-04-30,Emilia-Romagna,2146,206,2352,7211,9563,-2299,259,12322,3551,25436,182857,122430,IT,IT_45,-381,-1898,2519,39,5992,9545
2020-05-01,Emilia-Romagna,2112,197,2309,7175,9484,-79,208,12581,3579,25644,188264,125636,IT,IT_45,-34,-36,259,28,5407,9466
2020-05-02,Emilia-Romagna,2033,196,2229,7094,9323,-161,206,12913,3614,25850,192135,128005,IT,IT_45,-79,-81,332,35,3871,9305
2020-05-03,Emilia-Romagna,1997,197,2194,6851,9045,-278,166,13329,3642,26016,197075,131047,IT,IT_45,-36,-243,416,28,4940,9027
2020-05-04,Emilia-Romagna,1968,199,2167,6817,8984,-61,159,13525,3666,26175,200427,133329,IT,IT_45,-29,-34,196,24,3352,8966
2020-05-05,Emilia-Romagna,1917,191,2108,6573,8681,-303,100,13889,3705,26275,206166,136310,IT,IT_45,-51,-244,364,39,5739,8663
2020-05-06,Emilia-Romagna,1816,176,1992,6399,8391,-290,104,14251,3737,26379,211652,138871,IT,IT_45,-101,-174,362,32,5486,8373
2020-05-07,Emilia-Romagna,1726,173,1899,6112,8011,-380,108,14710,3766,26487,217039,141468,IT,IT_45,-90,-287,459,29,5387,7993
2020-05-08,Emilia-Romagna,1680,163,1843,5887,7730,-281,111,15071,3797,26598,221866,144009,IT,IT_45,-46,-225,361,31,4827,7712
2020-05-09,Emilia-Romagna,1604,155,1759,5642,7401,-329,121,15491,3827,26719,227366,146642,IT,IT_45,-76,-245,420,30,5500,7383
2020-05-10,Emilia-Romagna,1562,150,1712,5479,7191,-210,77,15760,3845,26796,231637,149276,IT,IT_45,-42,-163,269,18,4271,7173
2020-05-11,Emilia-Romagna,1537,141,1678,5362,7040,-151,80,15969,3867,26876,234619,151040,IT,IT_45,-25,-117,209,22,2982,7022
2020-05-12,Emilia-Romagna,1384,136,1520,5281,6801,-239,53,16243,3885,26929,239178,153074,IT,IT_45,-153,-81,274,18,4559,6783
2020-05-13,Emilia-Romagna,1165,123,1288,5214,6502,-299,50,16572,3905,26979,243883,155476,IT,IT_45,-219,-67,329,20,4705,6484
2020-05-14,Emilia-Romagna,861,122,983,5318,6301,-201,77,16825,3930,27056,248591,158371,IT,IT_45,-304,104,253,25,4708,6283
2020-05-15,Emilia-Romagna,763,114,877,5124,6001,-300,54,17166,3943,27110,253497,160622,IT,IT_45,-98,-194,341,13,4906,5983
2020-05-16,Emilia-Romagna,740,112,852,5000,5852,-149,72,17370,3960,27182,258274,163067,IT,IT_45,-23,-124,204,17,4777,5834
2020-05-17,Emilia-Romagna,721,111,832,4824,5656,-196,50,17603,3973,27232,261106,163117,IT,IT_45,-19,-176,233,13,2832,5638
2020-05-18,Emilia-Romagna,708,105,813,4712,5525,-131,35,17756,3986,27267,263888,166240,IT,IT_45,-13,-112,153,13,2782,5507
2020-05-19,Emilia-Romagna,670,99,769,4561,5330,-195,47,17987,3997,27314,268200,168367,IT,IT_45,-38,-151,231,11,4312,5312
2020-05-20,Emilia-Romagna,626,96,722,4376,5098,-232,50,18258,4008,27364,274362,171903,IT,IT_45,-44,-185,271,11,6162,5080
2020-05-21,Emilia-Romagna,592,92,684,4242,4926,-172,53,18466,4025,27417,278917,174485,IT,IT_45,-34,-134,208,17,4555,4908
2020-05-22,Emilia-Romagna,552,89,641,4089,4730,-196,53,18703,4037,27470,282857,176464,IT,IT_45,-40,-153,237,12,3940,4712
2020-05-23,Emilia-Romagna,524,84,608,3962,4570,-160,43,18896,4047,27513,287382,179022,IT,IT_45,-28,-127,193,10,4525,4552
2020-05-24,Emilia-Romagna,519,83,602,3855,4457,-113,45,19046,4055,27558,291876,182002,IT,IT_45,-5,-107,150,8,4494,4439
2020-05-25,Emilia-Romagna,514,82,596,3763,4359,-98,29,19160,4068,27587,294181,183187,IT,IT_45,-5,-92,114,13,2305,4341
2020-05-26,Emilia-Romagna,493,80,573,3573,4146,-213,24,19389,4076,27611,297854,185125,IT,IT_45,-21,-190,229,8,3673,4128
2020-05-27,Emilia-Romagna,459,78,537,3461,3998,-148,16,19546,4083,27627,301568,186933,IT,IT_45,-34,-112,157,7,3714,3980
2020-05-28,Emilia-Romagna,449,77,526,3224,3750,-248,74,19857,4094,27701,310696,191112,IT,IT_45,-10,-237,311,11,9128,3732
2020-05-29,Emilia-Romagna,429,76,505,3059,3564,-186,38,20073,4102,27739,316909,193318,IT,IT_45,-20,-165,216,8,6213,3546
2020-05-30,Emilia-Romagna,398,65,463,2816,3279,-285,20,20373,4107,27759,321373,195492,IT,IT_45,-31,-243,300,5,4464,3261
2020-05-31,Emilia-Romagna,393,57,450,2713,3163,-116,31,20513,4114,27790,325482,197423,IT,IT_45,-5,-103,140,7,4109,3145
2020-06-01,Emilia-Romagna,383,54,437,2631,3068,-95,19,20617,4124,27809,329358,198884,IT,IT_45,-10,-82,104,10,3876,3050
2020-06-02,Emilia-Romagna,358,50,408,2504,2912,-156,19,20780,4136,27828,333629,201267,IT,IT_45,-25,-127,163,12,4271,2894
2020-06-03,Emilia-Romagna,342,50,392,2447,2839,-73,14,20856,4147,27842,336630,202506,IT,IT_45,-16,-57,76,11,3001,2821
2020-06-04,Emilia-Romagna,320,49,369,2319,2688,-151,18,21018,4154,27860,341710,204614,IT,IT_45,-22,-128,162,7,5080,2670
2020-06-05,Emilia-Romagna,281,38,319,2193,2512,-176,17,21198,4167,27877,347146,207533,IT,IT_45,-39,-126,180,13,5436,2494
2020-06-06,Emilia-Romagna,256,35,291,2125,2416,-96,17,21307,4171,27894,351146,210719,IT,IT_45,-25,-68,109,4,4000,2398
2020-06-07,Emilia-Romagna,245,32,277,2051,2328,-88,14,21405,4175,27908,355952,213979,IT,IT_45,-11,-74,98,4,4806,2310
2020-06-08,Emilia-Romagna,239,31,270,2012,2282,-46,20,21467,4179,27928,360962,215416,IT,IT_45,-6,-39,62,4,5010,2264
2020-06-09,Emilia-Romagna,226,31,257,1899,2156,-126,18,21605,4185,27946,367485,218890,IT,IT_45,-13,-113,138,6,6523,2138
2020-06-10,Emilia-Romagna,228,25,253,1808,2061,-95,24,21717,4192,27970,375278,223413,IT,IT_45,2,-91,112,7,7793,2043
2020-06-11,Emilia-Romagna,216,18,234,1766,2000,-61,25,21803,4192,27995,385220,227500,IT,IT_45,-12,-42,86,0,9942,1982
2020-06-12,Emilia-Romagna,200,17,217,1600,1817,-183,33,22015,4196,28028,393539,231752,IT,IT_45,-16,-166,212,4,8319,1799
2020-06-13,Emilia-Romagna,192,15,207,1520,1727,-90,28,22130,4199,28056,400902,237236,IT,IT_45,-8,-80,115,3,7363,1709
2020-06-14,Emilia-Romagna,192,14,206,1431,1637,-90,17,22232,4204,28073,407039,241833,IT,IT_45,0,-89,102,5,6137,1619
2020-06-15,Emilia-Romagna,188,13,201,1299,1500,-137,11,22377,4207,28084,410984,244630,IT,IT_45,-4,-132,145,3,3945,1482
2020-06-16,Emilia-Romagna,180,11,191,1214,1405,-95,13,22483,4209,28097,417184,247911,IT,IT_45,-8,-85,106,2,6200,1387
2020-06-17,Emilia-Romagna,173,11,184,1161,1345,-60,14,22551,4215,28111,426730,252139,IT,IT_45,-7,-53,68,6,9546,1327
2020-06-18,Emilia-Romagna,159,11,170,1111,1281,-64,32,22643,4219,28143,435351,256490,IT,IT_45,-14,-50,92,4,8621,1263
2020-06-19,Emilia-Romagna,145,11,156,1063,1219,-62,27,22727,4224,28170,443301,261017,IT,IT_45,-14,-48,84,5,7950,1201
2020-06-20,Emilia-Romagna,140,11,151,1056,1207,-12,28,22761,4230,28198,449616,266062,IT,IT_45,-5,-7,34,6,6315,1189
2020-02-24,Friuli Venezia Giulia,0,0,0,0,0,0,0,0,0,0,58,,IT,IT_36,,,,,,0
2020-02-25,Friuli Venezia Giulia,0,0,0,0,0,0,0,0,0,0,89,,IT,IT_36,0,0,0,0,31,0
2020-02-26,Friuli Venezia Giulia,0,0,0,0,0,0,0,0,0,0,114,,IT,IT_36,0,0,0,0,25,0
2020-02-27,Friuli Venezia Giulia,0,0,0,0,0,0,0,0,0,0,141,,IT,IT_36,0,0,0,0,27,0
2020-02-28,Friuli Venezia Giulia,0,0,0,0,0,0,0,0,0,0,169,,IT,IT_36,0,0,0,0,28,0
2020-02-29,Friuli Venezia Giulia,0,0,0,0,0,0,0,0,0,0,189,,IT,IT_36,0,0,0,0,20,0
2020-03-01,Friuli Venezia Giulia,0,0,0,6,6,6,6,0,0,6,243,,IT,IT_36,0,6,0,0,54,6
2020-03-02,Friuli Venezia Giulia,0,0,0,9,9,3,3,0,0,9,269,,IT,IT_36,0,3,0,0,26,9
2020-03-03,Friuli Venezia Giulia,1,0,1,12,13,4,4,0,0,13,354,,IT,IT_36,1,3,0,0,85,13
2020-03-04,Friuli Venezia Giulia,3,0,3,15,18,5,5,0,0,18,376,,IT,IT_36,2,3,0,0,22,18
2020-03-05,Friuli Venezia Giulia,4,0,4,17,21,3,3,0,0,21,397,,IT,IT_36,1,2,0,0,21,21
2020-03-06,Friuli Venezia Giulia,4,0,4,24,28,7,10,3,0,31,577,,IT,IT_36,0,7,3,0,180,28
2020-03-07,Friuli Venezia Giulia,7,1,8,31,39,11,11,3,0,42,577,,IT,IT_36,3,7,0,0,0,39
2020-03-08,Friuli Venezia Giulia,7,1,8,45,53,14,15,3,1,57,997,,IT,IT_36,0,14,0,1,420,53
2020-03-09,Friuli Venezia Giulia,18,1,19,70,89,36,36,3,1,93,1344,,IT,IT_36,11,25,0,0,347,89
2020-03-10,Friuli Venezia Giulia,27,6,33,77,110,21,23,3,3,116,1602,,IT,IT_36,9,7,0,2,258,110
2020-03-11,Friuli Venezia Giulia,16,5,21,89,110,0,10,10,6,126,2073,,IT,IT_36,-11,12,7,3,471,110
2020-03-12,Friuli Venezia Giulia,23,10,33,115,148,38,41,11,8,167,2604,,IT,IT_36,7,26,1,2,531,148
2020-03-13,Friuli Venezia Giulia,59,8,67,169,236,88,90,11,10,257,3149,,IT,IT_36,36,54,0,2,545,236
2020-03-14,Friuli Venezia Giulia,67,11,78,193,271,35,44,17,13,301,3376,,IT,IT_36,8,24,6,3,227,271
2020-03-15,Friuli Venezia Giulia,98,12,110,206,316,45,46,17,14,347,3407,,IT,IT_36,31,13,0,1,31,316
2020-03-16,Friuli Venezia Giulia,96,19,115,231,346,30,39,18,22,386,4851,,IT,IT_36,-2,25,1,8,1444,346
2020-03-17,Friuli Venezia Giulia,104,21,125,222,347,1,8,17,30,394,4958,,IT,IT_36,8,-9,-1,8,107,347
2020-03-18,Friuli Venezia Giulia,128,27,155,261,416,69,68,15,31,462,4958,,IT,IT_36,24,39,-2,1,0,416
2020-03-19,Friuli Venezia Giulia,134,29,163,359,522,106,137,41,36,599,4052,,IT,IT_36,6,98,26,5,-906,522
2020-03-20,Friuli Venezia Giulia,143,32,175,380,555,33,57,63,38,656,4964,,IT,IT_36,9,21,22,2,912,555
2020-03-21,Friuli Venezia Giulia,152,37,189,477,666,111,134,82,42,790,5955,,IT,IT_36,9,97,19,4,991,666
2020-03-22,Friuli Venezia Giulia,163,47,210,528,738,72,84,89,47,874,6761,,IT,IT_36,11,51,7,5,806,738
2020-03-23,Friuli Venezia Giulia,185,41,226,545,771,33,56,105,54,930,7424,,IT,IT_36,22,17,16,7,663,771
2020-03-24,Friuli Venezia Giulia,195,49,244,604,848,77,62,80,64,992,8526,,IT,IT_36,10,59,-25,10,1102,848
2020-03-25,Friuli Venezia Giulia,200,52,252,659,911,63,147,158,70,1139,9494,,IT,IT_36,5,55,78,6,968,911
2020-03-26,Friuli Venezia Giulia,212,54,266,688,954,43,84,197,72,1223,10721,,IT,IT_36,12,29,39,2,1227,954
2020-03-27,Friuli Venezia Giulia,222,57,279,748,1027,73,94,214,76,1317,11841,,IT,IT_36,10,60,17,4,1120,1027
2020-03-28,Friuli Venezia Giulia,223,59,282,838,1120,93,119,229,87,1436,12723,,IT,IT_36,1,90,15,11,882,1120
2020-03-29,Friuli Venezia Giulia,236,60,296,845,1141,21,44,241,98,1480,13397,,IT,IT_36,13,7,12,11,674,1141
2020-03-30,Friuli Venezia Giulia,229,60,289,820,1109,-32,21,285,107,1501,14003,,IT,IT_36,-7,-25,44,9,606,1109
2020-03-31,Friuli Venezia Giulia,215,60,275,885,1160,51,92,320,113,1593,14899,,IT,IT_36,-14,65,35,6,896,1160
2020-04-01,Friuli Venezia Giulia,206,60,266,940,1206,46,92,357,122,1685,15987,,IT,IT_36,-9,55,37,9,1088,1206
2020-04-02,Friuli Venezia Giulia,199,60,259,1035,1294,88,114,376,129,1799,17121,,IT,IT_36,-7,95,19,7,1134,1294
2020-04-03,Friuli Venezia Giulia,201,61,262,1062,1324,30,80,419,136,1879,19985,,IT,IT_36,2,27,43,7,2864,1324
2020-04-04,Friuli Venezia Giulia,183,50,233,1103,1336,12,107,505,145,1986,21126,,IT,IT_36,-18,41,86,9,1141,1336
2020-04-05,Friuli Venezia Giulia,185,50,235,1128,1363,27,62,531,154,2048,21652,,IT,IT_36,2,25,26,9,526,1363
2020-04-06,Friuli Venezia Giulia,189,46,235,1161,1396,33,55,549,158,2103,22272,,IT,IT_36,4,33,18,4,620,1396
2020-04-07,Friuli Venezia Giulia,185,44,229,1150,1379,-17,50,610,164,2153,23536,,IT,IT_36,-4,-11,61,6,1264,1379
2020-04-08,Friuli Venezia Giulia,162,41,203,1212,1415,36,65,634,169,2218,24798,,IT,IT_36,-23,62,24,5,1262,1415
2020-04-09,Friuli Venezia Giulia,167,37,204,1186,1390,-25,81,738,171,2299,26205,,IT,IT_36,5,-26,104,2,1407,1390
2020-04-10,Friuli Venezia Giulia,167,33,200,1198,1398,8,50,772,179,2349,28097,,IT,IT_36,0,12,34,8,1892,1398
2020-04-11,Friuli Venezia Giulia,172,28,200,1182,1382,-16,44,826,185,2393,29685,,IT,IT_36,5,-16,54,6,1588,1382
2020-04-12,Friuli Venezia Giulia,160,28,188,1138,1326,-56,38,910,195,2431,29988,,IT,IT_36,-12,-44,84,10,303,1326
2020-04-13,Friuli Venezia Giulia,159,30,189,1118,1307,-19,51,973,202,2482,30941,,IT,IT_36,-1,-20,63,7,953,1307
2020-04-14,Friuli Venezia Giulia,166,28,194,705,899,-408,38,1415,206,2520,31764,,IT,IT_36,7,-413,442,4,823,899
2020-04-15,Friuli Venezia Giulia,163,24,187,1207,1394,495,24,938,212,2544,33800,,IT,IT_36,-3,502,-477,6,2036,1394
2020-04-16,Friuli Venezia Giulia,159,26,185,1145,1330,-64,72,1069,217,2616,35766,,IT,IT_36,-4,-62,131,5,1966,1330
2020-04-17,Friuli Venezia Giulia,148,23,171,1257,1428,98,59,1027,220,2675,40030,,IT,IT_36,-11,112,-42,3,4264,1428
2020-04-18,Friuli Venezia Giulia,141,27,168,1235,1403,-25,56,1106,222,2731,43293,,IT,IT_36,-7,-22,79,2,3263,1403
2020-04-19,Friuli Venezia Giulia,140,25,165,1172,1337,-66,14,1183,225,2745,44622,27544,IT,IT_36,-1,-63,77,3,1329,1337
2020-04-20,Friuli Venezia Giulia,140,22,162,1028,1190,-147,30,1346,239,2775,45161,28777,IT,IT_36,0,-144,163,14,539,1190
2020-04-21,Friuli Venezia Giulia,139,21,160,1162,1322,132,17,1229,241,2792,48500,31352,IT,IT_36,-1,134,-117,2,3339,1322
2020-04-22,Friuli Venezia Giulia,134,20,154,1154,1308,-14,25,1263,246,2817,50869,32871,IT,IT_36,-5,-8,34,5,2369,1308
2020-04-23,Friuli Venezia Giulia,138,18,156,979,1135,-173,41,1467,256,2858,52918,34057,IT,IT_36,4,-175,204,10,2049,1135
2020-04-24,Friuli Venezia Giulia,136,16,152,1168,1320,185,24,1304,258,2882,55502,35547,IT,IT_36,-2,189,-163,2,2584,1320
2020-04-25,Friuli Venezia Giulia,122,15,137,947,1084,-236,21,1556,263,2903,58375,37211,IT,IT_36,-14,-221,252,5,2873,1084
2020-04-26,Friuli Venezia Giulia,129,13,142,1106,1248,164,14,1405,264,2917,59681,38202,IT,IT_36,7,159,-151,1,1306,1248
2020-04-27,Friuli Venezia Giulia,130,13,143,1115,1258,10,60,1448,271,2977,60940,39330,IT,IT_36,1,9,43,7,1259,1258
2020-04-28,Friuli Venezia Giulia,136,13,149,1090,1239,-19,18,1478,278,2995,64151,41273,IT,IT_36,6,-25,30,7,3211,1239
2020-04-29,Friuli Venezia Giulia,134,12,146,1081,1227,-12,15,1498,285,3010,66769,42902,IT,IT_36,-2,-9,20,7,2618,1227
2020-04-30,Friuli Venezia Giulia,109,11,120,1050,1170,-57,15,1566,289,3025,67930,43691,IT,IT_36,-25,-31,68,4,1161,1170
2020-05-01,Friuli Venezia Giulia,131,6,137,978,1115,-55,16,1632,294,3041,71013,45566,IT,IT_36,22,-72,66,5,3083,1115
2020-05-02,Friuli Venezia Giulia,131,5,136,973,1109,-6,18,1655,295,3059,73855,47259,IT,IT_36,0,-5,23,1,2842,1109
2020-05-03,Friuli Venezia Giulia,131,6,137,950,1087,-22,13,1688,297,3072,74990,48041,IT,IT_36,0,-23,33,2,1135,1087
2020-05-04,Friuli Venezia Giulia,130,4,134,916,1050,-37,4,1727,299,3076,75421,48250,IT,IT_36,-1,-34,39,2,431,1050
2020-05-05,Friuli Venezia Giulia,120,4,124,860,984,-66,9,1798,303,3085,78510,50135,IT,IT_36,-10,-56,71,4,3089,984
2020-05-06,Friuli Venezia Giulia,115,3,118,844,962,-22,9,1826,306,3094,79429,50698,IT,IT_36,-5,-16,28,3,919,962
2020-05-07,Friuli Venezia Giulia,109,2,111,816,927,-35,13,1872,308,3107,82012,51123,IT,IT_36,-6,-28,46,2,2583,927
2020-05-08,Friuli Venezia Giulia,105,2,107,804,911,-16,9,1897,308,3116,82902,52784,IT,IT_36,-4,-12,25,0,890,911
2020-05-09,Friuli Venezia Giulia,101,3,104,765,869,-42,8,1947,308,3124,88384,55319,IT,IT_36,-4,-39,50,0,5482,869
2020-05-10,Friuli Venezia Giulia,98,3,101,750,851,-18,6,1969,310,3130,89449,56205,IT,IT_36,-3,-15,22,2,1065,851
2020-05-11,Friuli Venezia Giulia,96,3,99,731,830,-21,8,1996,312,3138,90860,57130,IT,IT_36,-2,-19,27,2,1411,830
2020-05-12,Friuli Venezia Giulia,96,2,98,703,801,-29,10,2034,313,3148,93051,58395,IT,IT_36,0,-28,38,1,2191,801
2020-05-13,Friuli Venezia Giulia,92,2,94,685,779,-22,8,2061,316,3156,94600,58936,IT,IT_36,-4,-18,27,3,1549,779
2020-05-14,Friuli Venezia Giulia,149,2,151,619,770,-9,5,2074,317,3161,97000,60177,IT,IT_36,57,-66,13,1,2400,770
2020-05-15,Friuli Venezia Giulia,80,3,83,658,741,-29,14,2116,318,3175,100400,62319,IT,IT_36,-69,39,42,1,3400,741
2020-05-16,Friuli Venezia Giulia,79,3,82,598,680,-61,8,2184,319,3183,101694,63251,IT,IT_36,-1,-60,68,1,1294,680
2020-05-17,Friuli Venezia Giulia,80,3,83,571,654,-26,8,2218,319,3191,104056,64558,IT,IT_36,1,-27,34,0,2362,654
2020-05-18,Friuli Venezia Giulia,81,3,84,537,621,-33,7,2257,320,3198,104874,65184,IT,IT_36,1,-34,39,1,818,621
2020-05-19,Friuli Venezia Giulia,76,2,78,522,600,-21,5,2283,320,3203,105656,65476,IT,IT_36,-5,-15,26,0,782,600
2020-05-20,Friuli Venezia Giulia,76,2,78,518,596,-4,6,2291,322,3209,108671,67449,IT,IT_36,0,-4,8,2,3015,596
2020-05-21,Friuli Venezia Giulia,72,2,74,504,578,-18,6,2314,323,3215,111541,68882,IT,IT_36,-4,-14,23,1,2870,578
2020-05-22,Friuli Venezia Giulia,68,2,70,415,485,-93,12,2417,325,3227,114062,70035,IT,IT_36,-4,-89,103,2,2521,485
2020-05-23,Friuli Venezia Giulia,63,1,64,395,459,-26,6,2447,327,3233,116689,71043,IT,IT_36,-5,-20,30,2,2627,459
2020-05-24,Friuli Venezia Giulia,62,1,63,349,412,-47,3,2495,329,3236,118852,72104,IT,IT_36,-1,-46,48,2,2163,412
2020-05-25,Friuli Venezia Giulia,62,1,63,323,386,-26,4,2525,329,3240,120123,73079,IT,IT_36,0,-26,30,0,1271,386
2020-05-26,Friuli Venezia Giulia,59,1,60,315,375,-11,11,2547,329,3251,121412,73911,IT,IT_36,-3,-8,22,0,1289,375
2020-05-27,Friuli Venezia Giulia,51,1,52,304,356,-19,4,2568,331,3255,123063,74332,IT,IT_36,-8,-11,21,2,1651,356
2020-05-28,Friuli Venezia Giulia,51,1,52,284,336,-20,7,2593,333,3262,126015,76369,IT,IT_36,0,-20,25,2,2952,336
2020-05-29,Friuli Venezia Giulia,45,2,47,276,323,-13,5,2611,333,3267,130838,78151,IT,IT_36,-6,-8,18,0,4823,323
2020-05-30,Friuli Venezia Giulia,45,1,46,259,305,-18,4,2633,333,3271,131976,78972,IT,IT_36,0,-17,22,0,1138,305
2020-05-31,Friuli Venezia Giulia,41,1,42,236,278,-27,2,2662,333,3273,134378,80223,IT,IT_36,-4,-23,29,0,2402,278
2020-06-01,Friuli Venezia Giulia,40,2,42,224,266,-12,1,2673,335,3274,135431,80085,IT,IT_36,-1,-12,11,2,1053,266
2020-06-02,Friuli Venezia Giulia,40,2,42,202,244,-22,2,2696,336,3276,136524,80795,IT,IT_36,0,-22,23,1,1093,244
2020-06-03,Friuli Venezia Giulia,39,2,41,192,233,-11,0,2707,336,3276,138250,81683,IT,IT_36,-1,-10,11,0,1726,233
2020-06-04,Friuli Venezia Giulia,34,2,36,177,213,-20,3,2730,336,3279,138942,81854,IT,IT_36,-5,-15,23,0,692,213
2020-06-05,Friuli Venezia Giulia,25,2,27,153,180,-33,1,2762,338,3280,142246,83600,IT,IT_36,-9,-24,32,2,3304,180
2020-06-06,Friuli Venezia Giulia,24,2,26,135,161,-19,3,2784,338,3283,146338,84978,IT,IT_36,-1,-18,22,0,4092,161
2020-06-07,Friuli Venezia Giulia,22,4,26,125,151,-10,0,2793,339,3283,147673,85671,IT,IT_36,-2,-10,9,1,1335,151
2020-06-08,Friuli Venezia Giulia,22,3,25,119,144,-7,1,2800,340,3284,148030,85834,IT,IT_36,0,-6,7,1,357,144
2020-06-09,Friuli Venezia Giulia,21,2,23,105,128,-16,0,2816,340,3284,148889,86257,IT,IT_36,-1,-14,16,0,859,128
2020-06-10,Friuli Venezia Giulia,25,1,26,87,113,-15,2,2832,341,3286,152866,90061,IT,IT_36,4,-18,16,1,3977,113
2020-06-11,Friuli Venezia Giulia,22,0,22,90,112,-1,1,2833,342,3287,153763,90508,IT,IT_36,-3,3,1,1,897,112
2020-06-12,Friuli Venezia Giulia,18,0,18,90,108,-4,3,2840,342,3290,157909,92278,IT,IT_36,-4,0,7,0,4146,108
2020-06-13,Friuli Venezia Giulia,15,0,15,90,105,-3,6,2848,343,3296,158870,93222,IT,IT_36,-3,0,8,1,961,105
2020-06-14,Friuli Venezia Giulia,15,1,16,87,103,-2,0,2850,343,3296,160824,93641,IT,IT_36,0,-3,2,0,1954,103
2020-06-15,Friuli Venezia Giulia,15,1,16,83,99,-4,0,2854,343,3296,161945,94567,IT,IT_36,0,-4,4,0,1121,99
2020-06-16,Friuli Venezia Giulia,14,0,14,85,99,0,1,2855,343,3297,162440,95057,IT,IT_36,-1,2,1,0,495,99
2020-06-17,Friuli Venezia Giulia,16,0,16,83,99,0,2,2857,343,3299,166064,96534,IT,IT_36,2,-2,2,0,3624,99
2020-06-18,Friuli Venezia Giulia,15,1,16,81,97,-2,2,2861,343,3301,167485,97662,IT,IT_36,-1,-2,4,0,1421,97
2020-06-19,Friuli Venezia Giulia,16,0,16,69,85,-12,2,2875,343,3303,170109,98912,IT,IT_36,1,-12,14,0,2624,85
2020-06-20,Friuli Venezia Giulia,16,1,17,66,83,-2,1,2877,344,3304,171947,99462,IT,IT_36,0,-3,2,1,1838,83
2020-02-24,Lazio,1,1,2,0,2,0,2,1,0,3,124,,IT,IT_62,,,,,,0
2020-02-25,Lazio,1,1,2,0,2,0,0,1,0,3,124,,IT,IT_62,0,0,0,0,0,0
2020-02-26,Lazio,0,0,0,0,0,-2,0,3,0,3,124,,IT,IT_62,-1,0,2,0,0,-2
2020-02-27,Lazio,0,0,0,0,0,0,0,3,0,3,552,,IT,IT_62,0,0,0,0,428,-2
2020-02-28,Lazio,0,0,0,0,0,0,0,3,0,3,611,,IT,IT_62,0,0,0,0,59,-2
2020-02-29,Lazio,3,0,3,0,3,3,3,3,0,6,679,,IT,IT_62,3,0,0,0,68,1
2020-03-01,Lazio,3,0,3,0,3,0,0,3,0,6,724,,IT,IT_62,0,0,0,0,45,1
2020-03-02,Lazio,3,0,3,1,4,1,1,3,0,7,773,,IT,IT_62,0,1,0,0,49,2
2020-03-03,Lazio,10,0,10,1,11,7,7,3,0,14,877,,IT,IT_62,7,0,0,0,104,9
2020-03-04,Lazio,15,3,18,9,27,16,16,3,0,30,995,,IT,IT_62,5,8,0,0,118,25
2020-03-05,Lazio,20,7,27,14,41,14,14,3,0,44,1175,,IT,IT_62,5,5,0,0,180,39
2020-03-06,Lazio,26,8,34,16,50,9,10,3,1,54,1373,,IT,IT_62,6,2,0,1,198,48
2020-03-07,Lazio,43,8,51,21,72,22,22,3,1,76,1582,,IT,IT_62,17,5,0,0,209,70
2020-03-08,Lazio,47,8,55,26,81,9,11,3,3,87,1929,,IT,IT_62,4,5,0,2,347,79
2020-03-09,Lazio,55,8,63,31,94,13,15,3,5,102,1929,,IT,IT_62,8,5,0,2,0,92
2020-03-10,Lazio,50,15,65,34,99,5,14,11,6,116,3591,,IT,IT_62,-5,3,8,1,1662,97
2020-03-11,Lazio,67,18,85,40,125,26,34,19,6,150,3591,,IT,IT_62,17,6,8,0,0,123
2020-03-12,Lazio,85,20,105,67,172,47,50,19,9,200,5592,,IT,IT_62,18,27,0,3,2001,170
2020-03-13,Lazio,122,24,146,96,242,70,77,24,11,277,6491,,IT,IT_62,37,29,5,2,899,240
2020-03-14,Lazio,181,25,206,114,320,78,80,24,13,357,7335,,IT,IT_62,59,18,0,2,844,318
2020-03-15,Lazio,223,31,254,142,396,76,79,24,16,436,8345,,IT,IT_62,42,28,0,3,1010,394
2020-03-16,Lazio,267,31,298,174,472,76,87,32,19,523,9330,,IT,IT_62,44,32,8,3,985,470
2020-03-17,Lazio,314,44,358,192,550,78,84,34,23,607,9436,,IT,IT_62,47,18,2,4,106,548
2020-03-18,Lazio,374,44,418,232,650,100,117,42,32,724,11145,,IT,IT_62,60,40,8,9,1709,648
2020-03-19,Lazio,426,45,471,270,741,91,99,44,38,823,11145,,IT,IT_62,52,38,2,6,0,739
2020-03-20,Lazio,537,47,584,328,912,171,185,53,43,1008,13889,,IT,IT_62,111,58,9,5,2744,910
2020-03-21,Lazio,591,70,661,425,1086,174,182,54,50,1190,13889,,IT,IT_62,54,97,1,7,0,1084
2020-03-22,Lazio,671,79,750,522,1272,186,193,58,53,1383,17845,,IT,IT_62,80,97,4,3,3956,1270
2020-03-23,Lazio,718,96,814,600,1414,142,157,63,63,1540,18371,,IT,IT_62,47,78,5,10,526,1412
2020-03-24,Lazio,747,94,841,704,1545,131,188,103,80,1728,18371,,IT,IT_62,29,104,40,17,0,1543
2020-03-25,Lazio,805,101,906,769,1675,130,173,131,95,1901,20669,,IT,IT_62,58,65,28,15,2298,1673
2020-03-26,Lazio,878,113,991,844,1835,160,195,155,106,2096,22771,,IT,IT_62,73,75,24,11,2102,1833
2020-03-27,Lazio,992,126,1118,895,2013,178,199,164,118,2295,24106,,IT,IT_62,114,51,9,12,1335,2011
2020-03-28,Lazio,985,133,1118,1063,2181,168,210,200,124,2505,27179,,IT,IT_62,-7,168,36,6,3073,2179
2020-03-29,Lazio,1062,133,1195,1167,2362,181,201,208,136,2706,27744,,IT,IT_62,77,104,8,12,565,2360
2020-03-30,Lazio,1079,154,1233,1264,2497,135,208,267,150,2914,32846,,IT,IT_62,17,97,59,14,5102,2495
2020-03-31,Lazio,1127,173,1300,1342,2642,145,181,291,162,3095,34677,,IT,IT_62,48,78,24,12,1831,2640
2020-04-01,Lazio,1131,177,1308,1450,2758,116,169,337,169,3264,35810,,IT,IT_62,4,108,46,7,1133,2756
2020-04-02,Lazio,1169,181,1350,1529,2879,121,169,369,185,3433,41575,,IT,IT_62,38,79,32,16,5765,2877
2020-04-03,Lazio,1194,188,1382,1627,3009,130,167,392,199,3600,43776,,IT,IT_62,25,98,23,14,2201,3007
2020-04-04,Lazio,1236,193,1429,1677,3106,97,157,439,212,3757,44624,,IT,IT_62,42,50,47,13,848,3104
2020-04-05,Lazio,1235,197,1432,1754,3186,80,123,475,219,3880,44658,,IT,IT_62,-1,77,36,7,34,3184
2020-04-06,Lazio,1235,197,1432,1868,3300,114,151,502,229,4031,47470,,IT,IT_62,0,114,27,10,2812,3298
2020-04-07,Lazio,1229,192,1421,1944,3365,65,118,546,238,4149,48874,,IT,IT_62,-6,76,44,9,1404,3363
2020-04-08,Lazio,1241,196,1437,2011,3448,83,117,574,244,4266,55113,,IT,IT_62,12,67,28,6,6239,3446
2020-04-09,Lazio,1244,198,1442,2090,3532,84,163,644,253,4429,58107,,IT,IT_62,3,79,70,9,2994,3530
2020-04-10,Lazio,1236,201,1437,2196,3633,101,154,687,263,4583,61769,,IT,IT_62,-8,106,43,10,3662,3631
2020-04-11,Lazio,1264,203,1467,2263,3730,97,140,720,273,4723,65241,,IT,IT_62,28,67,33,10,3472,3728
2020-04-12,Lazio,1268,201,1469,2348,3817,87,122,749,279,4845,68954,,IT,IT_62,4,85,29,6,3713,3815
2020-04-13,Lazio,1314,200,1514,2406,3920,103,123,764,284,4968,72746,,IT,IT_62,46,58,15,5,3792,3918
2020-04-14,Lazio,1344,199,1543,2479,4022,102,143,789,300,5111,74650,,IT,IT_62,30,73,25,16,1904,4020
2020-04-15,Lazio,1342,196,1538,2509,4047,25,121,874,311,5232,75584,,IT,IT_62,-2,30,85,11,934,4045
2020-04-16,Lazio,1347,197,1544,2600,4144,97,148,920,316,5380,81993,,IT,IT_62,5,91,46,5,6409,4142
2020-04-17,Lazio,1332,187,1519,2695,4214,70,144,978,332,5524,84755,,IT,IT_62,-15,95,58,16,2762,4212
2020-04-18,Lazio,1376,186,1562,2720,4282,68,144,1046,340,5668,89553,,IT,IT_62,44,25,68,8,4798,4280
2020-04-19,Lazio,1370,185,1555,2766,4321,39,87,1093,341,5755,91807,22702,IT,IT_62,-6,46,47,1,2254,4319
2020-04-20,Lazio,1388,185,1573,2792,4365,44,60,1101,349,5815,97823,23067,IT,IT_62,18,26,8,8,6016,4363
2020-04-21,Lazio,1380,184,1564,2838,4402,37,80,1130,363,5895,100031,24046,IT,IT_62,-8,46,29,14,2208,4400
2020-04-22,Lazio,1384,187,1571,2892,4463,61,80,1142,370,5975,104062,25244,IT,IT_62,4,54,12,7,4031,4461
2020-04-23,Lazio,1385,186,1571,2915,4486,23,79,1193,375,6054,111073,26298,IT,IT_62,1,23,51,5,7011,4484
2020-04-24,Lazio,1396,184,1580,2912,4492,6,78,1256,384,6132,114317,86545,IT,IT_62,11,-3,63,9,3244,4490
2020-04-25,Lazio,1421,183,1604,2957,4561,69,92,1276,387,6224,118354,90582,IT,IT_62,25,45,20,3,4037,4559
2020-04-26,Lazio,1442,161,1603,2970,4573,12,85,1347,389,6309,121677,93811,IT,IT_62,21,13,71,2,3323,4571
2020-04-27,Lazio,1464,143,1607,2955,4562,-11,83,1433,397,6392,124769,95719,IT,IT_62,22,-15,86,8,3092,4560
2020-04-28,Lazio,1468,132,1600,2962,4562,0,75,1491,414,6467,128664,98968,IT,IT_62,4,7,58,17,3895,4560
2020-04-29,Lazio,1445,130,1575,2960,4535,-27,78,1579,431,6545,133503,103435,IT,IT_62,-23,-2,88,17,4839,4533
2020-04-30,Lazio,1417,115,1532,2936,4468,-67,71,1707,441,6616,137596,107497,IT,IT_62,-28,-24,128,10,4093,4466
2020-05-01,Lazio,1372,105,1477,2969,4446,-22,56,1744,482,6672,143804,111988,IT,IT_62,-45,33,37,41,6208,4444
2020-05-02,Lazio,1370,96,1466,2986,4452,6,84,1807,497,6756,147078,114761,IT,IT_62,-2,17,63,15,3274,4450
2020-05-03,Lazio,1346,95,1441,2944,4385,-67,53,1916,508,6809,150912,117796,IT,IT_62,-24,-42,109,11,3834,4383
2020-05-04,Lazio,1335,95,1430,2955,4385,0,38,1938,524,6847,153293,120095,IT,IT_62,-11,11,22,16,2381,4383
2020-05-05,Lazio,1315,91,1406,2964,4370,-15,67,2010,534,6914,157307,122541,IT,IT_62,-20,9,72,10,4014,4368
2020-05-06,Lazio,1351,91,1442,2991,4433,63,81,2024,538,6995,160894,125897,IT,IT_62,36,27,14,4,3587,4431
2020-05-07,Lazio,1291,89,1380,2968,4348,-85,39,2143,543,7034,165340,130351,IT,IT_62,-60,-23,119,5,4446,4346
2020-05-08,Lazio,1278,84,1362,2966,4328,-20,52,2209,549,7086,169499,133674,IT,IT_62,-13,-2,66,6,4159,4326
2020-05-09,Lazio,1277,82,1359,2986,4345,17,47,2235,553,7133,174448,137428,IT,IT_62,-1,20,26,4,4949,4343
2020-05-10,Lazio,1265,84,1349,2937,4286,-59,32,2322,557,7165,178569,141233,IT,IT_62,-12,-49,87,4,4121,4284
2020-05-11,Lazio,1266,83,1349,2945,4294,8,25,2334,562,7190,181398,143970,IT,IT_62,1,8,12,5,2829,4292
2020-05-12,Lazio,1258,84,1342,2931,4273,-21,22,2373,566,7212,185085,147010,IT,IT_62,-8,-14,39,4,3687,4271
2020-05-13,Lazio,1224,83,1307,2928,4235,-38,38,2438,577,7250,188632,150097,IT,IT_62,-34,-3,65,11,3547,4233
2020-05-14,Lazio,1178,79,1257,2839,4096,-139,41,2600,595,7291,192917,153894,IT,IT_62,-46,-89,162,18,4285,4094
2020-05-15,Lazio,1173,79,1252,2836,4088,-8,73,2672,604,7364,197599,157880,IT,IT_62,-5,-3,72,9,4682,4086
2020-05-16,Lazio,1156,76,1232,2790,4022,-66,32,2758,616,7396,201938,161405,IT,IT_62,-17,-46,86,12,4339,4020
2020-05-17,Lazio,1150,74,1224,2686,3910,-112,50,2914,622,7446,206166,164779,IT,IT_62,-6,-104,156,6,4228,3908
2020-05-18,Lazio,1137,73,1210,2616,3826,-84,39,3031,628,7485,209472,167859,IT,IT_62,-13,-70,117,6,3306,3824
2020-05-19,Lazio,1124,74,1198,2588,3786,-40,20,3079,640,7505,213877,171353,IT,IT_62,-13,-28,48,12,4405,3784
2020-05-20,Lazio,1119,74,1193,2593,3786,0,28,3100,647,7533,217849,173903,IT,IT_62,-5,5,21,7,3972,3784
2020-05-21,Lazio,1110,68,1178,2459,3637,-149,25,3259,662,7558,222071,177749,IT,IT_62,-9,-134,159,15,4222,3635
2020-05-22,Lazio,1111,67,1178,2457,3635,-2,31,3285,669,7589,227090,182266,IT,IT_62,1,-2,26,7,5019,3633
2020-05-23,Lazio,1097,60,1157,2424,3581,-54,18,3350,676,7607,230743,185285,IT,IT_62,-14,-33,65,7,3653,3579
2020-05-24,Lazio,1088,61,1149,2420,3569,-12,20,3374,684,7627,233498,187994,IT,IT_62,-9,-4,24,8,2755,3567
2020-05-25,Lazio,1085,60,1145,2409,3554,-15,16,3401,688,7643,235840,190052,IT,IT_62,-3,-11,27,4,2342,3552
2020-05-26,Lazio,1083,59,1142,2396,3538,-16,18,3430,693,7661,238967,192591,IT,IT_62,-2,-13,29,5,3127,3536
2020-05-27,Lazio,1062,65,1127,2361,3488,-50,11,3483,701,7672,242287,195001,IT,IT_62,-21,-35,53,8,3320,3486
2020-05-28,Lazio,1035,64,1099,2306,3405,-83,21,3580,708,7693,245993,198207,IT,IT_62,-27,-55,97,7,3706,3403
2020-05-29,Lazio,817,59,876,2287,3163,-242,16,3825,721,7709,249267,201082,IT,IT_62,-218,-19,245,13,3274,3161
2020-05-30,Lazio,769,58,827,2228,3055,-108,6,3932,728,7715,253388,204232,IT,IT_62,-48,-59,107,7,4121,3053
2020-05-31,Lazio,730,57,787,2196,2983,-72,13,4010,735,7728,255474,206235,IT,IT_62,-39,-32,78,7,2086,2981
2020-06-01,Lazio,594,56,650,2244,2894,-89,10,4105,739,7738,257563,208081,IT,IT_62,-136,48,95,4,2089,2892
2020-06-02,Lazio,580,56,636,2211,2847,-47,5,4155,741,7743,260102,209892,IT,IT_62,-14,-33,50,2,2539,2845
2020-06-03,Lazio,519,51,570,2248,2818,-29,10,4188,747,7753,262461,211669,IT,IT_62,-61,37,33,6,2359,2816
2020-06-04,Lazio,488,51,539,2215,2754,-64,11,4260,750,7764,265380,214051,IT,IT_62,-31,-33,72,3,2919,2752
2020-06-05,Lazio,480,51,531,2179,2710,-44,9,4309,754,7773,268561,216743,IT,IT_62,-8,-36,49,4,3181,2708
2020-06-06,Lazio,477,49,526,2171,2697,-13,28,4346,758,7801,271662,219363,IT,IT_62,-3,-8,37,4,3101,2695
2020-06-07,Lazio,467,49,516,2174,2690,-7,11,4362,760,7812,274129,221612,IT,IT_62,-10,3,16,2,2467,2688
2020-06-08,Lazio,466,49,515,2100,2615,-75,16,4450,763,7828,275885,222963,IT,IT_62,-1,-74,88,3,1756,2613
2020-06-09,Lazio,462,47,509,2061,2570,-45,23,4515,766,7851,279572,225930,IT,IT_62,-4,-39,65,3,3687,2568
2020-06-10,Lazio,368,47,415,2151,2566,-4,18,4533,770,7869,283630,229513,IT,IT_62,-94,90,18,4,4058,2564
2020-06-11,Lazio,320,46,366,2151,2517,-49,20,4596,776,7889,287888,233158,IT,IT_62,-48,0,63,6,4258,2515
2020-06-12,Lazio,293,47,340,1882,2222,-295,27,4913,781,7916,291869,237100,IT,IT_62,-27,-269,317,5,3981,2220
2020-06-13,Lazio,303,45,348,1009,1357,-865,25,5778,806,7941,294654,239788,IT,IT_62,10,-873,865,25,2785,1355
2020-06-14,Lazio,305,37,342,980,1322,-35,14,5825,808,7955,297615,242245,IT,IT_62,2,-29,47,2,2961,1320
2020-06-15,Lazio,304,37,341,951,1292,-30,3,5855,811,7958,299590,243805,IT,IT_62,-1,-29,30,3,1975,1290
2020-06-16,Lazio,308,38,346,783,1129,-163,9,6024,814,7967,302305,245960,IT,IT_62,4,-168,169,3,2715,1127
2020-06-17,Lazio,284,38,322,717,1039,-90,10,6120,818,7977,305906,248746,IT,IT_62,-24,-66,96,4,3601,1037
2020-06-18,Lazio,261,38,299,698,997,-42,9,6167,822,7986,309169,251673,IT,IT_62,-23,-19,47,4,3263,995
2020-06-19,Lazio,247,38,285,703,988,-9,9,6181,826,7995,312708,254525,IT,IT_62,-14,5,14,4,3539,986
2020-06-20,Lazio,247,39,286,701,987,-1,14,6195,827,8009,316109,257265,IT,IT_62,0,-2,14,1,3401,985
2020-02-24,Liguria,0,0,0,0,0,0,0,0,0,0,1,,IT,IT_42,,,,,,0
2020-02-25,Liguria,1,0,1,0,1,1,1,0,0,1,39,,IT,IT_42,1,0,0,0,38,1
2020-02-26,Liguria,6,0,6,5,11,10,10,0,0,11,66,,IT,IT_42,5,5,0,0,27,11
2020-02-27,Liguria,9,0,9,10,19,8,8,0,0,19,78,,IT,IT_42,3,5,0,0,12,19
2020-02-28,Liguria,9,0,9,10,19,0,0,0,0,19,112,,IT,IT_42,0,0,0,0,34,19
2020-02-29,Liguria,4,1,5,33,38,19,23,4,0,42,121,,IT,IT_42,-5,23,4,0,9,38
2020-03-01,Liguria,12,1,13,8,21,-17,-17,4,0,25,121,,IT,IT_42,8,-25,0,0,0,21
2020-03-02,Liguria,12,1,13,5,18,-3,-3,4,0,22,121,,IT,IT_42,0,-3,0,0,0,18
2020-03-03,Liguria,12,2,14,5,19,1,2,4,1,24,121,,IT,IT_42,0,0,0,1,0,19
2020-03-04,Liguria,10,3,13,8,21,2,2,4,1,26,133,,IT,IT_42,-2,3,0,0,12,21
2020-03-05,Liguria,11,3,14,7,21,0,2,4,3,28,146,,IT,IT_42,1,-1,0,2,13,21
2020-03-06,Liguria,12,5,17,7,24,3,4,5,3,32,229,,IT,IT_42,1,0,1,0,83,24
2020-03-07,Liguria,26,6,32,10,42,18,19,5,4,51,331,,IT,IT_42,14,3,0,1,102,42
2020-03-08,Liguria,39,11,50,17,67,25,27,5,6,78,401,,IT,IT_42,13,7,0,2,70,67
2020-03-09,Liguria,60,17,77,20,97,30,31,5,7,109,611,,IT,IT_42,21,3,0,1,210,97
2020-03-10,Liguria,57,29,86,42,128,31,32,5,8,141,694,,IT,IT_42,-3,22,0,1,83,128
2020-03-11,Liguria,74,34,108,73,181,53,53,5,8,194,1025,,IT,IT_42,17,31,0,0,331,181
2020-03-12,Liguria,100,36,136,107,243,62,80,20,11,274,1174,,IT,IT_42,26,34,15,3,149,243
2020-03-13,Liguria,128,44,172,132,304,61,71,24,17,345,1442,,IT,IT_42,28,25,4,6,268,304
2020-03-14,Liguria,213,62,275,109,384,80,118,52,27,463,1750,,IT,IT_42,85,-23,28,10,308,384
2020-03-15,Liguria,253,66,319,174,493,109,96,33,33,559,1973,,IT,IT_42,40,65,-19,6,223,493
2020-03-16,Liguria,255,73,328,247,575,82,108,42,50,667,2189,,IT,IT_42,2,73,9,17,216,575
2020-03-17,Liguria,299,85,384,277,661,86,111,57,60,778,2509,,IT,IT_42,44,30,15,10,320,661
2020-03-18,Liguria,401,100,501,243,744,83,109,70,73,887,2912,,IT,IT_42,102,-34,13,13,403,744
2020-03-19,Liguria,491,112,603,280,883,139,172,85,91,1059,3348,,IT,IT_42,90,37,15,18,436,883
2020-03-20,Liguria,573,121,694,307,1001,118,162,101,119,1221,3794,,IT,IT_42,82,27,16,28,446,1001
2020-03-21,Liguria,598,129,727,432,1159,158,215,125,152,1436,4304,,IT,IT_42,25,125,24,33,510,1159
2020-03-22,Liguria,736,132,868,483,1351,192,229,143,171,1665,4995,,IT,IT_42,138,51,18,19,691,1351
2020-03-23,Liguria,761,133,894,659,1553,202,259,159,212,1924,5538,,IT,IT_42,25,176,16,41,543,1553
2020-03-24,Liguria,803,147,950,742,1692,139,192,193,231,2116,5992,,IT,IT_42,42,83,34,19,454,1692
2020-03-25,Liguria,927,147,1074,752,1826,134,189,225,254,2305,6602,,IT,IT_42,124,10,32,23,610,1826
2020-03-26,Liguria,998,154,1152,875,2027,201,262,260,280,2567,7304,,IT,IT_42,71,123,35,26,702,2027
2020-03-27,Liguria,1023,157,1180,880,2060,33,129,305,331,2696,7804,,IT,IT_42,25,5,45,51,500,2060
2020-03-28,Liguria,1031,167,1198,888,2086,26,126,378,358,2822,8177,,IT,IT_42,8,8,73,27,373,2086
2020-03-29,Liguria,1077,166,1243,1036,2279,193,254,420,377,3076,9100,,IT,IT_42,46,148,42,19,923,2279
2020-03-30,Liguria,1142,175,1317,1066,2383,104,141,437,397,3217,9677,,IT,IT_42,65,30,17,20,577,2383
2020-03-31,Liguria,1153,179,1332,1176,2508,125,199,480,428,3416,10376,,IT,IT_42,11,110,43,31,699,2508
2020-04-01,Liguria,1114,179,1293,1352,2645,137,244,555,460,3660,11334,,IT,IT_42,-39,176,75,32,958,2645
2020-04-02,Liguria,1120,172,1292,1368,2660,15,122,634,488,3782,12069,,IT,IT_42,6,16,79,28,735,2660
2020-04-03,Liguria,1147,173,1320,1426,2746,86,183,700,519,3965,12934,,IT,IT_42,27,58,66,31,865,2746
2020-04-04,Liguria,1121,169,1290,1604,2894,148,238,767,542,4203,14087,,IT,IT_42,-26,178,67,23,1153,2894
2020-04-05,Liguria,1126,165,1291,1802,3093,199,246,800,556,4449,15047,,IT,IT_42,5,198,33,14,960,3093
2020-04-06,Liguria,1141,162,1303,1814,3117,24,100,837,595,4549,15533,,IT,IT_42,15,12,37,39,486,3117
2020-04-07,Liguria,1090,156,1246,1966,3212,95,208,925,620,4757,16579,,IT,IT_42,-51,152,88,25,1046,3212
2020-04-08,Liguria,1109,153,1262,1983,3245,33,149,1007,654,4906,17521,,IT,IT_42,19,17,82,34,942,3245
2020-04-09,Liguria,1103,154,1257,1996,3253,8,114,1085,682,5020,18446,,IT,IT_42,-6,13,78,28,925,3253
2020-04-10,Liguria,1076,151,1227,2074,3301,48,171,1181,709,5191,19514,,IT,IT_42,-27,78,96,27,1068,3301
2020-04-11,Liguria,1003,146,1149,2184,3333,32,185,1309,734,5376,20888,,IT,IT_42,-73,110,128,25,1374,3333
2020-04-12,Liguria,1032,144,1176,2157,3333,0,118,1412,749,5494,21983,,IT,IT_42,29,-27,103,15,1095,3333
2020-04-13,Liguria,1088,138,1226,2139,3365,32,102,1471,760,5596,23129,,IT,IT_42,56,-18,59,11,1146,3365
2020-04-14,Liguria,967,133,1100,2366,3466,101,212,1549,793,5808,24446,,IT,IT_42,-121,227,78,33,1317,3466
2020-04-15,Liguria,959,120,1079,2385,3464,-2,128,1665,807,5936,25793,,IT,IT_42,-8,19,116,14,1347,3464
2020-04-16,Liguria,957,103,1060,2377,3437,-27,103,1774,828,6039,26945,,IT,IT_42,-2,-8,109,21,1152,3437
2020-04-17,Liguria,897,105,1002,2457,3459,22,149,1863,866,6188,28181,,IT,IT_42,-60,80,89,38,1236,3459
2020-04-18,Liguria,901,105,1006,2406,3412,-47,113,1992,897,6301,29322,,IT,IT_42,4,-51,129,31,1141,3412
2020-04-19,Liguria,885,101,986,2504,3490,78,227,2110,928,6528,31551,21103,IT,IT_42,-16,98,118,31,2229,3490
2020-04-20,Liguria,878,102,980,2516,3496,6,141,2216,957,6669,33007,21979,IT,IT_42,-7,12,106,29,1456,3496
2020-04-21,Liguria,914,94,1008,2455,3463,-33,95,2311,990,6764,34186,22670,IT,IT_42,36,-61,95,33,1179,3463
2020-04-22,Liguria,860,92,952,2524,3476,13,154,2420,1022,6918,35990,23756,IT,IT_42,-54,69,109,32,1804,3476
2020-04-23,Liguria,783,91,874,2592,3466,-10,131,2536,1047,7049,37842,25045,IT,IT_42,-77,68,116,25,1852,3466
2020-04-24,Liguria,760,87,847,2590,3437,-29,124,2660,1076,7173,39563,26040,IT,IT_42,-23,-2,124,29,1721,3437
2020-04-25,Liguria,759,83,842,2591,3433,-4,128,2775,1093,7301,41125,26898,IT,IT_42,-1,1,115,17,1562,3433
2020-04-26,Liguria,748,82,830,2650,3480,47,187,2894,1114,7488,42607,27852,IT,IT_42,-11,59,119,21,1482,3480
2020-04-27,Liguria,754,83,837,2743,3580,100,154,2934,1128,7642,44039,28739,IT,IT_42,6,93,40,14,1432,3580
2020-04-28,Liguria,718,81,799,2772,3571,-9,130,3060,1141,7772,45719,29794,IT,IT_42,-36,29,126,13,1680,3571
2020-04-29,Liguria,697,70,767,2809,3576,5,117,3161,1152,7889,47220,30669,IT,IT_42,-21,37,101,11,1501,3576
2020-04-30,Liguria,676,69,745,2806,3551,-25,104,3275,1167,7993,48762,31520,IT,IT_42,-21,-3,114,15,1542,3551
2020-05-01,Liguria,666,68,734,2784,3518,-33,133,3424,1184,8126,51199,32794,IT,IT_42,-10,-22,149,17,2437,3518
2020-05-02,Liguria,647,68,715,2883,3598,80,186,3519,1195,8312,53202,34037,IT,IT_42,-19,99,95,11,2003,3598
2020-05-03,Liguria,627,68,695,2856,3551,-47,47,3599,1209,8359,54492,34613,IT,IT_42,-20,-27,80,14,1290,3551
2020-05-04,Liguria,606,72,678,2830,3508,-43,53,3683,1221,8412,56092,35443,IT,IT_42,-21,-26,84,12,1600,3508
2020-05-05,Liguria,583,68,651,2776,3427,-81,63,3816,1232,8475,57622,36150,IT,IT_42,-23,-54,133,11,1530,3427
2020-05-06,Liguria,548,59,607,2699,3306,-121,76,4002,1243,8551,59693,37177,IT,IT_42,-35,-77,186,11,2071,3306
2020-05-07,Liguria,525,57,582,2666,3248,-58,94,4143,1254,8645,61446,38071,IT,IT_42,-23,-33,141,11,1753,3248
2020-05-08,Liguria,517,46,563,2613,3176,-72,78,4282,1265,8723,63531,39145,IT,IT_42,-8,-53,139,11,2085,3176
2020-05-09,Liguria,501,42,543,2439,2982,-194,15,4480,1276,8738,64926,39600,IT,IT_42,-16,-174,198,11,1395,2982
2020-05-10,Liguria,481,41,522,2378,2900,-82,50,4607,1281,8788,67322,40751,IT,IT_42,-20,-61,127,5,2396,2900
2020-05-11,Liguria,484,38,522,2322,2844,-56,44,4695,1293,8832,68814,41535,IT,IT_42,3,-56,88,12,1492,2844
2020-05-12,Liguria,447,35,482,2297,2779,-65,31,4783,1301,8863,70159,42200,IT,IT_42,-37,-25,88,8,1345,2779
2020-05-13,Liguria,430,35,465,2253,2718,-61,67,4898,1314,8930,72174,43272,IT,IT_42,-17,-44,115,13,2015,2718
2020-05-14,Liguria,408,35,443,2217,2660,-58,65,5006,1329,8995,74248,44390,IT,IT_42,-22,-36,108,15,2074,2660
2020-05-15,Liguria,385,31,416,2187,2603,-57,65,5121,1336,9060,76012,45307,IT,IT_42,-23,-30,115,7,1764,2603
2020-05-16,Liguria,369,26,395,2138,2533,-70,51,5232,1346,9111,78068,46304,IT,IT_42,-16,-49,111,10,2056,2533
2020-05-17,Liguria,360,24,384,2072,2456,-77,48,5348,1355,9159,80154,47381,IT,IT_42,-9,-66,116,9,2086,2456
2020-05-18,Liguria,360,23,383,1956,2339,-117,32,5485,1367,9191,81485,47984,IT,IT_42,0,-116,137,12,1331,2339
2020-05-19,Liguria,338,22,360,1904,2264,-75,66,5617,1376,9257,83593,49038,IT,IT_42,-22,-52,132,9,2108,2264
2020-05-20,Liguria,310,22,332,1846,2178,-86,32,5725,1386,9289,85140,49819,IT,IT_42,-28,-58,108,10,1547,2178
2020-05-21,Liguria,283,22,305,1770,2075,-103,55,5872,1397,9344,87011,50812,IT,IT_42,-27,-76,147,11,1871,2075
2020-05-22,Liguria,269,19,288,1620,1908,-167,45,6074,1407,9389,89529,51771,IT,IT_42,-14,-150,202,10,2518,1908
2020-05-23,Liguria,247,20,267,1467,1734,-174,38,6279,1414,9427,91735,52664,IT,IT_42,-22,-153,205,7,2206,1734
2020-05-24,Liguria,247,18,265,1359,1624,-110,53,6437,1419,9480,93173,53230,IT,IT_42,0,-108,158,5,1438,1624
2020-05-25,Liguria,236,18,254,1302,1556,-68,17,6516,1425,9497,94472,53791,IT,IT_42,-11,-57,79,6,1299,1556
2020-05-26,Liguria,223,19,242,1196,1438,-118,53,6681,1431,9550,96678,54918,IT,IT_42,-13,-106,165,6,2206,1438
2020-05-27,Liguria,205,14,219,1050,1269,-169,39,6882,1438,9589,98835,55899,IT,IT_42,-18,-146,201,7,2157,1269
2020-05-28,Liguria,198,13,211,934,1145,-124,16,7015,1445,9605,100625,56739,IT,IT_42,-7,-116,133,7,1790,1145
2020-05-29,Liguria,192,13,205,789,994,-151,14,7173,1452,9619,102173,57376,IT,IT_42,-6,-145,158,7,1548,994
2020-05-30,Liguria,186,9,195,586,781,-213,32,7411,1459,9651,104892,58665,IT,IT_42,-6,-203,238,7,2719,781
2020-05-31,Liguria,195,8,203,466,669,-112,12,7529,1465,9663,106363,59374,IT,IT_42,9,-120,118,6,1471,669
2020-06-01,Liguria,191,7,198,413,611,-58,56,7641,1467,9719,107787,60117,IT,IT_42,-4,-53,112,2,1424,611
2020-06-02,Liguria,175,7,182,364,546,-65,15,7720,1468,9734,109060,60631,IT,IT_42,-16,-49,79,1,1273,546
2020-06-03,Liguria,169,6,175,339,514,-32,17,7764,1473,9751,110006,61006,IT,IT_42,-6,-25,44,5,946,514
2020-06-04,Liguria,149,6,155,239,394,-120,21,7899,1479,9772,111587,61688,IT,IT_42,-20,-100,135,6,1581,394
2020-06-05,Liguria,142,6,148,96,244,-150,14,8056,1486,9786,113329,62417,IT,IT_42,-7,-143,157,7,1742,244
2020-06-06,Liguria,136,4,140,105,245,1,13,8062,1492,9799,114887,63119,IT,IT_42,-6,9,6,6,1558,245
2020-06-07,Liguria,127,5,132,111,243,-2,13,8070,1499,9812,116247,63749,IT,IT_42,-9,6,8,7,1360,243
2020-06-08,Liguria,125,5,130,118,248,5,14,8073,1505,9826,117410,64349,IT,IT_42,-2,7,3,6,1163,248
2020-06-09,Liguria,119,5,124,125,249,1,8,8076,1509,9834,118891,65073,IT,IT_42,-6,7,3,4,1481,249
2020-06-10,Liguria,110,3,113,132,245,-4,20,8096,1513,9854,121023,66009,IT,IT_42,-9,7,20,4,2132,245
2020-06-11,Liguria,107,3,110,140,250,5,10,8100,1514,9864,122654,66755,IT,IT_42,-3,8,4,1,1631,250
2020-06-12,Liguria,103,3,106,143,249,-1,7,8106,1516,9871,124320,67544,IT,IT_42,-4,3,6,2,1666,249
2020-06-13,Liguria,91,3,94,150,244,-5,4,8113,1518,9875,125871,68333,IT,IT_42,-12,7,7,2,1551,244
2020-06-14,Liguria,85,3,88,155,243,-1,4,8115,1521,9879,126705,68766,IT,IT_42,-6,5,2,3,834,243
2020-06-15,Liguria,87,2,89,157,246,3,8,8116,1525,9887,127913,69345,IT,IT_42,2,2,1,4,1208,246
2020-06-16,Liguria,76,2,78,164,242,-4,4,8120,1529,9891,129249,69980,IT,IT_42,-11,7,4,4,1336,242
2020-06-17,Liguria,73,2,75,169,244,2,5,8120,1532,9896,130870,70737,IT,IT_42,-3,5,0,3,1621,244
2020-06-18,Liguria,70,2,72,174,246,2,7,8121,1536,9903,132375,71497,IT,IT_42,-3,5,1,4,1505,246
2020-06-19,Liguria,66,3,69,180,249,3,7,8121,1540,9910,133898,72175,IT,IT_42,-4,6,0,4,1523,249
2020-06-20,Liguria,61,3,64,186,250,1,10,8125,1545,9920,135379,73012,IT,IT_42,-5,6,4,5,1481,250
2020-02-24,Lombardia,76,19,95,71,166,0,166,0,6,172,1463,,IT,IT_25,,,,,,0
2020-02-25,Lombardia,79,25,104,127,231,65,68,0,9,240,3700,,IT,IT_25,3,56,0,3,2237,65
2020-02-26,Lombardia,79,25,104,145,249,18,18,0,9,258,3208,,IT,IT_25,0,18,0,0,-492,83
2020-02-27,Lombardia,172,41,213,136,349,100,145,40,14,403,3320,,IT,IT_25,93,-9,40,5,112,183
2020-02-28,Lombardia,235,47,282,192,474,125,128,40,17,531,4835,,IT,IT_25,63,56,0,3,1515,308
2020-02-29,Lombardia,256,80,336,216,552,78,84,40,23,615,5723,,IT,IT_25,21,24,0,6,888,386
2020-03-01,Lombardia,406,106,512,375,887,335,369,73,24,984,6879,,IT,IT_25,150,159,33,1,1156,721
2020-03-02,Lombardia,478,127,605,472,1077,190,270,139,38,1254,7925,,IT,IT_25,72,97,66,14,1046,911
2020-03-03,Lombardia,698,167,865,461,1326,249,266,139,55,1520,9577,,IT,IT_25,220,-11,0,17,1652,1160
2020-03-04,Lombardia,877,209,1086,411,1497,171,300,250,73,1820,12138,,IT,IT_25,179,-50,111,18,2561,1331
2020-03-05,Lombardia,1169,244,1413,364,1777,280,431,376,98,2251,12354,,IT,IT_25,292,-47,126,25,216,1611
2020-03-06,Lombardia,1622,309,1931,77,2008,231,361,469,135,2612,13556,,IT,IT_25,453,-287,93,37,1202,1842
2020-03-07,Lombardia,1661,359,2020,722,2742,734,808,524,154,3420,15778,,IT,IT_25,39,645,55,19,2222,2576
2020-03-08,Lombardia,2217,399,2616,756,3372,630,769,550,267,4189,18534,,IT,IT_25,556,34,26,113,2756,3206
2020-03-09,Lombardia,2802,440,3242,1248,4490,1118,1280,646,333,5469,20135,,IT,IT_25,585,492,96,66,1601,4324
2020-03-10,Lombardia,3319,466,3785,642,4427,-63,322,896,468,5791,21479,,IT,IT_25,517,-606,250,135,1344,4261
2020-03-11,Lombardia,3852,560,4412,1351,5763,1336,1489,900,617,7280,25629,,IT,IT_25,533,709,4,149,4150,5597
2020-03-12,Lombardia,4247,605,4852,2044,6896,1133,1445,1085,744,8725,29534,,IT,IT_25,395,693,185,127,3905,6730
2020-03-13,Lombardia,4435,650,5085,2647,7732,836,1095,1198,890,9820,32700,,IT,IT_25,188,603,113,146,3166,7566
2020-03-14,Lombardia,4898,732,5630,3429,9059,1327,1865,1660,966,11685,37138,,IT,IT_25,463,782,462,76,4438,8893
2020-03-15,Lombardia,5500,767,6267,3776,10043,984,1587,2011,1218,13272,40369,,IT,IT_25,602,347,351,252,3231,9877
2020-03-16,Lombardia,6171,823,6994,3867,10861,818,1377,2368,1420,14649,43565,,IT,IT_25,671,91,357,202,3196,10695
2020-03-17,Lombardia,6953,879,7832,4263,12095,1234,1571,2485,1640,16220,46449,,IT,IT_25,782,396,117,220,2884,11929
2020-03-18,Lombardia,7285,924,8209,4057,12266,171,1493,3488,1959,17713,48983,,IT,IT_25,332,-206,1003,319,2534,12100
2020-03-19,Lombardia,7387,1006,8393,5545,13938,1672,2171,3778,2168,19884,52244,,IT,IT_25,102,1488,290,209,3261,13772
2020-03-20,Lombardia,7735,1050,8785,6635,15420,1482,2380,4295,2549,22264,57174,,IT,IT_25,348,1090,517,381,4930,15254
2020-03-21,Lombardia,8258,1093,9351,8019,17370,1950,3251,5050,3095,25515,66730,,IT,IT_25,523,1384,755,546,9556,17204
2020-03-22,Lombardia,9439,1142,10581,7304,17885,515,1691,5865,3456,27206,70598,,IT,IT_25,1181,-715,815,361,3868,17719
2020-03-23,Lombardia,9266,1183,10449,8461,18910,1025,1555,6075,3776,28761,73242,,IT,IT_25,-173,1157,210,320,2644,18744
2020-03-24,Lombardia,9711,1194,10905,8963,19868,958,1942,6657,4178,30703,76695,,IT,IT_25,445,502,582,402,3453,19702
2020-03-25,Lombardia,10026,1236,11262,9329,20591,723,1643,7281,4474,32346,81666,,IT,IT_25,315,366,624,296,4971,20425
2020-03-26,Lombardia,10681,1263,11944,10245,22189,1598,2543,7839,4861,34889,87713,,IT,IT_25,655,916,558,387,6047,22023
2020-03-27,Lombardia,11137,1292,12429,11466,23895,1706,2409,8001,5402,37298,95860,,IT,IT_25,456,1221,162,541,8147,23729
2020-03-28,Lombardia,11152,1319,12471,12038,24509,614,2117,8962,5944,39415,102503,,IT,IT_25,15,572,961,542,6643,24343
2020-03-29,Lombardia,11613,1328,12941,12451,25392,883,1592,9255,6360,41007,107398,,IT,IT_25,461,413,293,416,4895,25226
2020-03-30,Lombardia,11815,1330,13145,11861,25006,-386,1154,10337,6818,42161,111057,,IT,IT_25,202,-590,1082,458,3659,24840
2020-03-31,Lombardia,11883,1324,13207,11917,25124,118,1047,10885,7199,43208,114640,,IT,IT_25,68,56,548,381,3583,24958
2020-04-01,Lombardia,11927,1342,13269,12496,25765,641,1565,11415,7593,44773,121449,,IT,IT_25,44,579,530,394,6809,25599
2020-04-02,Lombardia,11762,1351,13113,12763,25876,111,1292,12229,7960,46065,128286,,IT,IT_25,-165,267,814,367,6837,25710
2020-04-03,Lombardia,11802,1381,13183,13006,26189,313,1455,13020,8311,47520,135051,,IT,IT_25,40,243,791,351,6765,26023
2020-04-04,Lombardia,12002,1326,13328,13892,27220,1031,1598,13242,8656,49118,141877,,IT,IT_25,200,886,222,345,6826,27054
2020-04-05,Lombardia,12009,1317,13326,14798,28124,904,1337,13426,8905,50455,149984,,IT,IT_25,7,906,184,249,8107,27958
2020-04-06,Lombardia,11914,1343,13257,15212,28469,345,1079,13863,9202,51534,154989,,IT,IT_25,-95,414,437,297,5005,28303
2020-04-07,Lombardia,11833,1305,13138,15205,28343,-126,791,14498,9484,52325,159331,,IT,IT_25,-81,-7,635,282,4342,28177
2020-04-08,Lombardia,11719,1257,12976,15569,28545,202,1089,15147,9722,53414,167557,,IT,IT_25,-114,364,649,238,8226,28379
2020-04-09,Lombardia,11796,1236,13032,16042,29074,529,1388,15706,10022,54802,176953,,IT,IT_25,77,473,559,300,9396,28908
2020-04-10,Lombardia,11877,1202,13079,16451,29530,456,1246,16280,10238,56048,186325,,IT,IT_25,81,409,574,216,9372,29364
2020-04-11,Lombardia,12026,1174,13200,17058,30258,728,1544,16823,10511,57592,196302,,IT,IT_25,149,607,543,273,9977,30092
2020-04-12,Lombardia,11969,1176,13145,18120,31265,1007,1460,17166,10621,59052,205832,,IT,IT_25,-57,1062,343,110,9530,31099
2020-04-13,Lombardia,12028,1143,13171,18764,31935,670,1262,17478,10901,60314,211092,,IT,IT_25,59,644,312,280,5260,31769
2020-04-14,Lombardia,12077,1122,13199,19164,32363,428,1012,17821,11142,61326,214870,,IT,IT_25,49,400,343,241,3778,32197
2020-04-15,Lombardia,12043,1074,13117,19804,32921,558,827,17855,11377,62153,221968,,IT,IT_25,-34,640,34,235,7098,32755
2020-04-16,Lombardia,11356,1032,12388,20702,33090,169,941,18396,11608,63094,232674,,IT,IT_25,-687,898,541,231,10706,32924
2020-04-17,Lombardia,10627,971,11598,21836,33434,344,1041,18850,11851,64135,243513,,IT,IT_25,-729,1134,454,243,10839,33268
2020-04-18,Lombardia,10042,947,10989,23206,34195,761,1246,19136,12050,65381,255331,,IT,IT_25,-585,1370,286,199,11818,34029
2020-04-19,Lombardia,10342,922,11264,23233,34497,302,855,19526,12213,66236,264155,183757,IT,IT_25,300,27,390,163,8824,34331
2020-04-20,Lombardia,10138,901,11039,23548,34587,90,735,20008,12376,66971,270486,173333,IT,IT_25,-204,315,482,163,6331,34421
2020-04-21,Lombardia,9805,851,10656,23322,33978,-609,960,21374,12579,67931,277197,173333,IT,IT_25,-333,-226,1366,203,6711,33812
2020-04-22,Lombardia,9692,817,10509,23733,34242,264,1161,22110,12740,69092,290699,184323,IT,IT_25,-113,411,736,161,13502,34076
2020-04-23,Lombardia,9192,790,9982,23891,33873,-369,1073,23352,12940,70165,302715,190451,IT,IT_25,-500,158,1242,200,12016,33707
2020-04-24,Lombardia,8791,756,9547,24821,34368,495,1091,23782,13106,71256,314298,196406,IT,IT_25,-401,930,430,166,11583,34202
2020-04-25,Lombardia,8489,724,9213,25260,34473,105,713,24227,13269,71969,326940,202827,IT,IT_25,-302,439,445,163,12642,34307
2020-04-26,Lombardia,8481,706,9187,25979,35166,693,920,24398,13325,72889,337797,208471,IT,IT_25,-8,719,171,56,10857,35000
2020-04-27,Lombardia,7525,680,8205,27236,35441,275,590,24589,13449,73479,342850,211523,IT,IT_25,-956,1257,191,124,5053,35275
2020-04-28,Lombardia,7280,655,7935,27809,35744,303,869,25029,13575,74348,351423,216526,IT,IT_25,-245,573,440,126,8573,35578
2020-04-29,Lombardia,7120,634,7754,28368,36122,378,786,25333,13679,75134,365895,223952,IT,IT_25,-160,559,304,104,14472,35956
2020-04-30,Lombardia,6834,605,7439,28772,36211,89,598,25749,13772,75732,376943,229880,IT,IT_25,-286,404,416,93,11048,36045
2020-05-01,Lombardia,6628,563,7191,29282,36473,262,737,26136,13860,76469,390644,236822,IT,IT_25,-206,510,387,88,13701,36307
2020-05-02,Lombardia,6529,545,7074,29593,36667,194,533,26146,14189,77002,403702,243383,IT,IT_25,-99,311,10,329,13058,36501
2020-05-03,Lombardia,6609,532,7141,29785,36926,259,526,26371,14231,77528,410857,247176,IT,IT_25,80,192,225,42,7155,36760
2020-05-04,Lombardia,6414,532,6946,30361,37307,381,577,26504,14294,78105,418835,251661,IT,IT_25,-195,576,133,63,7978,37141
2020-05-05,Lombardia,6201,509,6710,30382,37092,-215,500,27124,14389,78605,425290,255292,IT,IT_25,-213,21,620,95,6455,36926
2020-05-06,Lombardia,6079,480,6559,25194,31753,-5339,764,33005,14611,79369,439806,262964,IT,IT_25,-122,-5188,5881,222,14516,31587
2020-05-07,Lombardia,5848,480,6328,25687,32015,262,720,33329,14745,80089,455294,262964,IT,IT_25,-231,493,324,134,15488,31849
2020-05-08,Lombardia,5702,400,6102,25881,31983,-32,634,33901,14839,80723,466287,277106,IT,IT_25,-146,194,572,94,10993,31817
2020-05-09,Lombardia,5535,330,5865,24397,30262,-1721,502,36039,14924,81225,477765,282817,IT,IT_25,-167,-1484,2138,85,11478,30096
2020-05-10,Lombardia,5428,348,5776,24414,30190,-72,282,36331,14986,81507,485134,287330,IT,IT_25,-107,17,292,62,7369,30024
2020-05-11,Lombardia,5397,341,5738,24673,30411,221,364,36406,15054,81871,492642,292603,IT,IT_25,-31,259,75,68,7508,30245
2020-05-12,Lombardia,5222,322,5544,25131,30675,264,1033,37113,15116,82904,513244,305152,IT,IT_25,-175,458,707,62,20602,30509
2020-05-13,Lombardia,5007,307,5314,24718,30032,-643,394,38081,15185,83298,524163,310896,IT,IT_25,-215,-413,968,69,10919,29866
2020-05-14,Lombardia,4818,297,5115,24841,29956,-76,522,38568,15296,83820,538243,318289,IT,IT_25,-189,123,487,111,14080,29790
2020-05-15,Lombardia,4705,276,4981,22765,27746,-2210,299,40962,15411,84119,550405,325071,IT,IT_25,-113,-2076,2394,115,12162,27580
2020-05-16,Lombardia,4521,268,4789,22890,27679,-67,399,41389,15450,84518,564550,333243,IT,IT_25,-184,125,427,39,14145,27513
2020-05-17,Lombardia,4480,255,4735,22695,27430,-249,326,41895,15519,84844,576359,340164,IT,IT_25,-41,-195,506,69,11809,27264
2020-05-18,Lombardia,4482,252,4734,22339,27073,-357,175,42403,15543,85019,581437,343213,IT,IT_25,2,-356,508,24,5078,26907
2020-05-19,Lombardia,4426,244,4670,22621,27291,218,462,42593,15597,85481,596355,353579,IT,IT_25,-56,282,190,54,14918,27125
2020-05-20,Lombardia,4281,231,4512,22159,26671,-620,294,43442,15662,85775,607863,359922,IT,IT_25,-145,-462,849,65,11508,26505
2020-05-21,Lombardia,4119,226,4345,22370,26715,44,316,43649,15727,86091,622565,368046,IT,IT_25,-162,211,207,65,14702,26549
2020-05-22,Lombardia,4028,207,4235,21698,25933,-782,293,44667,15784,86384,641593,378934,IT,IT_25,-91,-672,1018,57,19028,25767
2020-05-23,Lombardia,4026,199,4225,21405,25630,-303,441,45355,15840,86825,658784,389648,IT,IT_25,-2,-293,688,56,17191,25464
2020-05-24,Lombardia,4017,197,4214,21400,25614,-16,285,45656,15840,87110,670241,396992,IT,IT_25,-9,-5,301,0,11457,25448
2020-05-25,Lombardia,3721,196,3917,21298,25215,-399,148,46169,15874,87258,675882,400252,IT,IT_25,-296,-102,513,34,5641,25049
2020-05-26,Lombardia,3622,183,3805,20672,24477,-738,159,47044,15896,87417,685058,405650,IT,IT_25,-99,-626,875,22,9176,24311
2020-05-27,Lombardia,3626,175,3801,20236,24037,-440,384,47810,15954,87801,697561,413483,IT,IT_25,4,-436,766,58,12503,23871
2020-05-28,Lombardia,3470,173,3643,19270,22913,-1124,382,49296,15974,88183,713068,422568,IT,IT_25,-156,-966,1486,20,15507,22747
2020-05-29,Lombardia,3552,173,3725,18958,22683,-230,354,49842,16012,88537,727146,430863,IT,IT_25,82,-312,546,38,14078,22517
2020-05-30,Lombardia,3307,172,3479,18330,21809,-874,221,50870,16079,88758,741447,438415,IT,IT_25,-245,-628,1028,67,14301,21643
2020-05-31,Lombardia,3131,170,3301,17695,20996,-813,210,51860,16112,88968,753874,445930,IT,IT_25,-176,-635,990,33,12427,20830
2020-06-01,Lombardia,3085,167,3252,17609,20861,-135,50,52026,16131,89018,757446,447874,IT,IT_25,-46,-86,166,19,3572,20695
2020-06-02,Lombardia,3021,166,3187,17068,20255,-606,187,52807,16143,89205,766122,451502,IT,IT_25,-64,-541,781,12,8676,20089
2020-06-03,Lombardia,2995,131,3126,17098,20224,-31,237,53046,16172,89442,777477,458782,IT,IT_25,-26,30,239,29,11355,20058
2020-06-04,Lombardia,2954,125,3079,17145,20224,0,84,53101,16201,89526,780887,460658,IT,IT_25,-41,47,55,29,3410,20058
2020-06-05,Lombardia,2960,120,3080,16773,19853,-371,402,53853,16222,89928,800276,475041,IT,IT_25,6,-372,752,21,19389,19687
2020-06-06,Lombardia,2840,110,2950,16549,19499,-354,142,54322,16249,90070,813972,480566,IT,IT_25,-120,-224,469,27,13696,19333
2020-06-07,Lombardia,2801,107,2908,16512,19420,-79,125,54505,16270,90195,821977,485842,IT,IT_25,-39,-37,183,21,8005,19254
2020-06-08,Lombardia,2708,107,2815,16504,19319,-101,194,54768,16302,90389,826465,489775,IT,IT_25,-93,-8,263,32,4488,19153
2020-06-09,Lombardia,2660,96,2756,15541,18297,-1022,192,55967,16317,90581,836313,496273,IT,IT_25,-48,-963,1199,15,9848,18131
2020-06-10,Lombardia,2565,98,2663,15194,17857,-440,99,56474,16349,90680,845618,502047,IT,IT_25,-95,-347,507,32,9305,17691
2020-06-11,Lombardia,2488,97,2585,14755,17340,-517,252,57218,16374,90932,858994,509853,IT,IT_25,-77,-439,744,25,13376,17174
2020-06-12,Lombardia,2357,97,2454,14570,17024,-316,272,57775,16405,91204,873831,519095,IT,IT_25,-131,-185,557,31,14837,16858
2020-06-13,Lombardia,2252,96,2348,14437,16785,-239,210,58201,16428,91414,883305,524774,IT,IT_25,-105,-133,426,23,9474,16619
2020-06-14,Lombardia,2116,94,2210,13779,15989,-796,244,59220,16449,91658,892641,530683,IT,IT_25,-136,-658,1019,21,9336,15823
2020-06-15,Lombardia,2018,94,2112,13864,15976,-13,259,59484,16457,91917,899278,534981,IT,IT_25,-98,85,264,8,6637,15810
2020-06-16,Lombardia,1902,69,1971,13262,15233,-743,143,60361,16466,92060,906322,539604,IT,IT_25,-116,-602,877,9,7044,15067
2020-06-17,Lombardia,1796,59,1855,13117,14972,-261,242,60850,16480,92302,917881,547133,IT,IT_25,-106,-145,489,14,11559,14806
2020-06-18,Lombardia,1673,60,1733,12914,14647,-325,216,61355,16516,92518,929356,554148,IT,IT_25,-123,-203,505,36,11475,14481
2020-06-19,Lombardia,1537,60,1597,12448,14045,-602,157,62096,16534,92675,939820,560376,IT,IT_25,-136,-466,741,18,10464,13879
2020-06-20,Lombardia,1401,54,1455,12456,13911,-134,165,62372,16557,92840,949134,565933,IT,IT_25,-136,8,276,23,9314,13745
2020-02-24,Marche,0,0,0,0,0,0,0,0,0,0,16,,IT,IT_57,,,,,,0
2020-02-25,Marche,0,0,0,0,0,0,0,0,0,0,21,,IT,IT_57,0,0,0,0,5,0
2020-02-26,Marche,1,0,1,0,1,1,1,0,0,1,28,,IT,IT_57,1,0,0,0,7,1
2020-02-27,Marche,2,1,3,0,3,2,2,0,0,3,46,,IT,IT_57,1,0,0,0,18,3
2020-02-28,Marche,3,2,5,1,6,3,3,0,0,6,47,,IT,IT_57,1,1,0,0,1,6
2020-02-29,Marche,6,2,8,3,11,5,5,0,0,11,68,,IT,IT_57,3,2,0,0,21,11
2020-03-01,Marche,12,5,17,8,25,14,14,0,0,25,101,,IT,IT_57,6,5,0,0,33,25
2020-03-02,Marche,17,6,23,11,34,9,10,0,1,35,137,,IT,IT_57,5,3,0,1,36,34
2020-03-03,Marche,27,13,40,19,59,25,26,0,2,61,200,,IT,IT_57,10,8,0,1,63,59
2020-03-04,Marche,34,15,49,31,80,21,23,0,4,84,288,,IT,IT_57,7,12,0,2,88,80
2020-03-05,Marche,57,19,76,44,120,40,40,0,4,124,413,,IT,IT_57,23,13,0,0,125,120
2020-03-06,Marche,73,20,93,62,155,35,35,0,4,159,585,,IT,IT_57,16,18,0,0,172,155
2020-03-07,Marche,94,36,130,71,201,46,48,0,6,207,816,,IT,IT_57,21,9,0,2,231,201
2020-03-08,Marche,110,41,151,114,265,64,65,0,7,272,1025,,IT,IT_57,16,43,0,1,209,265
2020-03-09,Marche,136,47,183,130,313,48,51,0,10,323,1250,,IT,IT_57,26,16,0,3,225,313
2020-03-10,Marche,152,54,206,175,381,68,71,0,13,394,1437,,IT,IT_57,16,45,0,3,187,381
2020-03-11,Marche,212,66,278,183,461,80,85,0,18,479,1656,,IT,IT_57,60,8,0,5,219,461
2020-03-12,Marche,254,76,330,240,570,109,113,0,22,592,1907,,IT,IT_57,42,57,0,4,251,570
2020-03-13,Marche,337,85,422,276,698,128,133,0,27,725,2218,,IT,IT_57,83,36,0,5,311,698
2020-03-14,Marche,449,93,542,321,863,165,174,0,36,899,2561,,IT,IT_57,112,45,0,9,343,863
2020-03-15,Marche,521,98,619,468,1087,224,234,0,46,1133,2946,,IT,IT_57,72,147,0,10,385,1087
2020-03-16,Marche,528,110,638,547,1185,98,109,0,57,1242,3225,,IT,IT_57,7,79,0,11,279,1185
2020-03-17,Marche,599,109,708,594,1302,117,129,0,69,1371,3225,,IT,IT_57,71,47,0,12,0,1302
2020-03-18,Marche,638,119,757,719,1476,174,197,0,92,1568,4109,,IT,IT_57,39,125,0,23,884,1476
2020-03-19,Marche,656,141,797,825,1622,146,169,0,115,1737,4512,,IT,IT_57,18,106,0,23,403,1622
2020-03-20,Marche,704,138,842,1002,1844,222,244,0,137,1981,5170,,IT,IT_57,48,177,0,22,658,1844
2020-03-21,Marche,742,141,883,1114,1997,153,172,2,154,2153,5740,,IT,IT_57,38,112,2,17,570,1997
2020-03-22,Marche,816,138,954,1277,2231,234,268,6,184,2421,6391,,IT,IT_57,74,163,4,30,651,2231
2020-03-23,Marche,882,148,1030,1328,2358,127,148,8,203,2569,6782,,IT,IT_57,66,51,2,19,391,2358
2020-03-24,Marche,862,149,1011,1486,2497,139,167,8,231,2736,7229,,IT,IT_57,-20,158,0,28,447,2497
2020-03-25,Marche,938,148,1086,1553,2639,142,198,8,287,2934,7896,,IT,IT_57,76,67,0,56,667,2639
2020-03-26,Marche,977,166,1143,1652,2795,156,180,9,310,3114,8623,,IT,IT_57,39,99,1,23,727,2795
2020-03-27,Marche,979,162,1141,1709,2850,55,82,10,336,3196,9060,,IT,IT_57,2,57,1,26,437,2850
2020-03-28,Marche,987,166,1153,1846,2999,149,177,10,364,3373,9884,,IT,IT_57,8,137,0,28,824,2999
2020-03-29,Marche,1000,168,1168,1992,3160,161,185,12,386,3558,10431,,IT,IT_57,13,146,2,22,547,3160
2020-03-30,Marche,998,167,1165,2086,3251,91,126,16,417,3684,10979,,IT,IT_57,-2,94,4,31,548,3251
2020-03-31,Marche,946,169,1115,2237,3352,101,141,21,452,3825,11724,,IT,IT_57,-52,151,5,35,745,3352
2020-04-01,Marche,984,168,1152,2304,3456,104,137,29,477,3962,12296,,IT,IT_57,38,67,8,25,572,3456
2020-04-02,Marche,986,164,1150,2405,3555,99,136,40,503,4098,12943,,IT,IT_57,2,101,11,26,647,3555
2020-04-03,Marche,982,158,1140,2491,3631,76,132,42,557,4230,13678,,IT,IT_57,-4,86,2,54,735,3631
2020-04-04,Marche,997,153,1150,2347,3497,-134,111,270,574,4341,14472,,IT,IT_57,15,-144,228,17,794,3497
2020-04-05,Marche,987,151,1138,2440,3578,81,123,287,599,4464,15252,,IT,IT_57,-10,93,17,25,780,3578
2020-04-06,Marche,1001,140,1141,2565,3706,128,150,296,612,4614,15919,,IT,IT_57,14,125,9,13,667,3706
2020-04-07,Marche,962,139,1101,2637,3738,32,96,342,630,4710,16619,,IT,IT_57,-39,72,46,18,700,3738
2020-04-08,Marche,974,133,1107,2455,3562,-176,149,645,652,4859,17532,,IT,IT_57,12,-182,303,22,913,3562
2020-04-09,Marche,945,133,1078,2323,3401,-161,96,885,669,4955,18194,,IT,IT_57,-29,-132,240,17,662,3401
2020-04-10,Marche,925,127,1052,2264,3316,-85,129,1086,682,5084,18970,,IT,IT_57,-20,-59,201,13,776,3316
2020-04-11,Marche,960,118,1078,2153,3231,-85,127,1291,689,5211,20060,,IT,IT_57,35,-111,205,7,1090,3231
2020-04-12,Marche,949,114,1063,2051,3114,-117,92,1489,700,5303,21057,,IT,IT_57,-11,-102,198,11,997,3114
2020-04-13,Marche,959,108,1067,2013,3080,-34,78,1588,713,5381,28379,,IT,IT_57,10,-38,99,13,7322,3080
2020-04-14,Marche,937,106,1043,2052,3095,15,45,1603,728,5426,29160,,IT,IT_57,-22,39,15,15,781,3095
2020-04-15,Marche,888,106,994,2103,3097,2,77,1660,746,5503,30329,,IT,IT_57,-49,51,57,18,1169,3097
2020-04-16,Marche,850,102,952,2172,3124,27,79,1694,764,5582,33778,,IT,IT_57,-38,69,34,18,3449,3124
2020-04-17,Marche,839,94,933,2224,3157,33,86,1726,785,5668,37997,,IT,IT_57,-11,52,32,21,4219,3157
2020-04-18,Marche,804,88,892,2280,3172,15,53,1754,795,5721,39909,,IT,IT_57,-35,56,28,10,1912,3172
2020-04-19,Marche,799,86,885,2297,3182,10,48,1780,807,5769,41474,27099,IT,IT_57,-5,17,26,12,1565,3182
2020-04-20,Marche,792,80,872,2340,3212,30,57,1792,822,5826,42782,28006,IT,IT_57,-7,43,12,15,1308,3212
2020-04-21,Marche,784,78,862,2356,3218,6,51,1825,834,5877,44332,29090,IT,IT_57,-8,16,33,12,1550,3218
2020-04-22,Marche,735,76,811,2419,3230,12,47,1849,845,5924,46492,30543,IT,IT_57,-49,63,24,11,2160,3230
2020-04-23,Marche,727,71,798,2432,3230,0,28,1865,857,5952,47662,31673,IT,IT_57,-8,13,16,12,1170,3230
2020-04-24,Marche,705,61,766,2507,3273,43,76,1890,865,6028,49163,33113,IT,IT_57,-22,75,25,8,1501,3273
2020-04-25,Marche,689,58,747,2525,3272,-1,30,1912,874,6058,50996,34256,IT,IT_57,-16,18,22,9,1833,3272
2020-04-26,Marche,668,58,726,2582,3308,36,53,1924,879,6111,52063,35107,IT,IT_57,-21,57,12,5,1067,3308
2020-04-27,Marche,667,58,725,2585,3310,2,16,1933,884,6127,52765,35617,IT,IT_57,-1,3,9,5,702,3310
2020-04-28,Marche,666,58,724,2610,3334,24,48,1948,893,6175,54313,36650,IT,IT_57,-1,25,15,9,1548,3334
2020-04-29,Marche,640,52,692,2655,3347,13,35,1964,899,6210,55905,37877,IT,IT_57,-26,45,16,6,1592,3347
2020-04-30,Marche,465,48,513,2697,3210,-137,37,2131,906,6247,59488,39145,IT,IT_57,-175,42,167,7,3583,3210
2020-05-01,Marche,413,44,457,2754,3211,1,28,2153,911,6275,61241,40123,IT,IT_57,-52,57,22,5,1753,3211
2020-05-02,Marche,399,46,445,2760,3205,-6,23,2177,916,6298,62834,41156,IT,IT_57,-14,6,24,5,1593,3205
2020-05-03,Marche,400,43,443,2755,3198,-7,21,2194,927,6319,64412,42281,IT,IT_57,1,-5,17,11,1578,3198
2020-05-04,Marche,389,44,433,2773,3206,8,44,2225,932,6363,65398,42838,IT,IT_57,-11,18,31,5,986,3206
2020-05-05,Marche,387,42,429,2790,3219,13,29,2237,936,6392,67256,44045,IT,IT_57,-2,17,12,4,1858,3219
2020-05-06,Marche,353,42,395,2841,3236,17,29,2242,943,6421,69037,45026,IT,IT_57,-34,51,5,7,1781,3236
2020-05-07,Marche,328,41,369,2878,3247,11,31,2257,948,6452,71017,46258,IT,IT_57,-25,37,15,5,1980,3247
2020-05-08,Marche,303,38,341,2897,3238,-9,18,2278,954,6470,72504,47092,IT,IT_57,-25,19,21,6,1487,3238
2020-05-09,Marche,285,32,317,2913,3230,-8,23,2305,958,6493,73965,47827,IT,IT_57,-18,16,27,4,1461,3230
2020-05-10,Marche,284,30,314,2937,3251,21,40,2322,960,6533,76367,49194,IT,IT_57,-1,24,17,2,2402,3251
2020-05-11,Marche,277,28,305,2922,3227,-24,10,2352,964,6543,77830,50206,IT,IT_57,-7,-15,30,4,1463,3227
2020-05-12,Marche,230,24,254,2954,3208,-19,25,2391,969,6568,79414,51176,IT,IT_57,-47,32,39,5,1584,3208
2020-05-13,Marche,211,20,231,2782,3013,-195,20,2604,971,6588,80850,52041,IT,IT_57,-19,-172,213,2,1436,3013
2020-05-14,Marche,189,18,207,2697,2904,-109,15,2725,974,6603,82840,53030,IT,IT_57,-22,-85,121,3,1990,2904
2020-05-15,Marche,178,18,196,2599,2795,-109,16,2847,977,6619,84351,53813,IT,IT_57,-11,-98,122,3,1511,2795
2020-05-16,Marche,154,17,171,2486,2657,-138,23,3003,982,6642,87211,54804,IT,IT_57,-24,-113,156,5,2860,2657
2020-05-17,Marche,151,18,169,2396,2565,-92,25,3118,984,6667,88656,55667,IT,IT_57,-3,-90,115,2,1445,2565
2020-05-18,Marche,156,17,173,2142,2315,-250,11,3379,984,6678,89085,55988,IT,IT_57,5,-254,261,0,429,2315
2020-05-19,Marche,144,17,161,1967,2128,-187,-3,3561,986,6675,89985,56668,IT,IT_57,-12,-175,182,2,900,2128
2020-05-20,Marche,125,16,141,1833,1974,-154,2,3716,987,6677,90093,57604,IT,IT_57,-19,-134,155,1,108,1974
2020-05-21,Marche,111,16,127,1705,1832,-142,12,3867,990,6689,91885,58667,IT,IT_57,-14,-128,151,3,1792,1832
2020-05-22,Marche,101,15,116,1652,1768,-64,8,3939,990,6697,93549,59673,IT,IT_57,-10,-53,72,0,1664,1768
2020-05-23,Marche,100,15,115,1598,1713,-55,4,3995,993,6701,94657,60232,IT,IT_57,-1,-54,56,3,1108,1713
2020-05-24,Marche,101,13,114,1578,1692,-21,13,4028,994,6714,95715,60949,IT,IT_57,1,-20,33,1,1058,1692
2020-05-25,Marche,95,13,108,1554,1662,-30,2,4059,995,6716,96270,61347,IT,IT_57,-6,-24,31,1,555,1662
2020-05-26,Marche,94,13,107,1468,1575,-87,2,4147,996,6718,97285,61923,IT,IT_57,-1,-86,88,1,1015,1575
2020-05-27,Marche,90,13,103,1347,1450,-125,0,4272,996,6718,98535,62815,IT,IT_57,-4,-121,125,0,1250,1450
2020-05-28,Marche,79,13,92,1254,1346,-104,1,4376,997,6719,100110,63611,IT,IT_57,-11,-93,104,1,1575,1346
2020-05-29,Marche,69,9,78,1274,1352,6,4,4385,986,6723,101389,64361,IT,IT_57,-10,20,9,-11,1279,1352
2020-05-30,Marche,66,9,75,1272,1347,-5,4,4393,987,6727,102484,64947,IT,IT_57,-3,-2,8,1,1095,1347
2020-05-31,Marche,62,9,71,1267,1338,-9,3,4405,987,6730,103634,65617,IT,IT_57,-4,-5,12,0,1150,1338
2020-06-01,Marche,63,9,72,1255,1327,-11,0,4416,987,6730,103994,65848,IT,IT_57,1,-12,11,0,360,1327
2020-06-02,Marche,60,9,69,1257,1326,-1,4,4421,987,6734,104968,66434,IT,IT_57,-3,2,5,0,974,1326
2020-06-03,Marche,57,8,65,1245,1310,-16,1,4438,987,6735,105679,66805,IT,IT_57,-3,-12,17,0,711,1310
2020-06-04,Marche,52,5,57,1246,1303,-7,3,4447,988,6738,110077,67429,IT,IT_57,-5,1,9,1,4398,1303
2020-06-05,Marche,50,5,55,1238,1293,-10,2,4458,989,6740,111431,68197,IT,IT_57,-2,-8,11,1,1354,1293
2020-06-06,Marche,46,3,49,1146,1195,-98,2,4556,991,6742,112740,68775,IT,IT_57,-4,-92,98,2,1309,1195
2020-06-07,Marche,41,2,43,1116,1159,-36,3,4595,991,6745,113729,69376,IT,IT_57,-5,-30,39,0,989,1159
2020-06-08,Marche,41,2,43,1032,1075,-84,2,4681,991,6747,114310,69736,IT,IT_57,0,-84,86,0,581,1075
2020-06-09,Marche,32,0,32,960,992,-83,0,4763,992,6747,115510,70335,IT,IT_57,-9,-72,82,1,1200,992
2020-06-10,Marche,29,0,29,918,947,-45,3,4811,992,6750,116320,70837,IT,IT_57,-3,-42,48,0,810,947
2020-06-11,Marche,26,0,26,876,902,-45,1,4857,992,6751,117720,71531,IT,IT_57,-3,-42,46,0,1400,902
2020-06-12,Marche,22,0,22,728,750,-152,1,5009,993,6752,119045,72169,IT,IT_57,-4,-148,152,1,1325,750
2020-06-13,Marche,22,0,22,655,677,-73,2,5084,993,6754,120308,72713,IT,IT_57,0,-73,75,0,1263,677
2020-06-14,Marche,21,0,21,605,626,-51,4,5139,993,6758,121354,73298,IT,IT_57,-1,-50,55,0,1046,626
2020-06-15,Marche,18,0,18,599,617,-9,4,5152,993,6762,121620,73564,IT,IT_57,-3,-6,13,0,266,617
2020-06-16,Marche,19,0,19,582,601,-16,1,5168,994,6763,122650,74194,IT,IT_57,1,-17,16,1,1030,601
2020-06-17,Marche,21,0,21,564,585,-16,1,5185,994,6764,123770,74827,IT,IT_57,2,-18,17,0,1120,585
2020-06-18,Marche,19,0,19,558,577,-8,4,5197,994,6768,125339,75604,IT,IT_57,-2,-6,12,0,1569,577
2020-06-19,Marche,14,0,14,546,560,-17,0,5214,994,6768,126380,76228,IT,IT_57,-5,-12,17,0,1041,560
2020-06-20,Marche,13,0,13,526,539,-21,0,5235,994,6768,127450,76777,IT,IT_57,-1,-20,21,0,1070,539
2020-02-24,Molise,0,0,0,0,0,0,0,0,0,0,0,,IT,IT_67,,,,,,0
2020-02-25,Molise,0,0,0,0,0,0,0,0,0,0,0,,IT,IT_67,0,0,0,0,0,0
2020-02-26,Molise,0,0,0,0,0,0,0,0,0,0,0,,IT,IT_67,0,0,0,0,0,0
2020-02-27,Molise,0,0,0,0,0,0,0,0,0,0,0,,IT,IT_67,0,0,0,0,0,0
2020-02-28,Molise,0,0,0,0,0,0,0,0,0,0,0,,IT,IT_67,0,0,0,0,0,0
2020-02-29,Molise,0,0,0,0,0,0,0,0,0,0,0,,IT,IT_67,0,0,0,0,0,0
2020-03-01,Molise,0,0,0,0,0,0,0,0,0,0,6,,IT,IT_67,0,0,0,0,6,0
2020-03-02,Molise,0,0,0,0,0,0,0,0,0,0,13,,IT,IT_67,0,0,0,0,7,0
2020-03-03,Molise,3,0,3,0,3,3,3,0,0,3,13,,IT,IT_67,3,0,0,0,0,3
2020-03-04,Molise,3,0,3,0,3,0,0,0,0,3,19,,IT,IT_67,0,0,0,0,6,3
2020-03-05,Molise,4,0,4,3,7,4,4,0,0,7,24,,IT,IT_67,1,3,0,0,5,7
2020-03-06,Molise,3,2,5,7,12,5,5,0,0,12,104,,IT,IT_67,-1,4,0,0,80,12
2020-03-07,Molise,3,2,5,9,14,2,2,0,0,14,112,,IT,IT_67,0,2,0,0,8,14
2020-03-08,Molise,4,2,6,8,14,0,0,0,0,14,116,,IT,IT_67,1,-1,0,0,4,14
2020-03-09,Molise,4,2,6,8,14,0,0,0,0,14,212,,IT,IT_67,0,0,0,0,96,14
2020-03-10,Molise,3,3,6,9,15,1,1,0,0,15,225,,IT,IT_67,-1,1,0,0,13,15
2020-03-11,Molise,4,3,7,9,16,1,1,0,0,16,233,,IT,IT_67,1,0,0,0,8,16
2020-03-12,Molise,4,3,7,9,16,0,0,0,0,16,238,,IT,IT_67,0,0,0,0,5,16
2020-03-13,Molise,5,3,8,9,17,1,1,0,0,17,243,,IT,IT_67,1,0,0,0,5,17
2020-03-14,Molise,5,3,8,9,17,0,0,0,0,17,247,,IT,IT_67,0,0,0,0,4,17
2020-03-15,Molise,3,4,7,10,17,0,0,0,0,17,248,,IT,IT_67,-2,1,0,0,1,17
2020-03-16,Molise,3,5,8,7,15,-2,4,5,1,21,253,,IT,IT_67,0,-3,5,1,5,15
2020-03-17,Molise,7,5,12,7,19,4,4,5,1,25,301,,IT,IT_67,4,0,0,0,48,19
2020-03-18,Molise,7,6,13,8,21,2,3,6,1,28,361,,IT,IT_67,0,1,1,0,60,21
2020-03-19,Molise,19,6,25,13,38,17,18,6,2,46,426,,IT,IT_67,12,5,0,1,65,38
2020-03-20,Molise,20,6,26,13,39,1,4,6,5,50,426,,IT,IT_67,1,0,0,3,0,39
2020-03-21,Molise,21,6,27,20,47,8,11,7,7,61,449,,IT,IT_67,1,7,1,2,23,47
2020-03-22,Molise,24,7,31,21,52,5,5,7,7,66,532,,IT,IT_67,3,1,0,0,83,52
2020-03-23,Molise,25,7,32,18,50,-2,1,10,7,67,532,,IT,IT_67,1,-3,3,0,0,50
2020-03-24,Molise,27,7,34,21,55,5,6,10,8,73,572,,IT,IT_67,2,3,0,1,40,55
2020-03-25,Molise,26,7,33,20,53,-2,0,12,8,73,580,,IT,IT_67,-1,-1,2,0,8,53
2020-03-26,Molise,27,8,35,46,81,28,30,14,8,103,670,,IT,IT_67,1,26,2,0,90,81
2020-03-27,Molise,26,9,35,51,86,5,6,14,9,109,710,,IT,IT_67,-1,5,0,1,40,86
2020-03-28,Molise,26,9,35,63,98,12,14,16,9,123,807,,IT,IT_67,0,12,2,0,97,98
2020-03-29,Molise,25,9,34,66,100,2,4,18,9,127,918,,IT,IT_67,-1,3,2,0,111,100
2020-03-30,Molise,27,8,35,72,107,7,7,18,9,134,955,,IT,IT_67,2,6,0,0,37,107
2020-03-31,Molise,29,8,37,80,117,10,10,18,9,144,1049,,IT,IT_67,2,8,0,0,94,117
2020-04-01,Molise,32,8,40,91,131,14,16,19,10,160,1157,,IT,IT_67,3,11,1,1,108,131
2020-04-02,Molise,30,8,38,95,133,2,5,21,11,165,1229,,IT,IT_67,-2,4,2,1,72,133
2020-04-03,Molise,31,8,39,105,144,11,11,21,11,176,1378,,IT,IT_67,1,10,0,0,149,144
2020-04-04,Molise,31,6,37,134,171,27,30,24,11,206,1504,,IT,IT_67,0,29,3,0,126,171
2020-04-05,Molise,33,6,39,148,187,16,18,24,13,224,1504,,IT,IT_67,2,14,0,2,0,187
2020-04-06,Molise,34,5,39,148,187,0,0,24,13,224,1546,,IT,IT_67,1,0,0,0,42,187
2020-04-07,Molise,35,5,40,145,185,-2,0,26,13,224,1581,,IT,IT_67,1,-3,2,0,35,185
2020-04-08,Molise,30,4,34,147,181,-4,2,32,13,226,2002,,IT,IT_67,-5,2,6,0,421,181
2020-04-09,Molise,30,4,34,155,189,8,8,32,13,234,2069,,IT,IT_67,0,8,0,0,67,189
2020-04-10,Molise,28,4,32,161,193,4,9,37,13,243,2069,,IT,IT_67,-2,6,5,0,0,193
2020-04-11,Molise,28,4,32,161,193,0,3,39,14,246,2201,,IT,IT_67,0,0,2,1,132,193
2020-04-12,Molise,27,4,31,171,202,9,11,40,15,257,2471,,IT,IT_67,-1,10,1,1,270,202
2020-04-13,Molise,28,4,32,170,202,0,0,40,15,257,2522,,IT,IT_67,1,-1,0,0,51,202
2020-04-14,Molise,26,4,30,170,200,-2,0,42,15,257,2522,,IT,IT_67,-2,0,2,0,0,200
2020-04-15,Molise,27,4,31,175,206,6,6,42,15,263,2855,,IT,IT_67,1,5,0,0,333,206
2020-04-16,Molise,25,4,29,174,203,-3,0,44,16,263,2967,,IT,IT_67,-2,-1,2,1,112,203
2020-04-17,Molise,26,4,30,178,208,5,6,45,16,269,3082,,IT,IT_67,1,4,1,0,115,208
2020-04-18,Molise,27,4,31,178,209,1,0,44,16,269,3082,,IT,IT_67,1,0,-1,0,0,209
2020-04-19,Molise,27,4,31,184,215,6,10,47,17,279,3584,3482,IT,IT_67,0,6,3,1,502,215
2020-04-20,Molise,27,2,29,184,213,-2,2,50,18,281,3783,3683,IT,IT_67,0,0,3,1,199,213
2020-04-21,Molise,27,2,29,184,213,0,1,51,18,282,4124,4015,IT,IT_67,0,0,1,0,341,213
2020-04-22,Molise,21,2,23,182,205,-8,2,60,19,284,4425,4252,IT,IT_67,-6,-2,9,1,301,205
2020-04-23,Molise,19,1,20,178,198,-7,0,66,20,284,4564,4478,IT,IT_67,-2,-4,6,1,139,198
2020-04-24,Molise,19,1,20,180,200,2,3,67,20,287,4805,4718,IT,IT_67,0,2,1,0,241,200
2020-04-25,Molise,19,1,20,178,198,-2,5,73,21,292,5191,5089,IT,IT_67,0,-2,6,1,386,198
2020-04-26,Molise,20,1,21,179,200,2,4,75,21,296,5567,5334,IT,IT_67,1,1,2,0,376,200
2020-04-27,Molise,20,1,21,179,200,0,0,75,21,296,5656,5423,IT,IT_67,0,0,0,0,89,200
2020-04-28,Molise,18,1,19,176,195,-5,1,81,21,297,5776,5538,IT,IT_67,-2,-3,6,0,120,195
2020-04-29,Molise,17,1,18,175,193,-2,0,83,21,297,5910,5857,IT,IT_67,-1,-1,2,0,134,193
2020-04-30,Molise,17,1,18,172,190,-3,1,87,21,298,6446,6228,IT,IT_67,0,-3,4,0,536,190
2020-05-01,Molise,17,1,18,172,190,0,2,89,21,300,6463,6450,IT,IT_67,0,0,2,0,17,190
2020-05-02,Molise,9,1,10,172,182,-8,1,98,21,301,7075,6808,IT,IT_67,-8,0,9,0,612,182
2020-05-03,Molise,8,1,9,172,181,-1,0,98,22,301,7075,6808,IT,IT_67,-1,0,0,1,0,181
2020-05-04,Molise,9,1,10,168,178,-3,0,101,22,301,7328,7057,IT,IT_67,1,-4,3,0,253,178
2020-05-05,Molise,9,1,10,167,177,-1,0,102,22,301,7528,7252,IT,IT_67,0,-1,1,0,200,177
2020-05-06,Molise,9,0,9,170,179,2,3,103,22,304,7896,7604,IT,IT_67,0,3,1,0,368,179
2020-05-07,Molise,8,0,8,162,170,-9,1,113,22,305,8237,7912,IT,IT_67,-1,-8,10,0,341,170
2020-05-08,Molise,6,0,6,178,184,14,22,121,22,327,8502,8177,IT,IT_67,-2,16,8,0,265,184
2020-05-09,Molise,8,0,8,197,205,21,20,120,22,347,8691,8375,IT,IT_67,2,19,-1,0,189,205
2020-05-10,Molise,9,0,9,209,218,13,23,130,22,370,9164,9008,IT,IT_67,1,12,10,0,473,218
2020-05-11,Molise,11,0,11,218,229,11,13,132,22,383,9390,9247,IT,IT_67,2,9,2,0,226,229
2020-05-12,Molise,13,1,14,212,226,-3,3,138,22,386,9981,9582,IT,IT_67,2,-6,6,0,591,226
2020-05-13,Molise,9,1,10,221,231,5,15,148,22,401,10062,9773,IT,IT_67,-4,9,10,0,81,231
2020-05-14,Molise,10,1,11,218,229,-2,2,152,22,403,10227,10052,IT,IT_67,1,-3,4,0,165,229
2020-05-15,Molise,8,2,10,217,227,-2,4,158,22,407,10468,10281,IT,IT_67,-2,-1,6,0,241,227
2020-05-16,Molise,8,2,10,205,215,-12,3,173,22,410,10859,10666,IT,IT_67,0,-12,15,0,391,215
2020-05-17,Molise,11,2,13,203,216,1,1,173,22,411,11085,10892,IT,IT_67,3,-2,0,0,226,216
2020-05-18,Molise,9,2,11,206,217,1,11,183,22,422,11514,11285,IT,IT_67,-2,3,10,0,429,217
2020-05-19,Molise,9,2,11,201,212,-5,0,188,22,422,11592,11354,IT,IT_67,0,-5,5,0,78,212
2020-05-20,Molise,7,2,9,189,198,-14,0,202,22,422,12158,11727,IT,IT_67,-2,-12,14,0,566,198
2020-05-21,Molise,8,2,10,184,194,-4,1,207,22,423,12253,11819,IT,IT_67,1,-5,5,0,95,194
2020-05-22,Molise,8,2,10,174,184,-10,3,220,22,426,12616,12173,IT,IT_67,0,-10,13,0,363,184
2020-05-23,Molise,8,2,10,179,189,5,5,220,22,431,13017,12552,IT,IT_67,0,5,0,0,401,189
2020-05-24,Molise,6,2,8,175,183,-6,1,227,22,432,13226,12751,IT,IT_67,-2,-4,7,0,209,183
2020-05-25,Molise,5,2,7,170,177,-6,0,233,22,432,13315,12819,IT,IT_67,-1,-5,6,0,89,177
2020-05-26,Molise,5,2,7,167,174,-3,0,236,22,432,13452,12940,IT,IT_67,0,-3,3,0,137,174
2020-05-27,Molise,3,2,5,161,166,-8,2,246,22,434,13629,13087,IT,IT_67,-2,-6,10,0,177,166
2020-05-28,Molise,3,2,5,158,163,-3,1,250,22,435,13847,13266,IT,IT_67,0,-3,4,0,218,163
2020-05-29,Molise,3,2,5,157,162,-1,1,252,22,436,14109,13506,IT,IT_67,0,-1,2,0,262,162
2020-05-30,Molise,3,2,5,151,156,-6,0,258,22,436,14371,13734,IT,IT_67,0,-6,6,0,262,156
2020-05-31,Molise,2,2,4,141,145,-11,0,269,22,436,14631,13985,IT,IT_67,-1,-10,11,0,260,145
2020-06-01,Molise,2,2,4,131,135,-10,0,279,22,436,14819,14147,IT,IT_67,0,-10,10,0,188,135
2020-06-02,Molise,3,2,5,128,133,-2,0,281,22,436,14951,14278,IT,IT_67,1,-3,2,0,132,133
2020-06-03,Molise,1,2,3,124,127,-6,0,287,22,436,15123,14439,IT,IT_67,-2,-4,6,0,172,127
2020-06-04,Molise,0,2,2,123,125,-2,0,288,23,436,15261,15261,IT,IT_67,-1,-1,1,1,138,125
2020-06-05,Molise,0,2,2,120,122,-3,0,291,23,436,15568,15568,IT,IT_67,0,-3,3,0,307,122
2020-06-06,Molise,0,2,2,119,121,-1,0,292,23,436,16522,15809,IT,IT_67,0,-1,1,0,954,121
2020-06-07,Molise,0,2,2,118,120,-1,0,293,23,436,16791,16056,IT,IT_67,0,-1,1,0,269,120
2020-06-08,Molise,0,2,2,117,119,-1,0,294,23,436,16966,16224,IT,IT_67,0,-1,1,0,175,119
2020-06-09,Molise,0,2,2,118,120,1,2,295,23,438,17162,16411,IT,IT_67,0,1,1,0,196,120
2020-06-10,Molise,0,2,2,118,120,0,1,296,23,439,17375,16611,IT,IT_67,0,0,1,0,213,120
2020-06-11,Molise,1,1,2,114,116,-4,0,300,23,439,17710,16916,IT,IT_67,1,-4,4,0,335,116
2020-06-12,Molise,1,1,2,112,114,-2,0,302,23,439,18112,17279,IT,IT_67,0,-2,2,0,402,114
2020-06-13,Molise,0,0,0,97,97,-17,0,319,23,439,18495,17630,IT,IT_67,-1,-15,17,0,383,97
2020-06-14,Molise,0,0,0,74,74,-23,0,342,23,439,18845,17947,IT,IT_67,0,-23,23,0,350,74
2020-06-15,Molise,0,0,0,70,70,-4,0,346,23,439,19125,18214,IT,IT_67,0,-4,4,0,280,70
2020-06-16,Molise,1,0,1,64,65,-5,0,351,23,439,19368,18444,IT,IT_67,1,-6,5,0,243,65
2020-06-17,Molise,1,0,1,61,62,-3,1,355,23,440,19635,18684,IT,IT_67,0,-3,4,0,267,62
2020-06-18,Molise,1,0,1,59,60,-2,0,357,23,440,19984,19006,IT,IT_67,0,-2,2,0,349,60
2020-06-19,Molise,2,0,2,51,53,-7,1,365,23,441,20203,19208,IT,IT_67,1,-8,8,0,219,53
2020-06-20,Molise,2,0,2,51,53,0,0,365,23,441,20441,19445,IT,IT_67,0,0,0,0,238,53
2020-02-24,Piemonte,2,0,2,1,3,0,3,0,0,3,141,,IT,IT_21,,,,,,0
2020-02-25,Piemonte,2,0,2,1,3,0,0,0,0,3,141,,IT,IT_21,0,0,0,0,0,0
2020-02-26,Piemonte,2,0,2,1,3,0,0,0,0,3,156,,IT,IT_21,0,0,0,0,15,0
2020-02-27,Piemonte,2,0,2,0,2,-1,-1,0,0,2,156,,IT,IT_21,0,-1,0,0,0,-1
2020-02-28,Piemonte,7,0,7,4,11,9,9,0,0,11,227,,IT,IT_21,5,4,0,0,71,8
2020-02-29,Piemonte,7,0,7,4,11,0,0,0,0,11,308,,IT,IT_21,0,0,0,0,81,8
2020-03-01,Piemonte,11,2,13,36,49,38,38,0,0,49,362,,IT,IT_21,4,32,0,0,54,46
2020-03-02,Piemonte,12,2,14,37,51,2,2,0,0,51,434,,IT,IT_21,1,1,0,0,72,48
2020-03-03,Piemonte,13,3,16,40,56,5,5,0,0,56,458,,IT,IT_21,1,3,0,0,24,53
2020-03-04,Piemonte,26,13,39,43,82,26,26,0,0,82,543,,IT,IT_21,13,3,0,0,85,79
2020-03-05,Piemonte,43,17,60,46,106,24,26,0,2,108,543,,IT,IT_21,17,3,0,2,0,103
2020-03-06,Piemonte,57,30,87,52,139,33,35,0,4,143,793,,IT,IT_21,14,6,0,2,250,136
2020-03-07,Piemonte,110,38,148,54,202,63,64,0,5,207,1046,,IT,IT_21,53,2,0,1,253,199
2020-03-08,Piemonte,245,45,290,65,355,153,153,0,5,360,1636,,IT,IT_21,135,11,0,0,590,352
2020-03-09,Piemonte,222,50,272,65,337,-18,-10,0,13,350,1681,,IT,IT_21,-23,0,0,8,45,334
2020-03-10,Piemonte,306,66,372,64,436,99,103,0,17,453,2374,,IT,IT_21,84,-1,0,4,693,433
2020-03-11,Piemonte,319,75,394,86,480,44,48,0,21,501,2431,,IT,IT_21,13,22,0,4,57,477
2020-03-12,Piemonte,368,97,465,89,554,74,79,0,26,580,2879,,IT,IT_21,49,3,0,5,448,551
2020-03-13,Piemonte,556,135,691,103,794,240,260,0,46,840,3105,,IT,IT_21,188,14,0,20,226,791
2020-03-14,Piemonte,538,150,688,126,814,20,33,0,59,873,3680,,IT,IT_21,-18,23,0,13,575,811
2020-03-15,Piemonte,726,171,897,133,1030,216,238,0,81,1111,4375,,IT,IT_21,188,7,0,22,695,1027
2020-03-16,Piemonte,1045,186,1231,174,1405,375,405,0,111,1516,5588,,IT,IT_21,319,41,0,30,1213,1402
2020-03-17,Piemonte,1378,206,1584,180,1764,359,381,0,133,1897,6543,,IT,IT_21,333,6,0,22,955,1761
2020-03-18,Piemonte,1780,227,2007,180,2187,423,444,0,154,2341,7516,,IT,IT_21,402,0,0,21,973,2184
2020-03-19,Piemonte,2279,257,2536,218,2754,567,591,3,175,2932,8853,,IT,IT_21,499,38,3,21,1337,2751
2020-03-20,Piemonte,1541,280,1821,1423,3244,490,529,8,209,3461,9975,,IT,IT_21,-738,1205,5,34,1122,3241
2020-03-21,Piemonte,1976,301,2277,1229,3506,262,291,8,238,3752,10701,,IT,IT_21,435,-194,0,29,726,3503
2020-03-22,Piemonte,2118,308,2426,1701,4127,621,668,10,283,4420,12701,,IT,IT_21,142,472,2,45,2000,4124
2020-03-23,Piemonte,2194,343,2537,1992,4529,402,441,17,315,4861,13560,,IT,IT_21,76,291,7,32,859,4526
2020-03-24,Piemonte,2404,360,2764,2360,5124,595,654,17,374,5515,15469,,IT,IT_21,210,368,0,59,1909,5121
2020-03-25,Piemonte,2544,381,2925,2631,5556,432,509,19,449,6024,16655,,IT,IT_21,140,271,2,75,1186,5553
2020-03-26,Piemonte,2633,408,3041,2909,5950,394,510,135,449,6534,18054,,IT,IT_21,89,278,116,0,1399,5947
2020-03-27,Piemonte,2852,431,3283,3064,6347,397,558,176,569,7092,19705,,IT,IT_21,219,155,41,120,1651,6344
2020-03-28,Piemonte,3094,439,3533,3318,6851,504,579,203,617,7671,21511,,IT,IT_21,242,254,27,48,1806,6848
2020-03-29,Piemonte,2985,443,3428,3840,7268,417,535,254,684,8206,24058,,IT,IT_21,-109,522,51,67,2547,7265
2020-03-30,Piemonte,2985,452,3437,4218,7655,387,506,308,749,8712,25478,,IT,IT_21,0,378,54,65,1420,7652
2020-03-31,Piemonte,3174,452,3626,4456,8082,427,589,365,854,9301,27658,,IT,IT_21,189,238,57,105,2180,8079
2020-04-01,Piemonte,3146,453,3599,4871,8470,388,494,439,886,9795,30060,,IT,IT_21,-28,415,74,32,2402,8467
2020-04-02,Piemonte,3341,453,3794,5005,8799,329,558,571,983,10353,32100,,IT,IT_21,195,134,132,97,2040,8796
2020-04-03,Piemonte,3300,452,3752,5378,9130,331,543,723,1043,10896,34281,,IT,IT_21,-41,373,152,60,2181,9127
2020-04-04,Piemonte,3441,450,3891,5802,9693,563,813,888,1128,11709,37181,,IT,IT_21,141,424,165,85,2900,9690
2020-04-05,Piemonte,3472,444,3916,6261,10177,484,653,1017,1168,12362,38539,,IT,IT_21,31,459,129,40,1358,10174
2020-04-06,Piemonte,3484,438,3922,6623,10545,368,562,1128,1251,12924,41123,,IT,IT_21,12,362,111,83,2584,10542
2020-04-07,Piemonte,3553,432,3985,6719,10704,159,419,1320,1319,13343,44121,,IT,IT_21,69,96,192,68,2998,10701
2020-04-08,Piemonte,3493,423,3916,7073,10989,285,540,1516,1378,13883,48495,,IT,IT_21,-60,354,196,59,4374,10986
2020-04-09,Piemonte,3514,412,3926,7410,11336,347,639,1732,1454,14522,52807,,IT,IT_21,21,337,216,76,4312,11333
2020-04-10,Piemonte,3497,394,3891,7685,11576,240,490,1904,1532,15012,57457,,IT,IT_21,-17,275,172,78,4650,11573
2020-04-11,Piemonte,3435,384,3819,8351,12170,594,996,2205,1633,16008,62577,,IT,IT_21,-62,666,301,101,5120,12167
2020-04-12,Piemonte,3429,381,3810,8695,12505,335,652,2426,1729,16660,66555,,IT,IT_21,-6,344,221,96,3978,12502
2020-04-13,Piemonte,3344,379,3723,9042,12765,260,474,2543,1826,17134,69170,,IT,IT_21,-85,347,117,97,2615,12762
2020-04-14,Piemonte,3395,367,3762,9293,13055,290,556,2708,1927,17690,71678,,IT,IT_21,51,251,165,101,2508,13052
2020-04-15,Piemonte,3338,366,3704,9491,13195,140,539,3019,2015,18229,75664,,IT,IT_21,-57,198,311,88,3986,13192
2020-04-16,Piemonte,3418,346,3764,10019,13783,588,879,3231,2094,19108,80708,,IT,IT_21,80,528,212,79,5044,13780
2020-04-17,Piemonte,3266,333,3599,10399,13998,215,695,3634,2171,19803,86714,,IT,IT_21,-152,380,403,77,6006,13995
2020-04-18,Piemonte,3271,323,3594,10629,14223,225,661,3989,2252,20464,91844,,IT,IT_21,5,230,355,81,5130,14220
2020-04-19,Piemonte,3201,305,3506,10964,14470,247,593,4256,2331,21057,96569,71644,IT,IT_21,-70,335,267,79,4725,14467
2020-04-20,Piemonte,3299,301,3600,10957,14557,87,292,4383,2409,21349,99669,73192,IT,IT_21,98,-7,127,78,3100,14554
2020-04-21,Piemonte,3116,293,3409,11402,14811,254,606,4659,2485,21955,105434,76406,IT,IT_21,-183,445,276,76,5765,14808
2020-04-22,Piemonte,3213,273,3486,11636,15122,311,784,5058,2559,22739,111513,81176,IT,IT_21,97,234,399,74,6079,15119
2020-04-23,Piemonte,3039,261,3300,11852,15152,30,401,5358,2630,23140,117970,84648,IT,IT_21,-174,216,300,71,6457,15149
2020-04-24,Piemonte,2918,257,3175,12216,15391,239,682,5732,2699,23822,125300,89392,IT,IT_21,-121,364,374,69,7330,15388
2020-04-25,Piemonte,2937,238,3175,12327,15502,111,604,6157,2767,24426,131107,93325,IT,IT_21,19,111,425,68,5807,15499
2020-04-26,Piemonte,2866,214,3080,12439,15519,17,394,6478,2823,24820,135142,96977,IT,IT_21,-71,112,321,56,4035,15516
2020-04-27,Piemonte,2830,214,3044,12464,15508,-11,278,6712,2878,25098,139348,99144,IT,IT_21,-36,25,234,55,4206,15505
2020-04-28,Piemonte,2701,202,2903,12603,15506,-2,352,7008,2936,25450,144531,102514,IT,IT_21,-129,139,296,58,5183,15503
2020-04-29,Piemonte,2637,202,2839,12682,15521,15,411,7337,3003,25861,151266,106179,IT,IT_21,-64,79,329,67,6735,15518
2020-04-30,Piemonte,2621,199,2820,12673,15493,-28,428,7730,3066,26289,156534,110157,IT,IT_21,-16,-9,393,63,5268,15490
2020-05-01,Piemonte,2503,181,2684,12878,15562,69,395,8025,3097,26684,162568,114786,IT,IT_21,-118,205,295,31,6034,15559
2020-05-02,Piemonte,2550,178,2728,12991,15719,157,495,8334,3126,27179,168479,118814,IT,IT_21,47,113,309,29,5911,15716
2020-05-03,Piemonte,2496,169,2665,12973,15638,-81,251,8640,3152,27430,172208,121176,IT,IT_21,-54,-18,306,26,3729,15635
2020-05-04,Piemonte,2391,161,2552,13010,15562,-76,192,8874,3186,27622,176078,123801,IT,IT_21,-105,37,234,34,3870,15559
2020-05-05,Piemonte,2307,155,2462,12861,15323,-239,152,9235,3216,27774,181316,126685,IT,IT_21,-84,-149,361,30,5238,15320
2020-05-06,Piemonte,2147,150,2297,12561,14858,-465,165,9834,3247,27939,188057,131269,IT,IT_21,-160,-300,599,31,6741,14855
2020-05-07,Piemonte,2147,150,2297,12172,14469,-389,196,10384,3282,28135,194584,134567,IT,IT_21,0,-389,550,35,6527,14466
2020-05-08,Piemonte,2013,140,2153,11954,14107,-362,233,10956,3305,28368,201183,138830,IT,IT_21,-134,-218,572,23,6599,14104
2020-05-09,Piemonte,2010,143,2153,11781,13934,-173,181,11284,3331,28549,205800,141515,IT,IT_21,-3,-173,328,26,4617,13931
2020-05-10,Piemonte,2024,137,2161,11489,13650,-284,116,11648,3367,28665,210370,145131,IT,IT_21,14,-292,364,36,4570,13647
2020-05-11,Piemonte,2021,135,2156,11182,13338,-312,111,12038,3400,28776,213783,147318,IT,IT_21,-3,-307,390,33,3413,13335
2020-05-12,Piemonte,1900,136,2036,11148,13184,-154,113,12277,3428,28889,218071,149386,IT,IT_21,-121,-34,239,28,4288,13181
2020-05-13,Piemonte,1858,122,1980,10511,12491,-693,169,13107,3460,29058,224788,154504,IT,IT_21,-42,-637,830,32,6717,12488
2020-05-14,Piemonte,1775,116,1891,10000,11891,-600,151,13825,3493,29209,232682,158112,IT,IT_21,-83,-511,718,33,7894,11888
2020-05-15,Piemonte,1593,108,1701,9412,11113,-778,137,14676,3557,29346,239507,161854,IT,IT_21,-182,-588,851,64,6825,11110
2020-05-16,Piemonte,1562,100,1662,9040,10702,-411,137,15187,3594,29483,245075,165849,IT,IT_21,-31,-372,511,37,5568,10699
2020-05-17,Piemonte,1620,101,1721,8518,10239,-463,64,15696,3612,29547,249371,168295,IT,IT_21,58,-522,509,18,4296,10236
2020-05-18,Piemonte,1589,99,1688,8186,9874,-365,72,16113,3632,29619,253479,170556,IT,IT_21,-31,-332,417,20,4108,9871
2020-05-19,Piemonte,1579,96,1675,7960,9635,-239,108,16413,3679,29727,258489,173201,IT,IT_21,-10,-226,300,47,5010,9632
2020-05-20,Piemonte,1513,96,1609,7542,9151,-484,158,17016,3718,29885,264624,177088,IT,IT_21,-66,-418,603,39,6135,9148
2020-05-21,Piemonte,1479,83,1562,7148,8710,-441,105,17538,3742,29990,271286,179877,IT,IT_21,-34,-394,522,24,6662,8707
2020-05-22,Piemonte,1414,79,1493,6959,8452,-258,87,17868,3757,30077,276633,182970,IT,IT_21,-65,-189,330,15,5347,8449
2020-05-23,Piemonte,1291,76,1367,6658,8025,-427,60,18341,3771,30137,281897,185963,IT,IT_21,-123,-301,473,14,5264,8022
2020-05-24,Piemonte,1283,75,1358,6345,7703,-322,43,18694,3783,30180,285160,188716,IT,IT_21,-8,-313,353,12,3263,7700
2020-05-25,Piemonte,1227,72,1299,6197,7496,-207,48,18934,3798,30228,288018,191129,IT,IT_21,-56,-148,240,15,2858,7493
2020-05-26,Piemonte,1162,70,1232,5709,6941,-555,86,19561,3812,30314,293473,193954,IT,IT_21,-65,-488,627,14,5455,6938
2020-05-27,Piemonte,1118,68,1186,5278,6464,-477,73,20095,3828,30387,298571,196790,IT,IT_21,-44,-431,534,16,5098,6461
2020-05-28,Piemonte,1058,64,1122,4950,6072,-392,58,20535,3838,30445,304358,199286,IT,IT_21,-60,-328,440,10,5787,6069
2020-05-29,Piemonte,1029,61,1090,4568,5658,-414,56,20992,3851,30501,309497,202227,IT,IT_21,-29,-382,457,13,5139,5655
2020-05-30,Piemonte,988,60,1048,4242,5290,-368,82,21435,3858,30583,315828,205102,IT,IT_21,-41,-326,443,7,6331,5287
2020-05-31,Piemonte,973,58,1031,4130,5161,-129,54,21609,3867,30637,319133,207714,IT,IT_21,-15,-112,174,9,3305,5158
2020-06-01,Piemonte,904,54,958,4104,5062,-99,21,21720,3876,30658,321476,209006,IT,IT_21,-69,-26,111,9,2343,5059
2020-06-02,Piemonte,849,46,895,3933,4828,-234,57,22003,3884,30715,325097,211174,IT,IT_21,-55,-171,283,8,3621,4825
2020-06-03,Piemonte,841,44,885,3801,4686,-142,19,22150,3898,30734,327206,212012,IT,IT_21,-8,-132,147,14,2109,4683
2020-06-04,Piemonte,808,43,851,3705,4556,-130,24,22292,3910,30758,331241,214551,IT,IT_21,-33,-96,142,12,4035,4553
2020-06-05,Piemonte,743,40,783,3586,4369,-187,49,22511,3927,30807,335814,217032,IT,IT_21,-65,-119,219,17,4573,4366
2020-06-06,Piemonte,684,37,721,3446,4167,-202,38,22744,3934,30845,340176,219444,IT,IT_21,-59,-140,233,7,4362,4164
2020-06-07,Piemonte,659,38,697,3265,3962,-205,10,22952,3941,30855,343354,221367,IT,IT_21,-25,-181,208,7,3178,3959
2020-06-08,Piemonte,633,36,669,3197,3866,-96,14,23049,3954,30869,344924,222000,IT,IT_21,-26,-68,97,13,1570,3863
2020-06-09,Piemonte,599,39,638,3033,3671,-195,21,23258,3961,30890,348770,224293,IT,IT_21,-34,-164,209,7,3846,3668
2020-06-10,Piemonte,564,35,599,2773,3372,-299,26,23568,3976,30916,353737,226874,IT,IT_21,-35,-260,310,15,4967,3369
2020-06-11,Piemonte,544,33,577,2606,3183,-189,42,23787,3988,30958,357957,229096,IT,IT_21,-20,-167,219,12,4220,3180
2020-06-12,Piemonte,527,30,557,2340,2897,-286,31,24096,3996,30989,361164,230888,IT,IT_21,-17,-266,309,8,3207,2894
2020-06-13,Piemonte,510,27,537,2283,2820,-77,40,24203,4006,31029,365223,232980,IT,IT_21,-17,-57,107,10,4059,2817
2020-06-14,Piemonte,517,26,543,2105,2648,-172,30,24399,4012,31059,368065,234561,IT,IT_21,7,-178,196,6,2842,2645
2020-06-15,Piemonte,517,28,545,2059,2604,-44,2,24445,4012,31061,369294,234980,IT,IT_21,0,-46,46,0,1229,2601
2020-06-16,Piemonte,472,28,500,1950,2450,-154,29,24622,4018,31090,372948,236721,IT,IT_21,-45,-109,177,6,3654,2447
2020-06-17,Piemonte,448,25,473,1912,2385,-65,41,24720,4026,31131,377165,238650,IT,IT_21,-24,-38,98,8,4217,2382
2020-06-18,Piemonte,397,25,422,1868,2290,-95,31,24840,4032,31162,380395,241279,IT,IT_21,-51,-44,120,6,3230,2287
2020-06-19,Piemonte,363,22,385,1793,2178,-112,26,24971,4039,31188,384705,243025,IT,IT_21,-34,-75,131,7,4310,2175
2020-06-20,Piemonte,358,17,375,1713,2088,-90,27,25082,4045,31215,387713,244951,IT,IT_21,-5,-80,111,6,3008,2085
2020-02-24,Puglia,0,0,0,0,0,0,0,0,0,0,0,,IT,IT_75,,,,,,0
2020-02-25,Puglia,0,0,0,0,0,0,0,0,0,0,0,,IT,IT_75,0,0,0,0,0,0
2020-02-26,Puglia,0,0,0,0,0,0,0,0,0,0,0,,IT,IT_75,0,0,0,0,0,0
2020-02-27,Puglia,1,0,1,0,1,1,1,0,0,1,0,,IT,IT_75,1,0,0,0,0,1
2020-02-28,Puglia,1,0,1,2,3,2,2,0,0,3,242,,IT,IT_75,0,2,0,0,242,3
2020-02-29,Puglia,1,0,1,2,3,0,0,0,0,3,252,,IT,IT_75,0,0,0,0,10,3
2020-03-01,Puglia,1,0,1,2,3,0,0,0,0,3,262,,IT,IT_75,0,0,0,0,10,3
2020-03-02,Puglia,2,0,2,2,4,1,1,0,0,4,278,,IT,IT_75,1,0,0,0,16,4
2020-03-03,Puglia,2,0,2,4,6,2,2,0,0,6,298,,IT,IT_75,0,2,0,0,20,6
2020-03-04,Puglia,4,0,4,3,7,1,3,1,1,9,322,,IT,IT_75,2,-1,1,1,24,7
2020-03-05,Puglia,5,1,6,6,12,5,5,1,1,14,359,,IT,IT_75,1,3,0,0,37,12
2020-03-06,Puglia,5,1,6,9,15,3,3,1,1,17,395,,IT,IT_75,0,3,0,0,36,15
2020-03-07,Puglia,9,2,11,12,23,8,9,1,2,26,395,,IT,IT_75,4,3,0,1,0,23
2020-03-08,Puglia,17,3,20,16,36,13,14,1,3,40,627,,IT,IT_75,8,4,0,1,232,36
2020-03-09,Puglia,20,6,26,20,46,10,10,1,3,50,685,,IT,IT_75,3,4,0,0,58,46
2020-03-10,Puglia,28,6,34,21,55,9,9,1,3,59,747,,IT,IT_75,8,1,0,0,62,55
2020-03-11,Puglia,38,4,42,29,71,16,18,1,5,77,909,,IT,IT_75,10,8,0,2,162,71
2020-03-12,Puglia,58,2,60,38,98,27,27,1,5,104,1269,,IT,IT_75,20,9,0,0,360,98
2020-03-13,Puglia,77,2,79,42,121,23,25,3,5,129,1449,,IT,IT_75,19,4,2,0,180,121
2020-03-14,Puglia,91,6,97,59,156,35,37,2,8,166,1681,,IT,IT_75,14,17,-1,3,232,156
2020-03-15,Puglia,116,6,122,90,212,56,64,2,16,230,2017,,IT,IT_75,25,31,0,8,336,212
2020-03-16,Puglia,116,6,122,90,212,0,0,2,16,230,2017,,IT,IT_75,0,0,0,0,0,212
2020-03-17,Puglia,155,14,169,151,320,108,110,2,18,340,3077,,IT,IT_75,39,61,0,2,1060,320
2020-03-18,Puglia,156,30,186,176,362,42,43,2,19,383,3433,,IT,IT_75,1,25,0,1,356,362
2020-03-19,Puglia,173,31,204,245,449,87,95,4,25,478,4046,,IT,IT_75,17,69,2,6,613,449
2020-03-20,Puglia,191,31,222,329,551,102,103,4,26,581,4789,,IT,IT_75,18,84,0,1,743,551
2020-03-21,Puglia,209,33,242,400,642,91,94,4,29,675,5617,,IT,IT_75,18,71,0,3,828,642
2020-03-22,Puglia,252,37,289,459,748,106,111,7,31,786,6160,,IT,IT_75,43,59,3,2,543,748
2020-03-23,Puglia,285,45,330,532,862,114,120,7,37,906,6761,,IT,IT_75,33,73,0,6,601,862
2020-03-24,Puglia,317,57,374,566,940,78,99,21,44,1005,7345,,IT,IT_75,32,34,14,7,584,940
2020-03-25,Puglia,349,64,413,610,1023,83,88,22,48,1093,8223,,IT,IT_75,32,44,1,4,878,1023
2020-03-26,Puglia,480,76,556,539,1095,72,89,22,65,1182,9191,,IT,IT_75,131,-71,0,17,968,1095
2020-03-27,Puglia,530,82,612,624,1236,141,152,29,69,1334,10233,,IT,IT_75,50,85,7,4,1042,1236
2020-03-28,Puglia,563,98,661,697,1358,122,124,29,71,1458,11500,,IT,IT_75,33,73,0,2,1267,1358
2020-03-29,Puglia,559,99,658,774,1432,74,91,31,86,1549,12361,,IT,IT_75,-4,77,2,15,861,1432
2020-03-30,Puglia,590,106,696,889,1585,153,163,36,91,1712,13117,,IT,IT_75,31,115,5,5,756,1585
2020-03-31,Puglia,609,105,714,940,1654,69,91,39,110,1803,14073,,IT,IT_75,19,51,3,19,956,1654
2020-04-01,Puglia,637,107,744,1012,1756,102,143,61,129,1946,15209,,IT,IT_75,28,72,22,19,1136,1756
2020-04-02,Puglia,645,118,763,1101,1864,108,131,69,144,2077,16554,,IT,IT_75,8,89,8,15,1345,1864
2020-04-03,Puglia,648,123,771,1178,1949,85,105,69,164,2182,17924,,IT,IT_75,3,77,0,20,1370,1949
2020-04-04,Puglia,627,153,780,1193,1973,24,58,94,173,2240,18977,,IT,IT_75,-21,15,25,9,1053,1973
2020-04-05,Puglia,574,159,733,1289,2022,49,77,113,182,2317,20080,,IT,IT_75,-53,96,19,9,1103,2022
2020-04-06,Puglia,625,97,722,1393,2115,93,127,134,195,2444,22059,,IT,IT_75,51,104,21,13,1979,2115
2020-04-07,Puglia,615,93,708,1429,2137,22,70,168,209,2514,23149,,IT,IT_75,-10,36,34,14,1090,2137
2020-04-08,Puglia,639,90,729,1509,2238,101,120,177,219,2634,24493,,IT,IT_75,24,80,9,10,1344,2238
2020-04-09,Puglia,630,86,716,1585,2301,63,82,190,225,2716,26088,,IT,IT_75,-9,76,13,6,1595,2301
2020-04-10,Puglia,631,80,711,1625,2336,35,93,235,238,2809,27812,,IT,IT_75,1,40,45,13,1724,2336
2020-04-11,Puglia,627,73,700,1702,2402,66,95,249,253,2904,29463,,IT,IT_75,-4,77,14,15,1651,2402
2020-04-12,Puglia,609,71,680,1772,2452,50,85,277,260,2989,30973,,IT,IT_75,-18,70,28,7,1510,2452
2020-04-13,Puglia,600,71,671,1841,2512,60,76,286,267,3065,31922,,IT,IT_75,-9,69,9,7,949,2512
2020-04-14,Puglia,611,62,673,1879,2552,40,53,288,278,3118,33071,,IT,IT_75,11,38,2,11,1149,2552
2020-04-15,Puglia,592,73,665,1908,2573,21,66,323,288,3184,34518,,IT,IT_75,-19,29,35,10,1447,2573
2020-04-16,Puglia,603,58,661,1964,2625,52,74,334,299,3258,36158,,IT,IT_75,11,56,11,11,1640,2625
2020-04-17,Puglia,590,62,652,2004,2656,31,69,364,307,3327,38278,,IT,IT_75,-13,40,30,8,2120,2656
2020-04-18,Puglia,594,60,654,2040,2694,38,82,401,314,3409,40423,,IT,IT_75,4,36,37,7,2145,2694
2020-04-19,Puglia,590,60,650,2136,2786,92,120,427,316,3529,42598,41580,IT,IT_75,-4,96,26,2,2175,2786
2020-04-20,Puglia,584,66,650,2160,2810,24,38,431,326,3567,44189,43119,IT,IT_75,-6,24,4,10,1591,2810
2020-04-21,Puglia,569,65,634,2178,2812,2,55,459,351,3622,45984,44760,IT,IT_75,-15,18,28,25,1795,2812
2020-04-22,Puglia,564,60,624,2250,2874,62,108,494,362,3730,48342,46925,IT,IT_75,-5,72,35,11,2358,2874
2020-04-23,Puglia,536,55,591,2345,2936,62,109,531,372,3839,50410,49403,IT,IT_75,-28,95,37,10,2068,2936
2020-04-24,Puglia,496,51,547,2386,2933,-3,42,565,383,3881,52472,51517,IT,IT_75,-40,41,34,11,2062,2933
2020-04-25,Puglia,469,48,517,2402,2919,-14,31,602,391,3912,54628,53500,IT,IT_75,-27,16,37,8,2156,2919
2020-04-26,Puglia,464,48,512,2425,2937,18,36,612,399,3948,55992,55397,IT,IT_75,-5,23,10,8,1364,2937
2020-04-27,Puglia,449,51,500,2412,2912,-25,10,641,405,3958,56976,55897,IT,IT_75,-15,-13,29,6,984,2912
2020-04-28,Puglia,448,51,499,2420,2919,7,22,654,407,3980,58496,57574,IT,IT_75,-1,8,13,2,1520,2919
2020-04-29,Puglia,449,47,496,2431,2927,8,49,692,410,4029,60334,59801,IT,IT_75,1,11,38,3,1838,2927
2020-04-30,Puglia,439,42,481,2468,2949,22,43,708,415,4072,62460,61439,IT,IT_75,-10,37,16,5,2126,2949
2020-05-01,Puglia,428,39,467,2480,2947,-2,27,731,421,4099,64292,62702,IT,IT_75,-11,12,23,6,1832,2947
2020-05-02,Puglia,416,39,455,2499,2954,7,34,757,422,4133,65370,63782,IT,IT_75,-12,19,26,1,1078,2954
2020-05-03,Puglia,410,40,450,2505,2955,1,11,765,424,4144,66443,64781,IT,IT_75,-6,6,8,2,1073,2955
2020-05-04,Puglia,397,39,436,2509,2945,-10,9,779,429,4153,67167,65789,IT,IT_75,-13,4,14,5,724,2945
2020-05-05,Puglia,384,39,423,2516,2939,-6,17,798,433,4170,69128,67238,IT,IT_75,-13,7,19,4,1961,2939
2020-05-06,Puglia,365,36,401,2502,2903,-36,26,855,438,4196,70944,68760,IT,IT_75,-19,-14,57,5,1816,2903
2020-05-07,Puglia,355,35,390,2410,2800,-103,49,1004,441,4245,72796,51638,IT,IT_75,-10,-92,149,3,1852,2800
2020-05-08,Puglia,349,33,382,2351,2733,-67,11,1080,443,4256,74724,53194,IT,IT_75,-6,-59,76,2,1928,2733
2020-05-09,Puglia,344,33,377,2352,2729,-4,30,1114,443,4286,76643,54181,IT,IT_75,-5,1,34,0,1919,2729
2020-05-10,Puglia,343,34,377,2292,2669,-60,27,1196,448,4313,78399,54781,IT,IT_75,-1,-60,82,5,1756,2669
2020-05-11,Puglia,340,32,372,2172,2544,-125,14,1332,451,4327,79737,55794,IT,IT_75,-3,-120,136,3,1338,2544
2020-05-12,Puglia,334,31,365,2056,2421,-123,10,1460,456,4337,81492,57060,IT,IT_75,-6,-116,128,5,1755,2421
2020-05-13,Puglia,310,27,337,1985,2322,-99,11,1566,460,4348,83713,58383,IT,IT_75,-24,-71,106,4,2221,2322
2020-05-14,Puglia,296,24,320,1933,2253,-69,9,1643,461,4357,85577,59815,IT,IT_75,-14,-52,77,1,1864,2253
2020-05-15,Puglia,285,23,308,1873,2181,-72,9,1724,461,4366,87687,60613,IT,IT_75,-11,-60,81,0,2110,2181
2020-05-16,Puglia,272,22,294,1810,2104,-77,8,1807,463,4374,89611,61942,IT,IT_75,-13,-63,83,2,1924,2104
2020-05-17,Puglia,263,21,284,1733,2017,-87,5,1892,470,4379,91035,62886,IT,IT_75,-9,-77,85,7,1424,2017
2020-05-18,Puglia,254,22,276,1719,1995,-22,7,1920,471,4386,91901,63403,IT,IT_75,-9,-14,28,1,866,1995
2020-05-19,Puglia,247,22,269,1672,1941,-54,10,1982,473,4396,93834,64779,IT,IT_75,-7,-47,62,2,1933,1941
2020-05-20,Puglia,242,21,263,1639,1902,-39,11,2027,478,4407,95895,66164,IT,IT_75,-5,-33,45,5,2061,1902
2020-05-21,Puglia,236,20,256,1583,1839,-63,6,2096,478,4413,97589,67562,IT,IT_75,-6,-56,69,0,1694,1839
2020-05-22,Puglia,233,17,250,1588,1838,-1,27,2120,482,4440,99702,67562,IT,IT_75,-3,5,24,4,2113,1838
2020-05-23,Puglia,215,17,232,1573,1805,-33,8,2157,486,4448,101738,68485,IT,IT_75,-18,-15,37,4,2036,1805
2020-05-24,Puglia,204,17,221,1572,1793,-12,10,2178,487,4458,103570,71032,IT,IT_75,-11,-1,21,1,1832,1793
2020-05-25,Puglia,190,15,205,1473,1678,-115,9,2298,491,4467,104670,72042,IT,IT_75,-14,-99,120,4,1100,1678
2020-05-26,Puglia,172,17,189,1350,1539,-139,2,2436,494,4469,106873,73226,IT,IT_75,-18,-123,138,3,2203,1539
2020-05-27,Puglia,170,17,187,1326,1513,-26,10,2471,495,4479,109499,74686,IT,IT_75,-2,-24,35,1,2626,1513
2020-05-28,Puglia,164,16,180,1215,1395,-118,2,2590,496,4481,111946,75959,IT,IT_75,-6,-111,119,1,2447,1395
2020-05-29,Puglia,158,12,170,1113,1283,-112,1,2699,500,4482,114588,77211,IT,IT_75,-6,-102,109,4,2642,1283
2020-05-30,Puglia,150,12,162,1060,1222,-61,8,2768,500,4490,116765,78458,IT,IT_75,-8,-53,69,0,2177,1222
2020-05-31,Puglia,143,11,154,1023,1177,-45,4,2813,504,4494,118652,79314,IT,IT_75,-7,-37,45,4,1887,1177
2020-06-01,Puglia,140,11,151,1004,1155,-22,4,2837,506,4498,119650,80390,IT,IT_75,-3,-19,24,2,998,1155
2020-06-02,Puglia,134,11,145,906,1051,-104,0,2939,508,4498,121460,81372,IT,IT_75,-6,-98,102,2,1810,1051
2020-06-03,Puglia,131,10,141,895,1036,-15,1,2952,511,4499,122506,82041,IT,IT_75,-3,-11,13,3,1046,1036
2020-06-04,Puglia,131,9,140,827,967,-69,4,3022,514,4503,125049,83870,IT,IT_75,0,-68,70,3,2543,967
2020-06-05,Puglia,111,5,116,730,846,-121,4,3140,521,4507,127520,85007,IT,IT_75,-20,-97,118,7,2471,846
2020-06-06,Puglia,109,4,113,645,758,-88,4,3231,522,4511,129898,86405,IT,IT_75,-2,-85,91,1,2378,758
2020-06-07,Puglia,96,4,100,633,733,-25,0,3253,525,4511,131931,86405,IT,IT_75,-13,-12,22,3,2033,733
2020-06-08,Puglia,94,4,98,600,698,-35,1,3289,525,4512,133164,88228,IT,IT_75,-2,-33,36,0,1233,698
2020-06-09,Puglia,76,5,81,532,613,-85,0,3373,526,4512,135625,90248,IT,IT_75,-18,-68,84,1,2461,613
2020-06-10,Puglia,71,4,75,482,557,-56,0,3426,529,4512,138377,91918,IT,IT_75,-5,-50,53,3,2752,557
2020-06-11,Puglia,65,3,68,399,467,-90,1,3516,530,4513,141322,93130,IT,IT_75,-6,-83,90,1,2945,467
2020-06-12,Puglia,61,2,63,376,439,-28,2,3544,532,4515,143844,94456,IT,IT_75,-4,-23,28,2,2522,439
2020-06-13,Puglia,60,2,62,360,422,-17,0,3561,532,4515,145905,96053,IT,IT_75,-1,-16,17,0,2061,422
2020-06-14,Puglia,57,2,59,359,418,-4,0,3565,532,4515,147249,96820,IT,IT_75,-3,-1,4,0,1344,418
2020-06-15,Puglia,56,2,58,352,410,-8,1,3572,534,4516,148627,97877,IT,IT_75,-1,-7,7,2,1378,410
2020-06-16,Puglia,48,2,50,303,353,-57,0,3628,535,4516,151482,99985,IT,IT_75,-8,-49,56,1,2855,353
2020-06-17,Puglia,46,2,48,276,324,-29,0,3656,536,4516,154143,101350,IT,IT_75,-2,-27,28,1,2661,324
2020-06-18,Puglia,34,1,35,271,306,-18,3,3675,538,4519,156582,103148,IT,IT_75,-12,-5,19,2,2439,306
2020-06-19,Puglia,31,1,32,223,255,-51,1,3727,538,4520,158828,104225,IT,IT_75,-3,-48,52,0,2246,255
2020-06-20,Puglia,32,1,33,187,220,-35,5,3765,540,4525,160662,105780,IT,IT_75,1,-36,38,2,1834,220
2020-02-24,Sardegna,0,0,0,0,0,0,0,0,0,0,1,,IT,IT_88,,,,,,0
2020-02-25,Sardegna,0,0,0,0,0,0,0,0,0,0,1,,IT,IT_88,0,0,0,0,0,0
2020-02-26,Sardegna,0,0,0,0,0,0,0,0,0,0,1,,IT,IT_88,0,0,0,0,0,0
2020-02-27,Sardegna,0,0,0,0,0,0,0,0,0,0,1,,IT,IT_88,0,0,0,0,0,0
2020-02-28,Sardegna,0,0,0,0,0,0,0,0,0,0,1,,IT,IT_88,0,0,0,0,0,0
2020-02-29,Sardegna,0,0,0,0,0,0,0,0,0,0,1,,IT,IT_88,0,0,0,0,0,0
2020-03-01,Sardegna,0,0,0,0,0,0,0,0,0,0,29,,IT,IT_88,0,0,0,0,28,0
2020-03-02,Sardegna,0,0,0,0,0,0,0,0,0,0,29,,IT,IT_88,0,0,0,0,0,0
2020-03-03,Sardegna,1,0,1,0,1,1,1,0,0,1,29,,IT,IT_88,1,0,0,0,0,1
2020-03-04,Sardegna,1,0,1,1,2,1,1,0,0,2,42,,IT,IT_88,0,1,0,0,13,2
2020-03-05,Sardegna,2,0,2,0,2,0,0,0,0,2,50,,IT,IT_88,1,-1,0,0,8,2
2020-03-06,Sardegna,2,0,2,3,5,3,3,0,0,5,99,,IT,IT_88,0,3,0,0,49,5
2020-03-07,Sardegna,2,0,2,3,5,0,0,0,0,5,99,,IT,IT_88,0,0,0,0,0,5
2020-03-08,Sardegna,5,0,5,6,11,6,6,0,0,11,149,,IT,IT_88,3,3,0,0,50,11
2020-03-09,Sardegna,8,0,8,11,19,8,8,0,0,19,185,,IT,IT_88,3,5,0,0,36,19
2020-03-10,Sardegna,9,0,9,11,20,1,1,0,0,20,204,,IT,IT_88,1,0,0,0,19,20
2020-03-11,Sardegna,10,0,10,27,37,17,17,0,0,37,283,,IT,IT_88,1,16,0,0,79,37
2020-03-12,Sardegna,12,0,12,27,39,2,2,0,0,39,302,,IT,IT_88,2,0,0,0,19,39
2020-03-13,Sardegna,12,0,12,31,43,4,4,0,0,43,504,,IT,IT_88,0,4,0,0,202,43
2020-03-14,Sardegna,14,0,14,33,47,4,4,0,0,47,530,,IT,IT_88,2,2,0,0,26,47
2020-03-15,Sardegna,16,0,16,59,75,28,30,0,2,77,613,,IT,IT_88,2,26,0,2,83,75
2020-03-16,Sardegna,39,0,39,66,105,30,30,0,2,107,797,,IT,IT_88,23,7,0,0,184,105
2020-03-17,Sardegna,36,4,40,75,115,10,10,0,2,117,1003,,IT,IT_88,-3,9,0,0,206,115
2020-03-18,Sardegna,42,7,49,83,132,17,17,0,2,134,1135,,IT,IT_88,6,8,0,0,132,132
2020-03-19,Sardegna,43,9,52,152,204,72,72,0,2,206,1334,,IT,IT_88,1,69,0,0,199,204
2020-03-20,Sardegna,56,15,71,217,288,84,87,3,2,293,1912,,IT,IT_88,13,65,3,0,578,288
2020-03-21,Sardegna,65,16,81,240,321,33,37,5,4,330,2297,,IT,IT_88,9,23,2,2,385,321
2020-03-22,Sardegna,67,16,83,244,327,6,9,5,7,339,2402,,IT,IT_88,2,4,0,3,105,327
2020-03-23,Sardegna,76,18,94,249,343,16,20,5,11,359,2568,,IT,IT_88,9,5,0,4,166,343
2020-03-24,Sardegna,80,19,99,296,395,52,62,11,15,421,2859,,IT,IT_88,4,47,6,4,291,395
2020-03-25,Sardegna,82,19,101,311,412,17,21,12,18,442,3019,,IT,IT_88,2,15,1,3,160,412
2020-03-26,Sardegna,92,20,112,350,462,50,52,13,19,494,3461,,IT,IT_88,10,39,1,1,442,462
2020-03-27,Sardegna,93,19,112,384,496,34,36,13,21,530,3801,,IT,IT_88,1,34,0,2,340,496
2020-03-28,Sardegna,95,22,117,452,569,73,94,29,26,624,4225,,IT,IT_88,2,68,16,5,424,569
2020-03-29,Sardegna,105,23,128,454,582,13,14,29,27,638,4598,,IT,IT_88,10,2,0,1,373,582
2020-03-30,Sardegna,113,24,137,485,622,40,44,32,28,682,4993,,IT,IT_88,8,31,3,1,395,622
2020-03-31,Sardegna,113,28,141,516,657,35,40,34,31,722,5257,,IT,IT_88,0,31,2,3,264,657
2020-04-01,Sardegna,119,27,146,529,675,18,23,36,34,745,5501,,IT,IT_88,6,13,2,3,244,675
2020-04-02,Sardegna,117,24,141,577,718,43,49,36,40,794,5970,,IT,IT_88,-2,48,0,6,469,718
2020-04-03,Sardegna,122,24,146,598,744,26,31,40,41,825,6478,,IT,IT_88,5,21,4,1,508,744
2020-04-04,Sardegna,123,24,147,642,789,45,49,44,41,874,6789,,IT,IT_88,1,44,4,0,311,789
2020-04-05,Sardegna,126,25,151,664,815,26,33,49,43,907,7157,,IT,IT_88,3,22,5,2,368,815
2020-04-06,Sardegna,123,26,149,670,819,4,15,56,47,922,7521,,IT,IT_88,-3,6,7,4,364,819
2020-04-07,Sardegna,122,26,148,673,821,2,13,62,52,935,7680,,IT,IT_88,-1,3,6,5,159,821
2020-04-08,Sardegna,112,31,143,697,840,19,40,76,59,975,8493,,IT,IT_88,-10,24,14,7,813,840
2020-04-09,Sardegna,106,25,131,745,876,36,51,86,64,1026,8918,,IT,IT_88,-6,48,10,5,425,876
2020-04-10,Sardegna,107,26,133,743,876,0,37,118,69,1063,9444,,IT,IT_88,1,-2,32,5,526,876
2020-04-11,Sardegna,113,24,137,751,888,12,28,130,73,1091,10120,,IT,IT_88,6,8,12,4,676,888
2020-04-12,Sardegna,109,26,135,768,903,15,22,137,73,1113,10663,,IT,IT_88,-4,17,7,0,543,903
2020-04-13,Sardegna,107,27,134,780,914,11,15,139,75,1128,11010,,IT,IT_88,-2,12,2,2,347,914
2020-04-14,Sardegna,107,24,131,769,900,-14,10,158,80,1138,11893,,IT,IT_88,0,-11,19,5,883,900
2020-04-15,Sardegna,107,26,133,737,870,-30,23,208,83,1161,12395,,IT,IT_88,0,-32,50,3,502,870
2020-04-16,Sardegna,109,24,133,732,865,-5,3,214,85,1164,12796,,IT,IT_88,2,-5,6,2,401,865
2020-04-17,Sardegna,113,23,136,736,872,7,14,220,86,1178,13304,,IT,IT_88,4,4,6,1,508,872
2020-04-18,Sardegna,112,23,135,746,881,9,20,231,86,1198,14087,,IT,IT_88,-1,10,11,0,783,881
2020-04-19,Sardegna,117,22,139,725,864,-17,17,265,86,1215,14859,13760,IT,IT_88,5,-21,34,0,772,864
2020-04-20,Sardegna,115,21,136,718,854,-10,13,288,86,1228,15328,14160,IT,IT_88,-2,-7,23,0,469,854
2020-04-21,Sardegna,112,21,133,704,837,-17,8,306,93,1236,15886,14526,IT,IT_88,-3,-14,18,7,558,837
2020-04-22,Sardegna,97,20,117,716,833,-4,11,318,96,1247,16886,15354,IT,IT_88,-15,12,12,3,1000,833
2020-04-23,Sardegna,90,20,110,707,817,-16,7,339,98,1254,17844,16094,IT,IT_88,-7,-9,21,2,958,817
2020-04-24,Sardegna,95,19,114,690,804,-13,3,351,102,1257,19889,18050,IT,IT_88,5,-17,12,4,2045,804
2020-04-25,Sardegna,96,18,114,680,794,-10,14,374,103,1271,20351,18480,IT,IT_88,1,-10,23,1,462,794
2020-04-26,Sardegna,95,20,115,668,783,-11,9,388,109,1280,21101,19162,IT,IT_88,-1,-12,14,6,750,783
2020-04-27,Sardegna,97,19,116,660,776,-7,3,398,109,1283,21395,19424,IT,IT_88,2,-8,10,0,294,776
2020-04-28,Sardegna,96,18,114,658,772,-4,2,404,109,1285,22116,20053,IT,IT_88,-1,-2,6,0,721,772
2020-04-29,Sardegna,87,17,104,657,761,-11,5,413,116,1290,23299,21071,IT,IT_88,-9,-1,9,7,1183,761
2020-04-30,Sardegna,87,16,103,641,744,-17,5,435,116,1295,24754,22358,IT,IT_88,0,-16,22,0,1455,744
2020-05-01,Sardegna,84,12,96,648,744,0,18,452,117,1313,26242,23442,IT,IT_88,-3,7,17,1,1488,744
2020-05-02,Sardegna,86,13,99,631,730,-14,2,466,119,1315,26990,24065,IT,IT_88,2,-17,14,2,748,730
2020-05-03,Sardegna,92,10,102,587,689,-41,4,511,119,1319,27737,24662,IT,IT_88,6,-44,45,0,747,689
2020-05-04,Sardegna,91,9,100,553,653,-36,-2,545,119,1317,28052,24926,IT,IT_88,-1,-34,34,0,315,653
2020-05-05,Sardegna,94,9,103,539,642,-11,1,557,119,1318,28867,25631,IT,IT_88,3,-14,12,0,815,642
2020-05-06,Sardegna,91,11,102,521,623,-19,1,577,119,1319,29966,26598,IT,IT_88,-3,-18,20,0,1099,623
2020-05-07,Sardegna,90,9,99,484,583,-40,5,622,119,1324,31064,27540,IT,IT_88,-1,-37,45,0,1098,583
2020-05-08,Sardegna,90,10,100,453,553,-30,6,658,119,1330,32219,28519,IT,IT_88,0,-31,36,0,1155,553
2020-05-09,Sardegna,87,11,98,452,550,-3,4,665,119,1334,33330,29503,IT,IT_88,-3,-1,7,0,1111,550
2020-05-10,Sardegna,83,10,93,422,515,-35,6,705,120,1340,34046,30086,IT,IT_88,-4,-30,40,1,716,515
2020-05-11,Sardegna,84,10,94,417,511,-4,3,712,120,1343,34641,30582,IT,IT_88,1,-5,7,0,595,511
2020-05-12,Sardegna,77,11,88,418,506,-5,1,718,120,1344,35476,31351,IT,IT_88,-7,1,6,0,835,506
2020-05-13,Sardegna,78,10,88,403,491,-15,1,734,120,1345,36710,32449,IT,IT_88,1,-15,16,0,1234,491
2020-05-14,Sardegna,76,10,86,379,465,-26,0,755,125,1345,38034,33526,IT,IT_88,-2,-24,21,5,1324,465
2020-05-15,Sardegna,75,10,85,376,461,-4,3,762,125,1348,39844,34864,IT,IT_88,-1,-3,7,0,1810,461
2020-05-16,Sardegna,75,10,85,330,415,-46,4,812,125,1352,41257,35933,IT,IT_88,0,-46,50,0,1413,415
2020-05-17,Sardegna,76,10,86,319,405,-10,1,823,125,1353,42249,36736,IT,IT_88,1,-11,11,0,992,405
2020-05-18,Sardegna,72,10,82,298,380,-25,0,847,126,1353,43387,37684,IT,IT_88,-4,-21,24,1,1138,380
2020-05-19,Sardegna,71,9,80,261,341,-39,1,887,126,1354,44413,38503,IT,IT_88,-1,-37,40,0,1026,341
2020-05-20,Sardegna,68,10,78,253,331,-10,1,898,126,1355,45572,39460,IT,IT_88,-3,-8,11,0,1159,331
2020-05-21,Sardegna,64,12,76,242,318,-13,1,911,127,1356,46795,40461,IT,IT_88,-4,-11,13,1,1223,318
2020-05-22,Sardegna,58,6,64,242,306,-12,0,922,128,1356,48189,41603,IT,IT_88,-6,0,11,1,1394,306
2020-05-23,Sardegna,58,6,64,223,287,-19,0,940,129,1356,49675,42790,IT,IT_88,0,-19,18,1,1486,287
2020-05-24,Sardegna,51,3,54,191,245,-42,0,982,129,1356,50796,43661,IT,IT_88,-7,-32,42,0,1121,245
2020-05-25,Sardegna,49,3,52,179,231,-14,-2,994,129,1354,51073,43924,IT,IT_88,-2,-12,12,0,277,231
2020-05-26,Sardegna,41,2,43,181,224,-7,0,1000,130,1354,51968,44663,IT,IT_88,-8,2,6,1,895,224
2020-05-27,Sardegna,41,2,43,172,215,-9,1,1010,130,1355,53294,45745,IT,IT_88,0,-9,10,0,1326,215
2020-05-28,Sardegna,38,2,40,160,200,-15,0,1025,130,1355,54587,46815,IT,IT_88,-3,-12,15,0,1293,200
2020-05-29,Sardegna,37,2,39,151,190,-10,1,1036,130,1356,55831,47841,IT,IT_88,-1,-9,11,0,1244,190
2020-05-30,Sardegna,34,2,36,150,186,-4,0,1040,130,1356,56580,48432,IT,IT_88,-3,-1,4,0,749,186
2020-05-31,Sardegna,33,2,35,150,185,-1,0,1041,130,1356,57296,49016,IT,IT_88,-1,0,1,0,716,185
2020-06-01,Sardegna,23,1,24,137,161,-24,1,1065,131,1357,57687,49354,IT,IT_88,-10,-13,24,1,391,161
2020-06-02,Sardegna,21,1,22,133,155,-6,0,1071,131,1357,58224,49736,IT,IT_88,-2,-4,6,0,537,155
2020-06-03,Sardegna,12,1,13,133,146,-9,0,1080,131,1357,58605,50057,IT,IT_88,-9,0,9,0,381,146
2020-06-04,Sardegna,12,1,13,95,108,-38,0,1118,131,1357,59556,50865,IT,IT_88,0,-38,38,0,951,108
2020-06-05,Sardegna,11,0,11,56,67,-41,2,1161,131,1359,60794,51853,IT,IT_88,-1,-39,43,0,1238,67
2020-06-06,Sardegna,10,1,11,49,60,-7,3,1171,131,1362,62145,52956,IT,IT_88,-1,-7,10,0,1351,60
2020-06-07,Sardegna,10,1,11,48,59,-1,0,1172,131,1362,63172,53735,IT,IT_88,0,-1,1,0,1027,59
2020-06-08,Sardegna,9,1,10,46,56,-3,0,1175,131,1362,63510,54051,IT,IT_88,-1,-2,3,0,338,56
2020-06-09,Sardegna,9,1,10,44,54,-2,-1,1176,131,1361,64272,54707,IT,IT_88,0,-2,1,0,762,54
2020-06-10,Sardegna,9,1,10,40,50,-4,0,1180,131,1361,65175,55439,IT,IT_88,0,-4,4,0,903,50
2020-06-11,Sardegna,10,1,11,32,43,-7,1,1188,131,1362,66133,56226,IT,IT_88,1,-8,8,0,958,43
2020-06-12,Sardegna,10,1,11,31,42,-1,1,1190,131,1363,67069,56937,IT,IT_88,0,-1,2,0,936,42
2020-06-13,Sardegna,12,0,12,22,34,-8,0,1197,132,1363,68079,57763,IT,IT_88,2,-9,7,1,1010,34
2020-06-14,Sardegna,12,0,12,21,33,-1,0,1198,132,1363,68769,58281,IT,IT_88,0,-1,1,0,690,33
2020-06-15,Sardegna,12,0,12,21,33,0,0,1198,132,1363,69134,58586,IT,IT_88,0,0,0,0,365,33
2020-06-16,Sardegna,13,0,13,20,33,0,2,1200,132,1365,70202,59536,IT,IT_88,1,-1,2,0,1068,33
2020-06-17,Sardegna,11,0,11,20,31,-2,1,1203,132,1366,71452,60606,IT,IT_88,-2,0,3,0,1250,31
2020-06-18,Sardegna,10,0,10,21,31,0,1,1204,132,1367,72722,61674,IT,IT_88,-1,1,1,0,1270,31
2020-06-19,Sardegna,10,0,10,20,30,-1,1,1206,132,1368,73846,62546,IT,IT_88,0,-1,2,0,1124,30
2020-06-20,Sardegna,9,0,9,19,28,-2,1,1209,132,1369,75217,63646,IT,IT_88,-1,-1,3,0,1371,28
2020-02-24,Sicilia,0,0,0,0,0,0,0,0,0,0,5,,IT,IT_82,,,,,,0
2020-02-25,Sicilia,1,0,1,2,3,3,3,0,0,3,5,,IT,IT_82,1,2,0,0,0,3
2020-02-26,Sicilia,1,0,1,2,3,0,0,0,0,3,5,,IT,IT_82,0,0,0,0,0,3
2020-02-27,Sicilia,1,0,1,1,2,-1,1,2,0,4,5,,IT,IT_82,0,-1,2,0,0,2
2020-02-28,Sicilia,1,0,1,1,2,0,0,2,0,4,5,,IT,IT_82,0,0,0,0,0,2
2020-02-29,Sicilia,1,0,1,1,2,0,0,2,0,4,6,,IT,IT_82,0,0,0,0,1,2
2020-03-01,Sicilia,1,0,1,6,7,5,5,2,0,9,291,,IT,IT_82,0,5,0,0,285,7
2020-03-02,Sicilia,2,0,2,3,5,-2,-2,2,0,7,307,,IT,IT_82,1,-3,0,0,16,5
2020-03-03,Sicilia,2,0,2,3,5,0,0,2,0,7,307,,IT,IT_82,0,0,0,0,0,5
2020-03-04,Sicilia,5,0,5,11,16,11,11,2,0,18,367,,IT,IT_82,3,8,0,0,60,16
2020-03-05,Sicilia,5,0,5,11,16,0,0,2,0,18,367,,IT,IT_82,0,0,0,0,0,16
2020-03-06,Sicilia,7,0,7,15,22,6,6,2,0,24,367,,IT,IT_82,2,4,0,0,0,22
2020-03-07,Sicilia,8,0,8,25,33,11,11,2,0,35,643,,IT,IT_82,1,10,0,0,276,33
2020-03-08,Sicilia,18,0,18,33,51,18,18,2,0,53,791,,IT,IT_82,10,8,0,0,148,51
2020-03-09,Sicilia,19,0,19,33,52,1,1,2,0,54,836,,IT,IT_82,1,0,0,0,45,52
2020-03-10,Sicilia,17,2,19,41,60,8,8,2,0,62,955,,IT,IT_82,-2,8,0,0,119,60
2020-03-11,Sicilia,23,1,24,57,81,21,21,2,0,83,1194,,IT,IT_82,6,16,0,0,239,81
2020-03-12,Sicilia,28,5,33,78,111,30,32,2,2,115,1477,,IT,IT_82,5,21,0,2,283,111
2020-03-13,Sicilia,37,7,44,82,126,15,15,2,2,130,1950,,IT,IT_82,9,4,0,0,473,126
2020-03-14,Sicilia,42,11,53,97,150,24,26,4,2,156,2100,,IT,IT_82,5,15,2,0,150,150
2020-03-15,Sicilia,56,15,71,108,179,29,32,7,2,188,2452,,IT,IT_82,14,11,3,0,352,179
2020-03-16,Sicilia,75,20,95,108,203,24,25,8,2,213,2653,,IT,IT_82,19,0,1,0,201,203
2020-03-17,Sicilia,86,28,114,112,226,23,24,8,3,237,2916,,IT,IT_82,11,4,0,1,263,226
2020-03-18,Sicilia,100,29,129,138,267,41,45,12,3,282,3294,,IT,IT_82,14,26,4,0,378,267
2020-03-19,Sicilia,143,36,179,142,321,54,58,15,4,340,3961,,IT,IT_82,43,4,3,1,667,321
2020-03-20,Sicilia,168,42,210,169,379,58,68,25,4,408,4468,,IT,IT_82,25,27,10,0,507,379
2020-03-21,Sicilia,206,48,254,204,458,79,82,26,6,490,4883,,IT,IT_82,38,35,1,2,415,458
2020-03-22,Sicilia,220,55,275,321,596,138,140,26,8,630,5580,,IT,IT_82,14,117,0,2,697,596
2020-03-23,Sicilia,250,60,310,371,681,85,91,27,13,721,6375,,IT,IT_82,30,50,1,5,795,681
2020-03-24,Sicilia,250,60,310,489,799,118,125,27,20,846,7170,,IT,IT_82,0,118,0,7,795,799
2020-03-25,Sicilia,259,80,339,597,936,137,148,33,25,994,8312,,IT,IT_82,9,108,6,5,1142,936
2020-03-26,Sicilia,346,68,414,681,1095,159,170,36,33,1164,9658,,IT,IT_82,87,84,3,8,1346,1095
2020-03-27,Sicilia,425,75,500,658,1158,63,86,53,39,1250,11079,,IT,IT_82,79,-23,17,6,1421,1158
2020-03-28,Sicilia,441,71,512,730,1242,84,109,60,57,1359,13096,,IT,IT_82,16,72,7,18,2017,1242
2020-03-29,Sicilia,451,71,522,808,1330,88,101,65,65,1460,13814,,IT,IT_82,10,78,5,8,718,1330
2020-03-30,Sicilia,484,75,559,849,1408,78,95,71,76,1555,14758,,IT,IT_82,33,41,6,11,944,1408
2020-03-31,Sicilia,503,72,575,917,1492,84,92,74,81,1647,15634,,IT,IT_82,19,68,3,5,876,1492
2020-04-01,Sicilia,496,72,568,976,1544,52,71,86,88,1718,16836,,IT,IT_82,-7,59,12,7,1202,1544
2020-04-02,Sicilia,503,73,576,1030,1606,62,73,92,93,1791,17833,,IT,IT_82,7,54,6,5,997,1606
2020-04-03,Sicilia,535,73,608,1056,1664,58,68,94,101,1859,18686,,IT,IT_82,32,26,2,8,853,1664
2020-04-04,Sicilia,553,74,627,1099,1726,62,73,95,111,1932,19896,,IT,IT_82,18,43,1,10,1210,1726
2020-04-05,Sicilia,556,76,632,1142,1774,48,62,104,116,1994,21904,,IT,IT_82,3,43,9,5,2008,1774
2020-04-06,Sicilia,563,74,637,1178,1815,41,52,108,123,2046,23464,,IT,IT_82,7,36,4,7,1560,1815
2020-04-07,Sicilia,562,73,635,1224,1859,44,51,113,125,2097,24857,,IT,IT_82,-1,46,5,2,1393,1859
2020-04-08,Sicilia,563,65,628,1265,1893,34,62,133,133,2159,27438,,IT,IT_82,1,41,20,8,2581,1893
2020-04-09,Sicilia,566,63,629,1313,1942,49,73,152,138,2232,28742,,IT,IT_82,3,48,19,5,1304,1942
2020-04-10,Sicilia,568,62,630,1337,1967,25,70,187,148,2302,31156,,IT,IT_82,2,24,35,10,2414,1967
2020-04-11,Sicilia,562,58,620,1381,2001,34,62,209,154,2364,33787,,IT,IT_82,-6,44,22,6,2631,2001
2020-04-12,Sicilia,552,53,605,1425,2030,29,52,223,163,2416,36098,,IT,IT_82,-10,44,14,9,2311,2030
2020-04-13,Sicilia,554,51,605,1445,2050,20,42,237,171,2458,37311,,IT,IT_82,2,20,14,8,1213,2050
2020-04-14,Sicilia,552,53,605,1466,2071,21,43,255,175,2501,37877,,IT,IT_82,-2,21,18,4,566,2071
2020-04-15,Sicilia,541,49,590,1491,2081,10,34,273,181,2535,39867,,IT,IT_82,-11,25,18,6,1990,2081
2020-04-16,Sicilia,525,48,573,1535,2108,27,44,284,187,2579,42405,,IT,IT_82,-16,44,11,6,2538,2108
2020-04-17,Sicilia,521,46,567,1572,2139,31,46,296,190,2625,45172,,IT,IT_82,-4,37,12,3,2767,2139
2020-04-18,Sicilia,526,42,568,1603,2171,32,47,305,196,2672,47715,,IT,IT_82,5,31,9,6,2543,2171
2020-04-19,Sicilia,522,41,563,1639,2202,31,45,315,200,2717,49772,49772,IT,IT_82,-4,36,10,4,2057,2202
2020-04-20,Sicilia,526,39,565,1645,2210,8,42,346,203,2759,51373,51373,IT,IT_82,4,6,31,3,1601,2210
2020-04-21,Sicilia,514,37,551,1708,2259,49,76,370,206,2835,55093,55093,IT,IT_82,-12,63,24,3,3720,2259
2020-04-22,Sicilia,500,35,535,1752,2287,28,48,388,208,2883,58732,58732,IT,IT_82,-14,44,18,2,3639,2287
2020-04-23,Sicilia,476,34,510,1791,2301,14,43,412,213,2926,62150,62150,IT,IT_82,-24,39,24,5,3418,2301
2020-04-24,Sicilia,461,32,493,1827,2320,19,55,443,218,2981,65165,63626,IT,IT_82,-15,36,31,5,3015,2320
2020-04-25,Sicilia,452,33,485,1787,2272,-48,39,524,224,3020,68251,64892,IT,IT_82,-9,-40,81,6,3086,2272
2020-04-26,Sicilia,445,33,478,1629,2107,-165,35,720,228,3055,70104,65689,IT,IT_82,-7,-158,196,4,1853,2107
2020-04-27,Sicilia,440,35,475,1648,2123,16,30,731,231,3085,70650,66749,IT,IT_82,-5,19,11,3,546,2123
2020-04-28,Sicilia,428,34,462,1681,2143,20,35,745,232,3120,73008,68729,IT,IT_82,-12,33,14,1,2358,2143
2020-04-29,Sicilia,415,34,449,1696,2145,2,20,763,232,3140,75360,71301,IT,IT_82,-13,15,18,0,2352,2145
2020-04-30,Sicilia,408,33,441,1716,2157,12,26,774,235,3166,79669,74541,IT,IT_82,-7,20,11,3,4309,2157
2020-05-01,Sicilia,399,30,429,1742,2171,14,28,786,237,3194,82860,77490,IT,IT_82,-9,26,12,2,3191,2171
2020-05-02,Sicilia,396,30,426,1760,2186,15,19,787,240,3213,84352,77590,IT,IT_82,-3,18,1,3,1492,2186
2020-05-03,Sicilia,383,29,412,1791,2203,17,27,795,242,3240,85955,78409,IT,IT_82,-13,31,8,2,1603,2203
2020-05-04,Sicilia,376,27,403,1799,2202,-1,15,809,244,3255,87166,79336,IT,IT_82,-7,8,14,2,1211,2202
2020-05-05,Sicilia,367,26,393,1809,2202,0,12,818,247,3267,91306,82079,IT,IT_82,-9,10,9,3,4140,2202
2020-05-06,Sicilia,359,25,384,1817,2201,-1,14,830,250,3281,92999,83908,IT,IT_82,-8,8,12,3,1693,2201
2020-05-07,Sicilia,349,21,370,1757,2127,-74,7,910,251,3288,95695,85674,IT,IT_82,-10,-60,80,1,2696,2127
2020-05-08,Sicilia,310,19,329,1798,2127,0,13,921,253,3301,98711,88497,IT,IT_82,-39,41,11,2,3016,2127
2020-05-09,Sicilia,277,17,294,1786,2080,-47,12,977,256,3313,101548,90885,IT,IT_82,-33,-12,56,3,2837,2080
2020-05-10,Sicilia,273,16,289,1780,2069,-11,14,1002,256,3327,102403,91748,IT,IT_82,-4,-6,25,0,855,2069
2020-05-11,Sicilia,271,16,287,1775,2062,-7,12,1020,257,3339,103134,92609,IT,IT_82,-2,-5,18,1,731,2062
2020-05-12,Sicilia,234,15,249,1662,1911,-151,4,1171,261,3343,105017,94034,IT,IT_82,-37,-113,151,4,1883,1911
2020-05-13,Sicilia,212,13,225,1664,1889,-22,11,1203,262,3354,107991,96860,IT,IT_82,-22,2,32,1,2974,1889
2020-05-14,Sicilia,203,12,215,1639,1854,-35,12,1249,263,3366,111137,99900,IT,IT_82,-9,-25,46,1,3146,1854
2020-05-15,Sicilia,198,11,209,1551,1760,-94,8,1351,263,3374,112929,101487,IT,IT_82,-5,-88,102,0,1792,1760
2020-05-16,Sicilia,159,12,171,1488,1659,-101,8,1458,265,3382,114963,103103,IT,IT_82,-39,-63,107,2,2034,1659
2020-05-17,Sicilia,145,13,158,1397,1555,-104,6,1566,267,3388,117426,105074,IT,IT_82,-14,-91,108,2,2463,1555
2020-05-18,Sicilia,137,13,150,1389,1539,-16,7,1589,267,3395,118859,106277,IT,IT_82,-8,-8,23,0,1433,1539
2020-05-19,Sicilia,125,12,137,1387,1524,-15,8,1611,268,3403,122040,109195,IT,IT_82,-12,-2,22,1,3181,1524
2020-05-20,Sicilia,118,11,129,1394,1523,-1,8,1620,268,3411,123573,110205,IT,IT_82,-7,7,9,0,1533,1523
2020-05-21,Sicilia,107,11,118,1404,1522,-1,6,1627,268,3417,127348,112329,IT,IT_82,-11,10,7,0,3775,1522
2020-05-22,Sicilia,103,10,113,1406,1519,-3,4,1634,268,3421,129431,114230,IT,IT_82,-4,2,7,0,2083,1519
2020-05-23,Sicilia,95,9,104,1408,1512,-7,0,1640,269,3421,131913,116517,IT,IT_82,-8,2,6,1,2482,1512
2020-05-24,Sicilia,91,9,100,1353,1453,-59,2,1701,269,3423,133249,117242,IT,IT_82,-4,-55,61,0,1336,1453
2020-05-25,Sicilia,89,9,98,1335,1433,-20,4,1724,270,3427,135261,118208,IT,IT_82,-2,-18,23,1,2012,1433
2020-05-26,Sicilia,83,10,93,1337,1430,-3,3,1729,271,3430,137682,120206,IT,IT_82,-6,2,5,1,2421,1430
2020-05-27,Sicilia,73,10,83,1235,1318,-112,5,1845,272,3435,140295,122130,IT,IT_82,-10,-102,116,1,2613,1318
2020-05-28,Sicilia,72,8,80,1065,1145,-173,3,2021,272,3438,142516,122600,IT,IT_82,-1,-170,176,0,2221,1145
2020-05-29,Sicilia,67,7,74,1063,1137,-8,2,2031,272,3440,145979,125340,IT,IT_82,-5,-2,10,0,3463,1137
2020-05-30,Sicilia,67,7,74,925,999,-138,2,2170,273,3442,148871,127725,IT,IT_82,0,-138,139,1,2892,999
2020-05-31,Sicilia,65,7,72,914,986,-13,1,2183,274,3443,150054,128717,IT,IT_82,-2,-11,13,1,1183,986
2020-06-01,Sicilia,65,8,73,894,967,-19,0,2202,274,3443,151186,129103,IT,IT_82,0,-20,19,0,1132,967
2020-06-02,Sicilia,62,7,69,897,966,-1,4,2206,275,3447,153417,130886,IT,IT_82,-3,3,4,1,2231,966
2020-06-03,Sicilia,60,7,67,813,880,-86,0,2292,275,3447,154873,131820,IT,IT_82,-2,-84,86,0,1456,880
2020-06-04,Sicilia,57,6,63,816,879,-1,0,2292,276,3447,157868,134035,IT,IT_82,-3,3,0,1,2995,879
2020-06-05,Sicilia,54,6,60,812,872,-7,1,2300,276,3448,160639,136155,IT,IT_82,-3,-4,8,0,2771,872
2020-06-06,Sicilia,47,7,54,812,866,-6,2,2308,276,3450,163432,138343,IT,IT_82,-7,0,8,0,2793,866
2020-06-07,Sicilia,42,7,49,813,862,-4,1,2312,277,3451,164985,139481,IT,IT_82,-5,1,4,1,1553,862
2020-06-08,Sicilia,40,7,47,806,853,-9,1,2321,278,3452,165693,140109,IT,IT_82,-2,-7,9,1,708,853
2020-06-09,Sicilia,39,6,45,808,853,0,2,2323,278,3454,168562,142495,IT,IT_82,-1,2,2,0,2869,853
2020-06-10,Sicilia,40,6,46,807,853,0,1,2324,278,3455,171384,144193,IT,IT_82,1,-1,1,0,2822,853
2020-06-11,Sicilia,37,5,42,807,849,-4,0,2327,279,3455,174429,146290,IT,IT_82,-3,0,3,1,3045,849
2020-06-12,Sicilia,34,3,37,804,841,-8,0,2335,279,3455,176233,147871,IT,IT_82,-3,-3,8,0,1804,841
2020-06-13,Sicilia,33,3,36,806,842,1,1,2335,279,3456,178319,149516,IT,IT_82,-1,2,0,0,2086,842
2020-06-14,Sicilia,32,3,35,802,837,-5,1,2341,279,3457,179438,150233,IT,IT_82,-1,-4,6,0,1119,837
2020-06-15,Sicilia,30,4,34,771,805,-32,1,2373,280,3458,180327,150982,IT,IT_82,-2,-31,32,1,889,805
2020-06-16,Sicilia,32,4,36,770,806,1,2,2374,280,3460,182514,152670,IT,IT_82,2,-1,1,0,2187,806
2020-06-17,Sicilia,25,3,28,777,805,-1,2,2377,280,3462,184412,154287,IT,IT_82,-7,7,3,0,1898,805
2020-06-18,Sicilia,24,3,27,610,637,-168,2,2547,280,3464,186253,155903,IT,IT_82,-1,-167,170,0,1841,637
2020-06-19,Sicilia,21,5,26,124,150,-487,3,2640,280,3070,187869,156719,IT,IT_82,-3,-486,93,0,1616,150
2020-06-20,Sicilia,21,5,26,114,140,-10,0,2650,280,3070,189938,157946,IT,IT_82,0,-10,10,0,2069,140
2020-02-24,Toscana,0,0,0,0,0,0,0,0,0,0,140,,IT,IT_52,,,,,,0
2020-02-25,Toscana,2,0,2,0,2,2,2,0,0,2,296,,IT,IT_52,2,0,0,0,156,2
2020-02-26,Toscana,2,0,2,0,2,0,0,0,0,2,363,,IT,IT_52,0,0,0,0,67,2
2020-02-27,Toscana,2,0,2,0,2,0,0,0,0,2,410,,IT,IT_52,0,0,0,0,47,2
2020-02-28,Toscana,5,0,5,2,7,5,6,1,0,8,437,,IT,IT_52,3,2,1,0,27,7
2020-02-29,Toscana,7,0,7,3,10,3,3,1,0,11,531,,IT,IT_52,2,1,0,0,94,10
2020-03-01,Toscana,7,0,7,5,12,2,2,1,0,13,572,,IT,IT_52,0,2,0,0,41,12
2020-03-02,Toscana,7,0,7,5,12,0,0,1,0,13,613,,IT,IT_52,0,0,0,0,41,12
2020-03-03,Toscana,10,0,10,8,18,6,6,1,0,19,697,,IT,IT_52,3,3,0,0,84,18
2020-03-04,Toscana,15,2,17,20,37,19,19,1,0,38,776,,IT,IT_52,5,12,0,0,79,37
2020-03-05,Toscana,26,3,29,31,60,23,23,1,0,61,776,,IT,IT_52,11,11,0,0,0,60
2020-03-06,Toscana,35,5,40,38,78,18,18,1,0,79,1097,,IT,IT_52,9,7,0,0,321,78
2020-03-07,Toscana,54,7,61,51,112,34,34,1,0,113,1331,,IT,IT_52,19,13,0,0,234,112
2020-03-08,Toscana,91,7,98,67,165,53,53,1,0,166,1618,,IT,IT_52,37,16,0,0,287,165
2020-03-09,Toscana,107,9,116,90,206,41,42,1,1,208,2018,,IT,IT_52,16,23,0,1,400,206
2020-03-10,Toscana,91,40,131,129,260,54,56,3,1,264,2573,,IT,IT_52,-16,39,2,0,555,260
2020-03-11,Toscana,87,54,141,173,314,54,56,5,1,320,2804,,IT,IT_52,-4,44,2,0,231,314
2020-03-12,Toscana,100,59,159,193,352,38,44,7,5,364,3165,,IT,IT_52,13,20,2,4,361,352
2020-03-13,Toscana,134,77,211,244,455,103,106,10,5,470,4049,,IT,IT_52,34,51,3,0,884,455
2020-03-14,Toscana,160,87,247,367,614,159,160,10,6,630,4595,,IT,IT_52,26,123,0,1,546,614
2020-03-15,Toscana,175,107,282,481,763,149,151,10,8,781,5132,,IT,IT_52,15,114,0,2,537,763
2020-03-16,Toscana,175,107,282,559,841,78,85,11,14,866,5910,,IT,IT_52,0,78,1,6,778,841
2020-03-17,Toscana,329,143,472,552,1024,183,187,12,17,1053,6727,,IT,IT_52,154,-7,1,3,817,1024
2020-03-18,Toscana,427,160,587,704,1291,267,277,17,22,1330,7606,,IT,IT_52,98,152,5,5,879,1291
2020-03-19,Toscana,501,178,679,743,1422,131,152,22,38,1482,8873,,IT,IT_52,74,39,5,16,1267,1422
2020-03-20,Toscana,601,189,790,923,1713,291,311,33,47,1793,10405,,IT,IT_52,100,180,11,9,1532,1713
2020-03-21,Toscana,664,202,866,1039,1905,192,219,35,72,2012,11909,,IT,IT_52,63,116,2,25,1504,1905
2020-03-22,Toscana,706,215,921,1223,2144,239,265,42,91,2277,13264,,IT,IT_52,42,184,7,19,1355,2144
2020-03-23,Toscana,838,238,1076,1225,2301,157,184,51,109,2461,13851,,IT,IT_52,132,2,9,18,587,2301
2020-03-24,Toscana,918,244,1162,1357,2519,218,238,51,129,2699,15701,,IT,IT_52,80,132,0,20,1850,2519
2020-03-25,Toscana,999,251,1250,1526,2776,257,273,54,142,2972,17868,,IT,IT_52,81,169,3,13,2167,2776
2020-03-26,Toscana,1037,259,1296,1677,2973,197,254,95,158,3226,20952,,IT,IT_52,38,151,41,16,3084,2973
2020-03-27,Toscana,1053,274,1327,1843,3170,197,224,103,177,3450,23746,,IT,IT_52,16,166,8,19,2794,3170
2020-03-28,Toscana,1093,277,1370,2141,3511,341,367,108,198,3817,25613,,IT,IT_52,40,298,5,21,1867,3511
2020-03-29,Toscana,1111,275,1386,2400,3786,275,305,121,215,4122,27579,,IT,IT_52,18,259,13,17,1966,3786
2020-03-30,Toscana,1116,279,1395,2655,4050,264,290,131,231,4412,30099,,IT,IT_52,5,255,10,16,2520,4050
2020-03-31,Toscana,1120,293,1413,2813,4226,176,196,138,244,4608,33165,,IT,IT_52,4,158,7,13,3066,4226
2020-04-01,Toscana,1120,297,1417,3015,4432,206,259,182,253,4867,36575,,IT,IT_52,0,202,44,9,3410,4432
2020-04-02,Toscana,1135,295,1430,3359,4789,357,406,216,268,5273,40724,,IT,IT_52,15,344,34,15,4149,4789
2020-04-03,Toscana,1149,288,1437,3472,4909,120,226,300,290,5499,44460,,IT,IT_52,14,113,84,22,3736,4909
2020-04-04,Toscana,1129,286,1415,3639,5054,145,172,310,307,5671,47886,,IT,IT_52,-20,167,10,17,3426,5054
2020-04-05,Toscana,1111,276,1387,3798,5185,131,176,337,325,5847,51006,,IT,IT_52,-18,159,27,18,3120,5185
2020-04-06,Toscana,1116,279,1395,3906,5301,116,154,350,350,6001,52849,,IT,IT_52,5,108,13,25,1843,5301
2020-04-07,Toscana,1087,263,1350,4077,5427,126,172,377,369,6173,56651,,IT,IT_52,-29,171,27,19,3802,5427
2020-04-08,Toscana,1066,260,1326,4231,5557,130,206,430,392,6379,60985,,IT,IT_52,-21,154,53,23,4334,5557
2020-04-09,Toscana,1038,256,1294,4409,5703,146,173,441,408,6552,65461,,IT,IT_52,-28,178,11,16,4476,5703
2020-04-10,Toscana,1011,256,1267,4555,5822,119,175,451,454,6727,72001,,IT,IT_52,-27,146,10,46,6540,5822
2020-04-11,Toscana,997,237,1234,4758,5992,170,231,499,467,6958,75756,,IT,IT_52,-14,203,48,13,3755,5992
2020-04-12,Toscana,983,238,1221,4941,6162,170,277,578,495,7235,78640,,IT,IT_52,-14,183,79,28,2884,6162
2020-04-13,Toscana,992,225,1217,5040,6257,95,155,615,518,7390,80889,,IT,IT_52,9,99,37,23,2249,6257
2020-04-14,Toscana,1002,225,1227,5125,6352,95,137,637,538,7527,82269,,IT,IT_52,10,85,22,20,1380,6352
2020-04-15,Toscana,977,216,1193,5224,6417,65,139,693,556,7666,86348,,IT,IT_52,-25,99,56,18,4079,6417
2020-04-16,Toscana,940,213,1153,5460,6613,196,277,745,585,7943,91651,,IT,IT_52,-37,236,52,29,5303,6613
2020-04-17,Toscana,898,207,1105,5478,6583,-30,167,925,602,8110,96231,,IT,IT_52,-42,18,180,17,4580,6583
2020-04-18,Toscana,883,198,1081,5389,6470,-113,127,1149,618,8237,99903,,IT,IT_52,-15,-89,224,16,3672,6470
2020-04-19,Toscana,852,192,1044,5452,6496,26,135,1239,637,8372,103975,84620,IT,IT_52,-31,63,90,19,4072,6496
2020-04-20,Toscana,850,182,1032,5536,6568,72,135,1272,667,8507,105857,85946,IT,IT_52,-2,84,33,30,1882,6568
2020-04-21,Toscana,833,171,1004,5618,6622,54,96,1295,686,8603,109925,87717,IT,IT_52,-17,82,23,19,4068,6622
2020-04-22,Toscana,820,174,994,5173,6167,-455,97,1828,705,8700,114100,91747,IT,IT_52,-13,-445,533,19,4175,6167
2020-04-23,Toscana,791,168,959,5212,6171,4,80,1886,723,8780,118177,94426,IT,IT_52,-29,39,58,18,4077,6171
2020-04-24,Toscana,738,159,897,5236,6133,-38,97,2002,742,8877,121336,96180,IT,IT_52,-53,24,116,19,3159,6133
2020-04-25,Toscana,687,166,853,5293,6146,13,138,2109,760,9015,125495,98753,IT,IT_52,-51,57,107,18,4159,6146
2020-04-26,Toscana,677,158,835,5234,6069,-77,132,2300,778,9147,127394,99751,IT,IT_52,-10,-59,191,18,1899,6069
2020-04-27,Toscana,671,154,825,5158,5983,-86,32,2401,795,9179,129048,100869,IT,IT_52,-6,-76,101,17,1654,5983
2020-04-28,Toscana,619,144,763,5133,5896,-87,52,2524,811,9231,133617,103891,IT,IT_52,-52,-25,123,16,4569,5896
2020-04-29,Toscana,576,139,715,4948,5663,-233,61,2802,827,9292,137482,106150,IT,IT_52,-43,-185,278,16,3865,5663
2020-04-30,Toscana,546,126,672,4912,5584,-79,60,2926,842,9352,141849,108596,IT,IT_52,-30,-36,124,15,4367,5584
2020-05-01,Toscana,520,124,644,4729,5373,-211,93,3218,854,9445,146456,111349,IT,IT_52,-26,-183,292,12,4607,5373
2020-05-02,Toscana,519,118,637,4728,5365,-8,80,3297,863,9525,148223,112437,IT,IT_52,-1,-1,79,9,1767,5365
2020-05-03,Toscana,513,112,625,4703,5328,-37,38,3363,872,9563,150914,114354,IT,IT_52,-6,-25,66,9,2691,5328
2020-05-04,Toscana,512,107,619,4660,5279,-49,38,3441,881,9601,152447,115065,IT,IT_52,-1,-43,78,9,1533,5279
2020-05-05,Toscana,484,111,595,4595,5190,-89,30,3552,889,9631,157260,118265,IT,IT_52,-28,-65,111,8,4813,5190
2020-05-06,Toscana,462,92,554,4534,5088,-102,26,3670,899,9657,161553,121066,IT,IT_52,-22,-61,118,10,4293,5088
2020-05-07,Toscana,437,91,528,4188,4716,-372,26,4052,915,9683,166062,124295,IT,IT_52,-25,-346,382,16,4509,4716
2020-05-08,Toscana,399,84,483,4109,4592,-124,38,4199,930,9721,170296,126752,IT,IT_52,-38,-79,147,15,4234,4592
2020-05-09,Toscana,364,79,443,4005,4448,-144,24,4360,937,9745,174596,129382,IT,IT_52,-35,-104,161,7,4300,4448
2020-05-10,Toscana,350,78,428,3719,4147,-301,29,4685,942,9774,178208,131788,IT,IT_52,-14,-286,325,5,3612,4147
2020-05-11,Toscana,347,77,424,3649,4073,-74,13,4764,950,9787,179469,132464,IT,IT_52,-3,-70,79,8,1261,4073
2020-05-12,Toscana,307,72,379,3462,3841,-232,15,5002,959,9802,184851,136285,IT,IT_52,-40,-187,238,9,5382,3841
2020-05-13,Toscana,284,72,356,3207,3563,-278,27,5302,964,9829,189026,138465,IT,IT_52,-23,-255,300,5,4175,3563
2020-05-14,Toscana,269,68,337,3051,3388,-175,30,5498,973,9859,193182,141430,IT,IT_52,-15,-156,196,9,4156,3388
2020-05-15,Toscana,238,67,305,2863,3168,-220,24,5739,976,9883,197365,144237,IT,IT_52,-31,-188,241,3,4183,3168
2020-05-16,Toscana,234,66,300,2643,2943,-225,30,5991,979,9913,200703,145946,IT,IT_52,-4,-220,252,3,3338,2943
2020-05-17,Toscana,214,67,281,2521,2802,-141,35,6162,984,9948,204022,148060,IT,IT_52,-20,-122,171,5,3319,2802
2020-05-18,Toscana,197,66,263,2310,2573,-229,13,6399,989,9961,205201,148580,IT,IT_52,-17,-211,237,5,1179,2573
2020-05-19,Toscana,190,56,246,2077,2323,-250,7,6653,992,9968,209161,151093,IT,IT_52,-7,-233,254,3,3960,2323
2020-05-20,Toscana,178,45,223,1894,2117,-206,14,6867,998,9982,214299,154671,IT,IT_52,-12,-183,214,6,5138,2117
2020-05-21,Toscana,169,41,210,1667,1877,-240,18,7119,1004,10000,218615,157388,IT,IT_52,-9,-227,252,6,4316,1877
2020-05-22,Toscana,162,42,204,1582,1786,-91,35,7240,1009,10035,222505,160266,IT,IT_52,-7,-85,121,5,3890,1786
2020-05-23,Toscana,157,40,197,1569,1766,-20,12,7270,1011,10047,226046,162433,IT,IT_52,-5,-13,30,2,3541,1766
2020-05-24,Toscana,148,38,186,1514,1700,-66,15,7349,1013,10062,229135,164469,IT,IT_52,-9,-55,79,2,3089,1700
2020-05-25,Toscana,152,37,189,1447,1636,-64,5,7416,1015,10067,230273,165114,IT,IT_52,4,-67,67,2,1138,1636
2020-05-26,Toscana,145,34,179,1343,1522,-114,3,7527,1021,10070,234796,168150,IT,IT_52,-7,-104,111,6,4523,1522
2020-05-27,Toscana,132,31,163,1297,1460,-62,12,7595,1027,10082,238667,170802,IT,IT_52,-13,-46,68,6,3871,1460
2020-05-28,Toscana,126,27,153,1227,1380,-80,4,7677,1029,10086,242687,173406,IT,IT_52,-6,-70,82,2,4020,1380
2020-05-29,Toscana,111,31,142,1113,1255,-125,2,7802,1031,10088,246052,175489,IT,IT_52,-15,-114,125,2,3365,1255
2020-05-30,Toscana,106,27,133,1033,1166,-89,12,7897,1037,10100,249441,177686,IT,IT_52,-5,-80,95,6,3389,1166
2020-05-31,Toscana,97,28,125,986,1111,-55,4,7952,1041,10104,252090,179296,IT,IT_52,-9,-47,55,4,2649,1111
2020-06-01,Toscana,85,25,110,972,1082,-29,3,7977,1048,10107,253845,180233,IT,IT_52,-12,-14,25,7,1755,1082
2020-06-02,Toscana,85,25,110,901,1011,-71,10,8053,1053,10117,257178,182335,IT,IT_52,0,-71,76,5,3333,1011
2020-06-03,Toscana,76,25,101,872,973,-38,4,8093,1055,10121,259167,183229,IT,IT_52,-9,-29,40,2,1989,973
2020-06-04,Toscana,65,24,89,794,883,-90,1,8180,1059,10122,262762,186632,IT,IT_52,-11,-78,87,4,3595,883
2020-06-05,Toscana,55,23,78,779,857,-26,7,8209,1063,10129,266508,188882,IT,IT_52,-10,-15,29,4,3746,857
2020-06-06,Toscana,49,22,71,714,785,-72,5,8281,1068,10134,269298,190860,IT,IT_52,-6,-65,72,5,2790,785
2020-06-07,Toscana,52,20,72,678,750,-35,1,8315,1070,10135,272106,192675,IT,IT_52,3,-36,34,2,2808,750
2020-06-08,Toscana,50,20,70,651,721,-29,9,8349,1074,10144,273706,193737,IT,IT_52,-2,-27,34,4,1600,721
2020-06-09,Toscana,46,17,63,565,628,-93,1,8440,1077,10145,277092,195695,IT,IT_52,-4,-86,91,3,3386,628
2020-06-10,Toscana,40,15,55,484,539,-89,3,8531,1078,10148,280491,198466,IT,IT_52,-6,-81,91,1,3399,539
2020-06-11,Toscana,42,15,57,464,521,-18,10,8558,1079,10158,283638,200500,IT,IT_52,2,-20,27,1,3147,521
2020-06-12,Toscana,36,14,50,460,510,-11,7,8575,1080,10165,286693,202577,IT,IT_52,-6,-4,17,1,3055,510
2020-06-13,Toscana,33,16,49,453,502,-8,7,8588,1082,10172,289524,204513,IT,IT_52,-3,-7,13,2,2831,502
2020-06-14,Toscana,34,16,50,449,499,-3,8,8596,1085,10180,292101,206348,IT,IT_52,1,-4,8,3,2577,499
2020-06-15,Toscana,31,16,47,442,489,-10,8,8611,1088,10188,293683,207371,IT,IT_52,-3,-7,15,3,1582,489
2020-06-16,Toscana,34,14,48,415,463,-26,3,8637,1091,10191,296812,209629,IT,IT_52,3,-27,26,3,3129,463
2020-06-17,Toscana,33,14,47,397,444,-19,2,8657,1092,10193,300612,212090,IT,IT_52,-1,-18,20,1,3800,444
2020-06-18,Toscana,23,13,36,402,438,-6,2,8664,1093,10195,303786,213644,IT,IT_52,-10,5,7,1,3174,438
2020-06-19,Toscana,18,12,30,393,423,-15,10,8687,1095,10205,306489,214853,IT,IT_52,-5,-9,23,2,2703,423
2020-06-20,Toscana,19,12,31,383,414,-9,2,8698,1095,10207,309250,215914,IT,IT_52,1,-10,11,0,2761,414
2020-02-24,P.A. Trento,0,0,0,0,0,0,0,0,0,0,3,,IT,IT_TN,,,,,,0
2020-02-25,P.A. Trento,0,0,0,0,0,0,0,0,0,0,3,,IT,IT_TN,0,0,0,0,0,0
2020-02-26,P.A. Trento,0,0,0,0,0,0,0,0,0,0,3,,IT,IT_TN,0,0,0,0,0,0
2020-02-27,P.A. Trento,0,0,0,0,0,0,0,0,0,0,32,,IT,IT_TN,0,0,0,0,29,0
2020-02-28,P.A. Trento,0,0,0,0,0,0,0,0,0,0,32,,IT,IT_TN,0,0,0,0,0,0
2020-02-29,P.A. Trento,0,0,0,0,0,0,0,0,0,0,43,,IT,IT_TN,0,0,0,0,11,0
2020-03-01,P.A. Trento,0,0,0,0,0,0,0,0,0,0,122,,IT,IT_TN,0,0,0,0,79,0
2020-03-02,P.A. Trento,0,0,0,0,0,0,0,0,0,0,122,,IT,IT_TN,0,0,0,0,0,0
2020-03-03,P.A. Trento,1,0,1,3,4,4,4,0,0,4,122,,IT,IT_TN,1,3,0,0,0,4
2020-03-04,P.A. Trento,1,0,1,4,5,1,1,0,0,5,122,,IT,IT_TN,0,1,0,0,0,5
2020-03-05,P.A. Trento,2,0,2,5,7,2,2,0,0,7,122,,IT,IT_TN,1,1,0,0,0,7
2020-03-06,P.A. Trento,4,0,4,6,10,3,3,0,0,10,122,,IT,IT_TN,2,1,0,0,0,10
2020-03-07,P.A. Trento,6,1,7,7,14,4,4,0,0,14,194,,IT,IT_TN,2,1,0,0,72,14
2020-03-08,P.A. Trento,7,2,9,14,23,9,9,0,0,23,228,,IT,IT_TN,1,7,0,0,34,23
2020-03-09,P.A. Trento,10,2,12,21,33,10,10,0,0,33,267,,IT,IT_TN,3,7,0,0,39,33
2020-03-10,P.A. Trento,19,3,22,28,50,17,19,2,0,52,399,,IT,IT_TN,9,7,2,0,132,50
2020-03-11,P.A. Trento,28,4,32,42,74,24,25,3,0,77,527,,IT,IT_TN,9,14,1,0,128,74
2020-03-12,P.A. Trento,43,5,48,54,102,28,30,4,1,107,593,,IT,IT_TN,15,12,1,1,66,102
2020-03-13,P.A. Trento,58,6,64,93,157,55,56,4,2,163,846,,IT,IT_TN,15,39,0,1,253,157
2020-03-14,P.A. Trento,68,12,80,119,199,42,43,5,2,206,1006,,IT,IT_TN,10,26,1,0,160,199
2020-03-15,P.A. Trento,73,19,92,275,367,168,172,5,6,378,1006,,IT,IT_TN,5,156,0,4,0,367
2020-03-16,P.A. Trento,73,19,92,275,367,0,0,5,6,378,1006,,IT,IT_TN,0,0,0,0,0,367
2020-03-17,P.A. Trento,107,22,129,239,368,1,7,10,7,385,1727,,IT,IT_TN,34,-36,5,1,721,368
2020-03-18,P.A. Trento,141,22,163,273,436,68,70,12,7,455,2187,,IT,IT_TN,34,34,2,0,460,436
2020-03-19,P.A. Trento,169,30,199,292,491,55,68,20,12,523,2203,,IT,IT_TN,28,19,8,5,16,491
2020-03-20,P.A. Trento,198,34,232,368,600,109,119,29,13,642,2656,,IT,IT_TN,29,76,9,1,453,600
2020-03-21,P.A. Trento,233,39,272,448,720,120,140,34,28,782,2656,,IT,IT_TN,35,80,5,15,0,720
2020-03-22,P.A. Trento,235,46,281,604,885,165,172,34,35,954,3050,,IT,IT_TN,2,156,0,7,394,885
2020-03-23,P.A. Trento,249,46,295,619,914,29,69,68,41,1023,3150,,IT,IT_TN,14,15,34,6,100,914
2020-03-24,P.A. Trento,308,49,357,618,975,61,87,79,56,1110,3712,,IT,IT_TN,59,-1,11,15,562,975
2020-03-25,P.A. Trento,308,65,373,685,1058,83,112,90,74,1222,4114,,IT,IT_TN,0,67,11,18,402,1058
2020-03-26,P.A. Trento,300,66,366,728,1094,36,75,117,86,1297,4600,,IT,IT_TN,-8,43,27,12,486,1094
2020-03-27,P.A. Trento,341,66,407,757,1164,70,94,125,102,1391,4923,,IT,IT_TN,41,29,8,16,323,1164
2020-03-28,P.A. Trento,351,72,423,811,1234,70,114,151,120,1505,5561,,IT,IT_TN,10,54,26,18,638,1234
2020-03-29,P.A. Trento,356,75,431,862,1293,59,89,172,129,1594,5950,,IT,IT_TN,5,51,21,9,389,1293
2020-03-30,P.A. Trento,353,78,431,926,1357,64,88,178,147,1682,6377,,IT,IT_TN,-3,64,6,18,427,1357
2020-03-31,P.A. Trento,354,80,434,955,1389,32,64,193,164,1746,6973,,IT,IT_TN,1,29,15,17,596,1389
2020-04-01,P.A. Trento,345,76,421,1062,1483,94,124,214,173,1870,7675,,IT,IT_TN,-9,107,21,9,702,1483
2020-04-02,P.A. Trento,339,78,417,1170,1587,104,133,229,187,2003,8496,,IT,IT_TN,-6,108,15,14,821,1587
2020-04-03,P.A. Trento,343,80,423,1236,1659,72,106,246,204,2109,8993,,IT,IT_TN,4,66,17,17,497,1659
2020-04-04,P.A. Trento,353,81,434,1319,1753,94,111,257,210,2220,9863,,IT,IT_TN,10,83,11,6,870,1753
2020-04-05,P.A. Trento,352,80,432,1363,1795,42,65,273,217,2285,10476,,IT,IT_TN,-1,44,16,7,613,1795
2020-04-06,P.A. Trento,354,79,433,1405,1838,43,63,280,230,2348,11130,,IT,IT_TN,2,42,7,13,654,1838
2020-04-07,P.A. Trento,360,78,438,1452,1890,52,128,342,244,2476,12030,,IT,IT_TN,6,47,62,14,900,1890
2020-04-08,P.A. Trento,354,77,431,1509,1940,50,126,407,255,2602,13258,,IT,IT_TN,-6,57,65,11,1228,1940
2020-04-09,P.A. Trento,345,69,414,1564,1978,38,106,462,268,2708,14338,,IT,IT_TN,-9,55,55,13,1080,1978
2020-04-10,P.A. Trento,335,70,405,1589,1994,16,108,547,275,2816,14981,,IT,IT_TN,-10,25,85,7,643,1994
2020-04-11,P.A. Trento,335,62,397,1667,2064,70,154,622,284,2970,16646,,IT,IT_TN,0,78,75,9,1665,2064
2020-04-12,P.A. Trento,322,61,383,1699,2082,18,83,678,293,3053,17797,,IT,IT_TN,-13,32,56,9,1151,2082
2020-04-13,P.A. Trento,326,56,382,1698,2080,-2,73,746,300,3126,18586,,IT,IT_TN,4,-1,68,7,789,2080
2020-04-14,P.A. Trento,325,54,379,1703,2082,2,15,749,310,3141,18774,,IT,IT_TN,-1,5,3,10,188,2082
2020-04-15,P.A. Trento,312,48,360,1744,2104,22,79,798,318,3220,19535,,IT,IT_TN,-13,41,49,8,761,2104
2020-04-16,P.A. Trento,296,43,339,1748,2087,-17,74,885,322,3294,20773,,IT,IT_TN,-16,4,87,4,1238,2087
2020-04-17,P.A. Trento,286,44,330,1660,1990,-97,82,1044,342,3376,21921,,IT,IT_TN,-10,-88,159,20,1148,1990
2020-04-18,P.A. Trento,276,42,318,1667,1985,-5,55,1098,348,3431,23147,,IT,IT_TN,-10,7,54,6,1226,1985
2020-04-19,P.A. Trento,278,41,319,1652,1971,-14,101,1201,360,3532,24388,16685,IT,IT_TN,2,-15,103,12,1241,1971
2020-04-20,P.A. Trento,272,40,312,1617,1929,-42,58,1295,366,3590,26211,17347,IT,IT_TN,-6,-35,94,6,1823,1929
2020-04-21,P.A. Trento,254,38,292,1617,1909,-20,24,1329,376,3614,26610,17705,IT,IT_TN,-18,0,34,10,399,1909
2020-04-22,P.A. Trento,245,34,279,1595,1874,-35,32,1391,381,3646,26674,17672,IT,IT_TN,-9,-22,62,5,64,1874
2020-04-23,P.A. Trento,234,29,263,1608,1871,-3,81,1474,382,3727,28240,18656,IT,IT_TN,-11,13,83,1,1566,1871
2020-04-24,P.A. Trento,224,28,252,1575,1827,-44,49,1560,389,3776,29779,19250,IT,IT_TN,-10,-33,86,7,1539,1827
2020-04-25,P.A. Trento,202,27,229,1515,1744,-83,62,1694,400,3838,30661,19394,IT,IT_TN,-22,-60,134,11,882,1744
2020-04-26,P.A. Trento,199,24,223,1459,1682,-62,56,1807,405,3894,32142,19902,IT,IT_TN,-3,-56,113,5,1481,1682
2020-04-27,P.A. Trento,201,23,224,1483,1707,25,101,1881,407,3995,33152,20199,IT,IT_TN,2,24,74,2,1010,1707
2020-04-28,P.A. Trento,182,22,204,1361,1565,-142,30,2048,412,4025,33839,20539,IT,IT_TN,-19,-122,167,5,687,1565
2020-04-29,P.A. Trento,165,22,187,1276,1463,-102,44,2190,416,4069,35008,20944,IT,IT_TN,-17,-85,142,4,1169,1463
2020-04-30,P.A. Trento,158,21,179,1191,1370,-93,47,2328,418,4116,36534,21622,IT,IT_TN,-7,-85,138,2,1526,1370
2020-05-01,P.A. Trento,146,19,165,1128,1293,-77,16,2416,423,4132,37838,22602,IT,IT_TN,-12,-63,88,5,1304,1293
2020-05-02,P.A. Trento,138,19,157,1125,1282,-11,49,2474,425,4181,39579,23380,IT,IT_TN,-8,-3,58,2,1741,1282
2020-05-03,P.A. Trento,136,17,153,1094,1247,-35,66,2571,429,4247,41095,24085,IT,IT_TN,-2,-31,97,4,1516,1247
2020-05-04,P.A. Trento,135,17,152,1013,1165,-82,11,2663,430,4258,42061,24500,IT,IT_TN,-1,-81,92,1,966,1165
2020-05-05,P.A. Trento,126,15,141,900,1041,-124,3,2787,433,4261,42870,25137,IT,IT_TN,-9,-113,124,3,809,1041
2020-05-06,P.A. Trento,116,13,129,853,982,-59,19,2861,437,4280,44719,26161,IT,IT_TN,-10,-47,74,4,1849,982
2020-05-07,P.A. Trento,99,11,110,800,910,-72,3,2935,438,4283,46500,28486,IT,IT_TN,-17,-53,74,1,1781,910
2020-05-08,P.A. Trento,94,11,105,767,872,-38,2,2975,438,4285,48220,29188,IT,IT_TN,-5,-33,40,0,1720,872
2020-05-09,P.A. Trento,87,10,97,733,830,-42,7,3024,438,4292,50278,30354,IT,IT_TN,-7,-34,49,0,2058,830
2020-05-10,P.A. Trento,82,10,92,694,786,-44,3,3068,441,4295,52039,30808,IT,IT_TN,-5,-39,44,3,1761,786
2020-05-11,P.A. Trento,84,11,95,640,735,-51,2,3119,443,4297,53398,31970,IT,IT_TN,2,-54,51,2,1359,735
2020-05-12,P.A. Trento,80,9,89,578,667,-68,6,3191,445,4303,55334,33082,IT,IT_TN,-4,-62,72,2,1936,667
2020-05-13,P.A. Trento,76,9,85,488,573,-94,9,3293,446,4312,57997,34662,IT,IT_TN,-4,-90,102,1,2663,573
2020-05-14,P.A. Trento,66,9,75,430,505,-68,3,3362,448,4315,60843,36359,IT,IT_TN,-10,-58,69,2,2846,505
2020-05-15,P.A. Trento,53,9,62,344,406,-99,3,3461,451,4318,63700,38273,IT,IT_TN,-13,-86,99,3,2857,406
2020-05-16,P.A. Trento,44,8,52,293,345,-61,8,3528,453,4326,65383,39613,IT,IT_TN,-9,-51,67,2,1683,345
2020-05-17,P.A. Trento,41,8,49,252,301,-44,12,3584,453,4338,69659,41383,IT,IT_TN,-3,-41,56,0,4276,301
2020-05-18,P.A. Trento,41,8,49,199,248,-53,13,3650,453,4351,70173,41383,IT,IT_TN,0,-53,66,0,514,248
2020-05-19,P.A. Trento,42,8,50,154,204,-44,7,3699,455,4358,70691,42125,IT,IT_TN,1,-45,49,2,518,204
2020-05-20,P.A. Trento,39,6,45,81,126,-78,10,3787,455,4368,72031,42140,IT,IT_TN,-3,-73,88,0,1340,126
2020-05-21,P.A. Trento,40,6,46,20,66,-60,10,3857,455,4378,73849,42954,IT,IT_TN,1,-61,70,0,1818,66
2020-05-22,P.A. Trento,32,4,36,571,607,541,10,3326,455,4388,76001,43885,IT,IT_TN,-8,551,-531,0,2152,607
2020-05-23,P.A. Trento,28,4,32,533,565,-42,7,3374,456,4395,78185,45304,IT,IT_TN,-4,-38,48,1,2184,565
2020-05-24,P.A. Trento,27,4,31,504,535,-30,9,3412,457,4404,79788,45860,IT,IT_TN,-1,-29,38,1,1603,535
2020-05-25,P.A. Trento,27,4,31,486,517,-18,1,3430,458,4405,80454,45531,IT,IT_TN,0,-18,18,1,666,517
2020-05-26,P.A. Trento,24,3,27,486,513,-4,10,3441,461,4415,81149,45926,IT,IT_TN,-3,0,11,3,695,513
2020-05-27,P.A. Trento,19,2,21,456,477,-36,7,3483,462,4422,82269,46350,IT,IT_TN,-5,-30,42,1,1120,477
2020-05-28,P.A. Trento,17,3,20,438,458,-19,3,3505,462,4425,83018,46735,IT,IT_TN,-2,-18,22,0,749,458
2020-05-29,P.A. Trento,16,3,19,391,410,-48,3,3556,462,4428,84805,47349,IT,IT_TN,-1,-47,51,0,1787,410
2020-05-30,P.A. Trento,13,3,16,350,366,-44,1,3601,462,4429,86565,47908,IT,IT_TN,-3,-41,45,0,1760,366
2020-05-31,P.A. Trento,13,3,16,288,304,-62,1,3664,462,4430,88558,48665,IT,IT_TN,0,-62,63,0,1993,304
2020-06-01,P.A. Trento,14,3,17,276,293,-11,2,3677,462,4432,89235,48853,IT,IT_TN,1,-12,13,0,677,293
2020-06-02,P.A. Trento,14,2,16,267,283,-10,0,3686,463,4432,89787,49173,IT,IT_TN,0,-9,9,1,552,283
2020-06-03,P.A. Trento,15,2,17,205,222,-61,1,3748,463,4433,91021,49626,IT,IT_TN,1,-62,62,0,1234,222
2020-06-04,P.A. Trento,14,1,15,192,207,-15,0,3762,464,4433,91631,49920,IT,IT_TN,-1,-13,14,1,610,207
2020-06-05,P.A. Trento,8,1,9,114,123,-84,0,3846,464,4433,92916,50312,IT,IT_TN,-6,-78,84,0,1285,123
2020-06-06,P.A. Trento,6,1,7,97,104,-19,1,3866,464,4434,94159,50758,IT,IT_TN,-2,-17,20,0,1243,104
2020-06-07,P.A. Trento,6,1,7,75,82,-22,1,3889,464,4435,95638,51385,IT,IT_TN,0,-22,23,0,1479,82
2020-06-08,P.A. Trento,7,1,8,73,81,-1,1,3891,464,4436,95825,51453,IT,IT_TN,1,-2,2,0,187,81
2020-06-09,P.A. Trento,6,1,7,74,81,0,3,3894,464,4439,96527,51934,IT,IT_TN,-1,1,3,0,702,81
2020-06-10,P.A. Trento,6,1,7,73,80,-1,0,3895,464,4439,97739,52412,IT,IT_TN,0,-1,1,0,1212,80
2020-06-11,P.A. Trento,5,1,6,65,71,-9,2,3906,464,4441,98969,52795,IT,IT_TN,-1,-8,11,0,1230,71
2020-06-12,P.A. Trento,5,1,6,62,68,-3,2,3911,464,4443,100400,53453,IT,IT_TN,0,-3,5,0,1431,68
2020-06-13,P.A. Trento,5,1,6,64,70,2,3,3912,464,4446,102138,54175,IT,IT_TN,0,2,1,0,1738,70
2020-06-14,P.A. Trento,5,1,6,60,66,-4,1,3917,464,4447,103910,55054,IT,IT_TN,0,-4,5,0,1772,66
2020-06-15,P.A. Trento,5,0,5,61,66,0,1,3917,465,4448,104306,55322,IT,IT_TN,0,1,0,1,396,66
2020-06-16,P.A. Trento,2,0,2,62,64,-2,0,3919,465,4448,104696,55530,IT,IT_TN,-3,1,2,0,390,64
2020-06-17,P.A. Trento,2,0,2,56,58,-6,1,3926,465,4449,105841,56032,IT,IT_TN,0,-6,7,0,1145,58
2020-06-18,P.A. Trento,2,0,2,57,59,1,8,3933,465,4457,107366,56609,IT,IT_TN,0,1,7,0,1525,59
2020-06-19,P.A. Trento,2,0,2,54,56,-3,1,3936,466,4458,108564,57050,IT,IT_TN,0,-3,3,1,1198,56
2020-06-20,P.A. Trento,1,0,1,50,51,-5,0,3941,466,4458,110268,57678,IT,IT_TN,-1,-4,5,0,1704,51
2020-02-24,Umbria,0,0,0,0,0,0,0,0,0,0,0,,IT,IT_55,,,,,,0
2020-02-25,Umbria,0,0,0,0,0,0,0,0,0,0,8,,IT,IT_55,0,0,0,0,8,0
2020-02-26,Umbria,0,0,0,0,0,0,0,0,0,0,8,,IT,IT_55,0,0,0,0,0,0
2020-02-27,Umbria,0,0,0,0,0,0,0,0,0,0,8,,IT,IT_55,0,0,0,0,0,0
2020-02-28,Umbria,0,0,0,0,0,0,0,0,0,0,8,,IT,IT_55,0,0,0,0,0,0
2020-02-29,Umbria,0,0,0,0,0,0,0,0,0,0,31,,IT,IT_55,0,0,0,0,23,0
2020-03-01,Umbria,0,0,0,2,2,2,2,0,0,2,35,,IT,IT_55,0,2,0,0,4,2
2020-03-02,Umbria,0,0,0,2,2,0,0,0,0,2,35,,IT,IT_55,0,0,0,0,0,2
2020-03-03,Umbria,1,1,2,6,8,6,6,0,0,8,45,,IT,IT_55,1,4,0,0,10,8
2020-03-04,Umbria,1,1,2,7,9,1,1,0,0,9,58,,IT,IT_55,0,1,0,0,13,9
2020-03-05,Umbria,1,1,2,7,9,0,0,0,0,9,88,,IT,IT_55,0,0,0,0,30,9
2020-03-06,Umbria,2,2,4,12,16,7,7,0,0,16,110,,IT,IT_55,1,5,0,0,22,16
2020-03-07,Umbria,2,2,4,20,24,8,8,0,0,24,134,,IT,IT_55,0,8,0,0,24,24
2020-03-08,Umbria,2,2,4,22,26,2,2,0,0,26,168,,IT,IT_55,0,2,0,0,34,26
2020-03-09,Umbria,4,2,6,22,28,2,2,0,0,28,183,,IT,IT_55,2,0,0,0,15,28
2020-03-10,Umbria,8,2,10,27,37,9,9,0,0,37,260,,IT,IT_55,4,5,0,0,77,37
2020-03-11,Umbria,7,5,12,32,44,7,9,2,0,46,340,,IT,IT_55,-1,5,2,0,80,44
2020-03-12,Umbria,8,8,16,46,62,18,18,2,0,64,458,,IT,IT_55,1,14,0,0,118,62
2020-03-13,Umbria,11,10,21,52,73,11,12,2,1,76,576,,IT,IT_55,3,6,0,1,118,73
2020-03-14,Umbria,21,11,32,71,103,30,31,3,1,107,748,,IT,IT_55,10,19,1,0,172,103
2020-03-15,Umbria,25,13,38,101,139,36,36,3,1,143,965,,IT,IT_55,4,30,0,0,217,139
2020-03-16,Umbria,30,15,45,114,159,20,21,4,1,164,1093,,IT,IT_55,5,13,1,0,128,159
2020-03-17,Umbria,36,21,57,135,192,33,33,4,1,197,1323,,IT,IT_55,6,21,0,0,230,192
2020-03-18,Umbria,54,21,75,166,241,49,50,4,2,247,1601,,IT,IT_55,18,31,0,1,278,241
2020-03-19,Umbria,69,21,90,238,328,87,87,4,2,334,1954,,IT,IT_55,15,72,0,0,353,328
2020-03-20,Umbria,75,24,99,285,384,56,61,4,7,395,2303,,IT,IT_55,6,47,0,5,349,384
2020-03-21,Umbria,92,29,121,326,447,63,67,5,10,462,2712,,IT,IT_55,17,41,1,3,409,447
2020-03-22,Umbria,97,35,132,368,500,53,59,5,16,521,3135,,IT,IT_55,5,42,0,6,423,500
2020-03-23,Umbria,106,42,148,408,556,56,56,5,16,577,3561,,IT,IT_55,9,40,0,0,426,556
2020-03-24,Umbria,105,43,148,476,624,68,71,5,19,648,4108,,IT,IT_55,-1,68,0,3,547,624
2020-03-25,Umbria,123,44,167,519,686,62,62,5,19,710,4707,,IT,IT_55,18,43,0,0,599,686
2020-03-26,Umbria,144,46,190,580,770,84,92,12,20,802,5428,,IT,IT_55,21,61,7,1,721,770
2020-03-27,Umbria,149,46,195,629,824,54,82,39,21,884,6137,,IT,IT_55,5,49,27,1,709,824
2020-03-28,Umbria,159,44,203,695,898,74,85,43,28,969,7028,,IT,IT_55,10,66,4,7,891,898
2020-03-29,Umbria,166,46,212,685,897,-1,54,95,31,1023,7685,,IT,IT_55,7,-10,52,3,657,897
2020-03-30,Umbria,173,47,220,614,834,-63,28,184,33,1051,8150,,IT,IT_55,7,-71,89,2,465,834
2020-03-31,Umbria,176,43,219,632,851,17,27,190,37,1078,8685,,IT,IT_55,3,18,6,4,535,851
2020-04-01,Umbria,173,45,218,646,864,13,17,194,37,1095,9080,,IT,IT_55,-3,14,4,0,395,864
2020-04-02,Umbria,171,47,218,667,885,21,33,205,38,1128,9737,,IT,IT_55,-2,21,11,1,657,885
2020-04-03,Umbria,165,48,213,707,920,35,51,220,39,1179,10614,,IT,IT_55,-6,40,15,1,877,920
2020-04-04,Umbria,167,44,211,716,927,7,31,242,41,1210,11809,,IT,IT_55,2,9,22,2,1195,927
2020-04-05,Umbria,159,45,204,694,898,-29,29,298,43,1239,12448,,IT,IT_55,-8,-22,56,2,639,898
2020-04-06,Umbria,159,46,205,667,872,-26,14,337,44,1253,12573,,IT,IT_55,0,-27,39,1,125,872
2020-04-07,Umbria,157,41,198,648,846,-26,10,368,49,1263,13274,,IT,IT_55,-2,-19,31,5,701,846
2020-04-08,Umbria,155,41,196,627,823,-23,26,416,50,1289,14105,,IT,IT_55,-2,-21,48,1,831,823
2020-04-09,Umbria,154,38,192,600,792,-31,9,455,51,1298,15170,,IT,IT_55,-1,-27,39,1,1065,792
2020-04-10,Umbria,146,39,185,567,752,-40,4,498,52,1302,16325,,IT,IT_55,-8,-33,43,1,1155,752
2020-04-11,Umbria,137,39,176,547,723,-29,7,534,52,1309,17661,,IT,IT_55,-9,-20,36,0,1336,723
2020-04-12,Umbria,129,39,168,519,687,-36,10,580,52,1319,18672,,IT,IT_55,-8,-28,46,0,1011,687
2020-04-13,Umbria,127,38,165,460,625,-62,1,643,52,1320,18740,,IT,IT_55,-2,-59,63,0,68,625
2020-04-14,Umbria,127,37,164,458,622,-3,1,646,53,1321,18956,,IT,IT_55,0,-2,3,1,216,622
2020-04-15,Umbria,122,37,159,423,582,-40,1,686,54,1322,20258,,IT,IT_55,-5,-35,40,1,1302,582
2020-04-16,Umbria,116,33,149,387,536,-46,7,738,55,1329,21487,,IT,IT_55,-6,-36,52,1,1229,536
2020-04-17,Umbria,111,31,142,352,494,-42,8,786,57,1337,22818,,IT,IT_55,-5,-35,48,2,1331,494
2020-04-18,Umbria,109,32,141,290,431,-63,7,856,57,1344,24106,,IT,IT_55,-2,-62,70,0,1288,431
2020-04-19,Umbria,108,30,138,298,436,5,4,854,58,1348,25170,16790,IT,IT_55,-1,8,-2,1,1064,436
2020-04-20,Umbria,113,29,142,282,424,-12,1,867,58,1349,25562,17099,IT,IT_55,5,-16,13,0,392,424
2020-04-21,Umbria,107,22,129,278,407,-17,4,886,60,1353,26639,17873,IT,IT_55,-6,-4,19,2,1077,407
2020-04-22,Umbria,97,20,117,254,371,-36,4,925,61,1357,27655,18679,IT,IT_55,-10,-24,39,1,1016,371
2020-04-23,Umbria,100,19,119,236,355,-16,5,946,61,1362,29011,19627,IT,IT_55,3,-18,21,0,1356,355
2020-04-24,Umbria,94,19,113,209,322,-33,1,979,62,1363,30524,20733,IT,IT_55,-6,-27,33,1,1513,322
2020-04-25,Umbria,95,18,113,184,297,-25,3,1006,63,1366,31939,21842,IT,IT_55,1,-25,27,1,1415,297
2020-04-26,Umbria,91,17,108,188,296,-1,2,1008,64,1368,32569,22320,IT,IT_55,-4,4,2,1,630,296
2020-04-27,Umbria,90,16,106,181,287,-9,2,1018,65,1370,32823,22492,IT,IT_55,-1,-7,10,1,254,287
2020-04-28,Umbria,80,17,97,178,275,-12,9,1039,65,1379,33881,23263,IT,IT_55,-10,-3,21,0,1058,275
2020-04-29,Umbria,77,16,93,168,261,-14,12,1064,66,1391,34937,24079,IT,IT_55,-3,-10,25,1,1056,261
2020-04-30,Umbria,68,16,84,149,233,-28,1,1092,67,1392,36459,25317,IT,IT_55,-9,-19,28,1,1522,233
2020-05-01,Umbria,60,13,73,131,204,-29,1,1121,68,1393,37762,26285,IT,IT_55,-8,-18,29,1,1303,204
2020-05-02,Umbria,60,13,73,123,196,-8,1,1130,68,1394,38072,26463,IT,IT_55,0,-8,9,0,310,196
2020-05-03,Umbria,58,13,71,112,183,-13,0,1143,68,1394,38823,26973,IT,IT_55,-2,-11,13,0,751,183
2020-05-04,Umbria,56,13,69,112,181,-2,0,1143,70,1394,39044,27152,IT,IT_55,-2,0,0,2,221,181
2020-05-05,Umbria,56,11,67,109,176,-5,6,1154,70,1400,39998,27822,IT,IT_55,0,-3,11,0,954,176
2020-05-06,Umbria,55,9,64,107,171,-5,4,1163,70,1404,41328,28712,IT,IT_55,-1,-2,9,0,1330,171
2020-05-07,Umbria,47,9,56,85,141,-30,1,1194,70,1405,42788,29708,IT,IT_55,-8,-22,31,0,1460,141
2020-05-08,Umbria,47,6,53,66,119,-22,1,1216,71,1406,44223,30704,IT,IT_55,0,-19,22,1,1435,119
2020-05-09,Umbria,45,6,51,60,111,-8,1,1225,71,1407,45574,31679,IT,IT_55,-2,-6,9,0,1351,111
2020-05-10,Umbria,42,6,48,65,113,2,4,1227,71,1411,46923,32713,IT,IT_55,-3,5,2,0,1349,113
2020-05-11,Umbria,40,4,44,64,108,-5,1,1233,71,1412,47474,33027,IT,IT_55,-2,-1,6,0,551,108
2020-05-12,Umbria,41,4,45,64,109,1,7,1239,71,1419,49249,34207,IT,IT_55,1,0,6,0,1775,109
2020-05-13,Umbria,36,4,40,66,106,-3,0,1241,72,1419,50731,35313,IT,IT_55,-5,2,2,1,1482,106
2020-05-14,Umbria,26,1,27,65,92,-14,1,1255,73,1420,52247,36495,IT,IT_55,-10,-1,14,1,1516,92
2020-05-15,Umbria,25,2,27,63,90,-2,2,1259,73,1422,53801,37660,IT,IT_55,-1,-2,4,0,1554,90
2020-05-16,Umbria,25,2,27,54,81,-9,0,1268,73,1422,55170,38663,IT,IT_55,0,-9,9,0,1369,81
2020-05-17,Umbria,25,2,27,51,78,-3,2,1273,73,1424,55956,39272,IT,IT_55,0,-3,5,0,786,78
2020-05-18,Umbria,24,2,26,51,77,-1,0,1274,73,1424,56279,39512,IT,IT_55,-1,0,1,0,323,77
2020-05-19,Umbria,25,2,27,39,66,-11,3,1287,74,1427,57822,40651,IT,IT_55,1,-12,13,1,1543,66
2020-05-20,Umbria,25,2,27,39,66,0,0,1287,74,1427,59220,41748,IT,IT_55,0,0,0,0,1398,66
2020-05-21,Umbria,17,2,19,42,61,-5,2,1294,74,1429,60471,42720,IT,IT_55,-8,3,7,0,1251,61
2020-05-22,Umbria,16,2,18,41,59,-2,0,1296,74,1429,61696,43686,IT,IT_55,-1,-1,2,0,1225,59
2020-05-23,Umbria,15,2,17,39,56,-3,1,1300,74,1430,63009,44473,IT,IT_55,-1,-2,4,0,1313,56
2020-05-24,Umbria,15,2,17,36,53,-3,0,1302,75,1430,63717,45131,IT,IT_55,0,-3,2,1,708,53
2020-05-25,Umbria,15,2,17,29,46,-7,0,1309,75,1430,63916,45268,IT,IT_55,0,-7,7,0,199,46
2020-05-26,Umbria,12,2,14,28,42,-4,1,1314,75,1431,65013,46044,IT,IT_55,-3,-1,5,0,1097,42
2020-05-27,Umbria,13,2,15,17,32,-10,0,1324,75,1431,66219,46975,IT,IT_55,1,-11,10,0,1206,32
2020-05-28,Umbria,14,2,16,17,33,1,0,1323,75,1431,67458,47920,IT,IT_55,1,0,-1,0,1239,33
2020-05-29,Umbria,15,2,17,14,31,-2,0,1324,76,1431,68773,48873,IT,IT_55,1,-3,1,1,1315,31
2020-05-30,Umbria,16,1,17,14,31,0,0,1324,76,1431,70023,49760,IT,IT_55,1,0,0,0,1250,31
2020-05-31,Umbria,15,2,17,14,31,0,0,1324,76,1431,70553,50271,IT,IT_55,-1,0,0,0,530,31
2020-06-01,Umbria,15,2,17,14,31,0,0,1324,76,1431,70741,50790,IT,IT_55,0,0,0,0,188,31
2020-06-02,Umbria,15,2,17,14,31,0,0,1324,76,1431,71769,51508,IT,IT_55,0,0,0,0,1028,31
2020-06-03,Umbria,15,2,17,14,31,0,0,1324,76,1431,72001,51310,IT,IT_55,0,0,0,0,232,31
2020-06-04,Umbria,15,2,17,14,31,0,0,1324,76,1431,73204,52223,IT,IT_55,0,0,0,0,1203,31
2020-06-05,Umbria,12,2,14,15,29,-2,0,1326,76,1431,74142,52888,IT,IT_55,-3,1,2,0,938,29
2020-06-06,Umbria,11,2,13,15,28,-1,0,1327,76,1431,75336,53733,IT,IT_55,-1,0,1,0,1194,28
2020-06-07,Umbria,10,2,12,17,29,1,1,1327,76,1432,76179,54314,IT,IT_55,-1,2,0,0,843,29
2020-06-08,Umbria,10,2,12,17,29,0,0,1327,76,1432,76413,54486,IT,IT_55,0,0,0,0,234,29
2020-06-09,Umbria,12,2,14,15,29,0,3,1330,76,1435,77427,55145,IT,IT_55,2,-2,3,0,1014,29
2020-06-10,Umbria,13,2,15,13,28,-1,1,1332,76,1436,78366,55763,IT,IT_55,1,-2,2,0,939,28
2020-06-11,Umbria,11,2,13,13,26,-2,0,1334,76,1436,79234,56310,IT,IT_55,-2,0,2,0,868,26
2020-06-12,Umbria,10,1,11,13,24,-2,0,1336,76,1436,80190,56914,IT,IT_55,-1,0,2,0,956,24
2020-06-13,Umbria,10,1,11,10,21,-3,0,1339,76,1436,81155,57511,IT,IT_55,0,-3,3,0,965,21
2020-06-14,Umbria,9,1,10,10,20,-1,0,1339,77,1436,81976,58013,IT,IT_55,-1,0,0,1,821,20
2020-06-15,Umbria,9,1,10,8,18,-2,0,1341,77,1436,82235,58164,IT,IT_55,0,-2,2,0,259,18
2020-06-16,Umbria,8,1,9,9,18,0,1,1342,77,1437,83435,58815,IT,IT_55,-1,1,1,0,1200,18
2020-06-17,Umbria,7,2,9,9,18,0,0,1342,77,1437,84511,59407,IT,IT_55,-1,0,0,0,1076,18
2020-06-18,Umbria,5,2,7,9,16,-2,0,1344,77,1437,85586,59912,IT,IT_55,-2,0,2,0,1075,16
2020-06-19,Umbria,5,2,7,10,17,1,1,1344,77,1438,86693,60357,IT,IT_55,0,1,0,0,1107,17
2020-06-20,Umbria,5,2,7,10,17,0,0,1343,78,1438,87789,60857,IT,IT_55,0,0,-1,1,1096,17
2020-02-24,Valle d'Aosta,0,0,0,0,0,0,0,0,0,0,7,,IT,IT_23,,,,,,0
2020-02-25,Valle d'Aosta,0,0,0,0,0,0,0,0,0,0,7,,IT,IT_23,0,0,0,0,0,0
2020-02-26,Valle d'Aosta,0,0,0,0,0,0,0,0,0,0,7,,IT,IT_23,0,0,0,0,0,0
2020-02-27,Valle d'Aosta,0,0,0,0,0,0,0,0,0,0,9,,IT,IT_23,0,0,0,0,2,0
2020-02-28,Valle d'Aosta,0,0,0,0,0,0,0,0,0,0,9,,IT,IT_23,0,0,0,0,0,0
2020-02-29,Valle d'Aosta,0,0,0,0,0,0,0,0,0,0,9,,IT,IT_23,0,0,0,0,0,0
2020-03-01,Valle d'Aosta,0,0,0,0,0,0,0,0,0,0,10,,IT,IT_23,0,0,0,0,1,0
2020-03-02,Valle d'Aosta,0,0,0,0,0,0,0,0,0,0,11,,IT,IT_23,0,0,0,0,1,0
2020-03-03,Valle d'Aosta,0,0,0,0,0,0,0,0,0,0,12,,IT,IT_23,0,0,0,0,1,0
2020-03-04,Valle d'Aosta,0,0,0,0,0,0,0,0,0,0,15,,IT,IT_23,0,0,0,0,3,0
2020-03-05,Valle d'Aosta,0,0,0,2,2,2,2,0,0,2,21,,IT,IT_23,0,2,0,0,6,2
2020-03-06,Valle d'Aosta,0,0,0,7,7,5,5,0,0,7,28,,IT,IT_23,0,5,0,0,7,7
2020-03-07,Valle d'Aosta,1,0,1,7,8,1,1,0,0,8,32,,IT,IT_23,1,0,0,0,4,8
2020-03-08,Valle d'Aosta,1,0,1,8,9,1,1,0,0,9,41,,IT,IT_23,0,1,0,0,9,9
2020-03-09,Valle d'Aosta,4,0,4,11,15,6,6,0,0,15,67,,IT,IT_23,3,3,0,0,26,15
2020-03-10,Valle d'Aosta,2,0,2,15,17,2,2,0,0,17,89,,IT,IT_23,-2,4,0,0,22,17
2020-03-11,Valle d'Aosta,2,0,2,17,19,2,3,0,1,20,99,,IT,IT_23,0,2,0,1,10,19
2020-03-12,Valle d'Aosta,7,0,7,19,26,7,7,0,1,27,118,,IT,IT_23,5,2,0,0,19,26
2020-03-13,Valle d'Aosta,6,0,6,21,27,1,1,0,1,28,189,,IT,IT_23,-1,2,0,0,71,27
2020-03-14,Valle d'Aosta,12,0,12,29,41,14,14,0,1,42,231,,IT,IT_23,6,8,0,0,42,41
2020-03-15,Valle d'Aosta,10,3,13,43,56,15,15,0,1,57,230,,IT,IT_23,-2,14,0,0,-1,56
2020-03-16,Valle d'Aosta,28,5,33,70,103,47,48,0,2,105,287,,IT,IT_23,18,27,0,1,57,103
2020-03-17,Valle d'Aosta,35,6,41,93,134,31,31,0,2,136,398,,IT,IT_23,7,23,0,0,111,134
2020-03-18,Valle d'Aosta,41,3,44,118,162,28,29,0,3,165,486,,IT,IT_23,6,25,0,1,88,162
2020-03-19,Valle d'Aosta,47,9,56,153,209,47,50,0,6,215,608,,IT,IT_23,6,35,0,3,122,209
2020-03-20,Valle d'Aosta,54,9,63,194,257,48,49,0,7,264,814,,IT,IT_23,7,41,0,1,206,257
2020-03-21,Valle d'Aosta,62,15,77,227,304,47,49,1,8,313,884,,IT,IT_23,8,33,1,1,70,304
2020-03-22,Valle d'Aosta,63,21,84,270,354,50,51,1,9,364,950,,IT,IT_23,1,43,0,1,66,354
2020-03-23,Valle d'Aosta,69,20,89,290,379,25,29,2,12,393,1098,,IT,IT_23,6,20,1,3,148,379
2020-03-24,Valle d'Aosta,71,20,91,288,379,0,7,2,19,400,1180,,IT,IT_23,2,-2,0,7,82,379
2020-03-25,Valle d'Aosta,70,25,95,280,375,-4,1,2,24,401,1200,,IT,IT_23,-1,-8,0,5,20,375
2020-03-26,Valle d'Aosta,73,24,97,281,378,3,7,2,28,408,1203,,IT,IT_23,3,1,0,4,3,378
2020-03-27,Valle d'Aosta,91,24,115,298,413,35,44,2,37,452,1252,,IT,IT_23,18,17,0,9,49,413
2020-03-28,Valle d'Aosta,90,26,116,352,468,55,59,2,41,511,1380,,IT,IT_23,-1,54,0,4,128,468
2020-03-29,Valle d'Aosta,90,26,116,423,539,71,73,2,43,584,1480,,IT,IT_23,0,71,0,2,100,539
2020-03-30,Valle d'Aosta,92,26,118,400,518,-21,0,16,50,584,1536,,IT,IT_23,2,-23,14,7,56,518
2020-03-31,Valle d'Aosta,91,26,117,435,552,34,44,20,56,628,1582,,IT,IT_23,-1,35,4,6,46,552
2020-04-01,Valle d'Aosta,85,27,112,428,540,-12,3,32,59,631,1717,,IT,IT_23,-6,-7,12,3,135,540
2020-04-02,Valle d'Aosta,85,25,110,446,556,16,37,49,63,668,1934,,IT,IT_23,0,18,17,4,217,556
2020-04-03,Valle d'Aosta,85,25,110,450,560,4,51,89,70,719,2106,,IT,IT_23,0,4,40,7,172,560
2020-04-04,Valle d'Aosta,63,23,86,474,560,0,29,106,82,748,2274,,IT,IT_23,-22,24,17,12,168,560
2020-04-05,Valle d'Aosta,96,23,119,457,576,16,34,115,91,782,2390,,IT,IT_23,33,-17,9,9,116,576
2020-04-06,Valle d'Aosta,109,21,130,437,567,-9,23,142,96,805,2590,,IT,IT_23,13,-20,27,5,200,567
2020-04-07,Valle d'Aosta,118,17,135,458,593,26,30,142,100,835,2754,,IT,IT_23,9,21,0,4,164,593
2020-04-08,Valle d'Aosta,120,20,140,466,606,13,15,142,102,850,2953,,IT,IT_23,2,8,0,2,199,606
2020-04-09,Valle d'Aosta,118,18,136,473,609,3,18,154,105,868,3142,,IT,IT_23,-2,7,12,3,189,609
2020-04-10,Valle d'Aosta,131,16,147,455,602,-7,11,170,107,879,3328,,IT,IT_23,13,-18,16,2,186,602
2020-04-11,Valle d'Aosta,118,17,135,455,590,-12,23,205,107,902,3464,,IT,IT_23,-13,0,35,0,136,590
2020-04-12,Valle d'Aosta,109,16,125,463,588,-2,19,221,112,921,3510,,IT,IT_23,-9,8,16,5,46,588
2020-04-13,Valle d'Aosta,109,15,124,458,582,-6,6,230,115,927,3614,,IT,IT_23,0,-5,9,3,104,582
2020-04-14,Valle d'Aosta,112,14,126,433,559,-23,20,270,118,947,3726,,IT,IT_23,3,-25,40,3,112,559
2020-04-15,Valle d'Aosta,112,11,123,425,548,-11,11,289,121,958,3894,,IT,IT_23,0,-8,19,3,168,548
2020-04-16,Valle d'Aosta,105,12,117,401,518,-30,13,331,122,971,4159,,IT,IT_23,-7,-24,42,1,265,518
2020-04-17,Valle d'Aosta,108,9,117,374,491,-27,22,379,123,993,4366,,IT,IT_23,3,-27,48,1,207,491
2020-04-18,Valle d'Aosta,107,10,117,432,549,58,80,400,124,1073,4521,,IT,IT_23,-1,58,21,1,155,549
2020-04-19,Valle d'Aosta,102,10,112,450,562,13,15,401,125,1088,4677,3802,IT,IT_23,-5,18,1,1,156,562
2020-04-20,Valle d'Aosta,102,8,110,438,548,-14,0,413,127,1088,4799,3910,IT,IT_23,0,-12,12,2,122,548
2020-04-21,Valle d'Aosta,99,8,107,415,522,-26,5,445,126,1093,4911,3969,IT,IT_23,-3,-23,32,-1,112,522
2020-04-22,Valle d'Aosta,92,8,100,401,501,-21,2,467,127,1095,5024,4011,IT,IT_23,-7,-14,22,1,113,501
2020-04-23,Valle d'Aosta,91,9,100,363,463,-38,1,506,127,1096,5227,4133,IT,IT_23,-1,-38,39,0,203,463
2020-04-24,Valle d'Aosta,88,7,95,259,354,-109,4,617,129,1100,5262,4454,IT,IT_23,-3,-104,111,2,35,354
2020-04-25,Valle d'Aosta,83,6,89,224,313,-41,0,657,130,1100,5966,4694,IT,IT_23,-5,-35,40,1,704,313
2020-04-26,Valle d'Aosta,82,7,89,165,254,-59,6,721,131,1106,6135,4624,IT,IT_23,-1,-59,64,1,169,254
2020-04-27,Valle d'Aosta,86,7,93,142,235,-19,5,743,133,1111,6551,4873,IT,IT_23,4,-23,22,2,416,235
2020-04-28,Valle d'Aosta,81,5,86,123,209,-26,8,775,135,1119,6897,5069,IT,IT_23,-5,-19,32,2,346,209
2020-04-29,Valle d'Aosta,78,5,83,52,135,-74,5,852,137,1124,7181,5337,IT,IT_23,-3,-71,77,2,284,135
2020-04-30,Valle d'Aosta,76,4,80,9,89,-46,4,902,137,1128,7631,5647,IT,IT_23,-2,-43,50,0,450,89
2020-05-01,Valle d'Aosta,72,3,75,17,92,3,5,904,137,1133,7769,5818,IT,IT_23,-4,8,2,0,138,92
2020-05-02,Valle d'Aosta,70,3,73,25,98,6,3,901,137,1136,7951,5931,IT,IT_23,-2,8,-3,0,182,98
2020-05-03,Valle d'Aosta,74,2,76,33,109,11,6,895,138,1142,8100,6046,IT,IT_23,4,8,-6,1,149,109
2020-05-04,Valle d'Aosta,74,2,76,34,110,1,1,894,139,1143,8271,6200,IT,IT_23,0,1,-1,1,171,110
2020-05-05,Valle d'Aosta,56,3,59,51,110,0,0,894,139,1143,8484,6342,IT,IT_23,-18,17,0,0,213,110
2020-05-06,Valle d'Aosta,50,3,53,74,127,17,3,880,139,1146,8640,6461,IT,IT_23,-6,23,-14,0,156,127
2020-05-07,Valle d'Aosta,49,2,51,79,130,3,4,881,139,1150,8939,6702,IT,IT_23,-1,5,1,0,299,130
2020-05-08,Valle d'Aosta,45,2,47,76,123,-7,1,889,139,1151,9280,6999,IT,IT_23,-4,-3,8,0,341,123
2020-05-09,Valle d'Aosta,45,3,48,70,118,-5,1,895,139,1152,9443,7130,IT,IT_23,0,-6,6,0,163,118
2020-05-10,Valle d'Aosta,46,2,48,65,113,-5,5,905,139,1157,9833,7467,IT,IT_23,1,-5,10,0,390,113
2020-05-11,Valle d'Aosta,44,1,45,62,107,-6,1,912,139,1158,10063,7651,IT,IT_23,-2,-3,7,0,230,107
2020-05-12,Valle d'Aosta,45,0,45,59,104,-3,2,916,140,1160,10415,7956,IT,IT_23,1,-3,4,1,352,104
2020-05-13,Valle d'Aosta,38,0,38,55,93,-11,3,929,141,1163,10777,8254,IT,IT_23,-7,-4,13,1,362,93
2020-05-14,Valle d'Aosta,38,0,38,42,80,-13,3,945,141,1166,11100,8537,IT,IT_23,0,-13,16,0,323,80
2020-05-15,Valle d'Aosta,37,0,37,40,77,-3,6,953,142,1172,11413,8814,IT,IT_23,-1,-2,8,1,313,77
2020-05-16,Valle d'Aosta,33,0,33,42,75,-2,1,956,142,1173,11835,9181,IT,IT_23,-4,2,3,0,422,75
2020-05-17,Valle d'Aosta,31,0,31,37,68,-7,0,962,143,1173,12169,9469,IT,IT_23,-2,-5,6,1,334,68
2020-05-18,Valle d'Aosta,30,0,30,30,60,-8,1,971,143,1174,12327,9595,IT,IT_23,-1,-7,9,0,158,60
2020-05-19,Valle d'Aosta,26,1,27,22,49,-11,1,983,143,1175,12663,9862,IT,IT_23,-4,-8,12,0,336,49
2020-05-20,Valle d'Aosta,25,1,26,20,46,-3,0,986,143,1175,12920,10079,IT,IT_23,-1,-2,3,0,257,46
2020-05-21,Valle d'Aosta,26,1,27,16,43,-3,1,990,143,1176,13261,10380,IT,IT_23,1,-4,4,0,341,43
2020-05-22,Valle d'Aosta,22,2,24,19,43,0,1,991,143,1177,13531,10607,IT,IT_23,-4,3,1,0,270,43
2020-05-23,Valle d'Aosta,23,2,25,10,35,-8,0,999,143,1177,13828,10858,IT,IT_23,1,-9,8,0,297,35
2020-05-24,Valle d'Aosta,23,1,24,8,32,-3,1,1003,143,1178,14079,11035,IT,IT_23,0,-2,4,0,251,32
2020-05-25,Valle d'Aosta,19,1,20,13,33,1,1,1003,143,1179,14175,11123,IT,IT_23,-4,5,0,0,96,33
2020-05-26,Valle d'Aosta,17,1,18,13,31,-2,2,1007,143,1181,14262,11190,IT,IT_23,-2,0,4,0,87,31
2020-05-27,Valle d'Aosta,17,1,18,9,27,-4,0,1011,143,1181,14459,11322,IT,IT_23,0,-4,4,0,197,27
2020-05-28,Valle d'Aosta,16,0,16,7,23,-4,1,1016,143,1182,14653,11487,IT,IT_23,-1,-2,5,0,194,23
2020-05-29,Valle d'Aosta,12,0,12,7,19,-4,0,1020,143,1182,14759,11572,IT,IT_23,-4,0,4,0,106,19
2020-05-30,Valle d'Aosta,13,0,13,4,17,-2,1,1023,143,1183,14972,11741,IT,IT_23,1,-3,3,0,213,17
2020-05-31,Valle d'Aosta,12,0,12,3,15,-2,1,1026,143,1184,15203,11926,IT,IT_23,-1,-1,3,0,231,15
2020-06-01,Valle d'Aosta,11,0,11,6,17,2,3,1027,143,1187,15230,11950,IT,IT_23,-1,3,1,0,27,17
2020-06-02,Valle d'Aosta,10,0,10,3,13,-4,0,1031,143,1187,15327,12027,IT,IT_23,-1,-3,4,0,97,13
2020-06-03,Valle d'Aosta,9,0,9,4,13,0,0,1031,143,1187,15413,12084,IT,IT_23,-1,1,0,0,86,13
2020-06-04,Valle d'Aosta,9,0,9,1,10,-3,0,1034,143,1187,15512,12156,IT,IT_23,0,-3,3,0,99,10
2020-06-05,Valle d'Aosta,9,0,9,1,10,0,0,1034,143,1187,15587,12200,IT,IT_23,0,0,0,0,75,10
2020-06-06,Valle d'Aosta,7,0,7,5,12,2,2,1033,144,1189,15730,12289,IT,IT_23,-2,4,-1,1,143,12
2020-06-07,Valle d'Aosta,6,0,6,3,9,-3,2,1038,144,1191,15905,12335,IT,IT_23,-1,-2,5,0,175,9
2020-06-08,Valle d'Aosta,7,0,7,1,8,-1,0,1039,144,1191,15910,12385,IT,IT_23,1,-2,1,0,5,8
2020-06-09,Valle d'Aosta,7,0,7,1,8,0,0,1039,144,1191,16040,12436,IT,IT_23,0,0,0,0,130,8
2020-06-10,Valle d'Aosta,3,0,3,3,6,-2,0,1041,144,1191,16141,12502,IT,IT_23,-4,2,2,0,101,6
2020-06-11,Valle d'Aosta,6,0,6,0,6,0,0,1041,144,1191,16268,12606,IT,IT_23,3,-3,0,0,127,6
2020-06-12,Valle d'Aosta,6,0,6,3,9,3,0,1038,144,1191,16374,12671,IT,IT_23,0,3,-3,0,106,9
2020-06-13,Valle d'Aosta,7,0,7,0,7,-2,0,1040,144,1191,16476,12736,IT,IT_23,1,-3,2,0,102,7
2020-06-14,Valle d'Aosta,7,0,7,0,7,0,0,1040,144,1191,16597,12806,IT,IT_23,0,0,0,0,121,7
2020-06-15,Valle d'Aosta,7,0,7,5,12,5,0,1035,144,1191,16650,12829,IT,IT_23,0,5,-5,0,53,12
2020-06-16,Valle d'Aosta,6,0,6,4,10,-2,0,1037,144,1191,16764,12907,IT,IT_23,-1,-1,2,0,114,10
2020-06-17,Valle d'Aosta,5,0,5,3,8,-2,0,1039,144,1191,16918,12996,IT,IT_23,-1,-1,2,0,154,8
2020-06-18,Valle d'Aosta,5,0,5,1,6,-2,0,1040,145,1191,17057,13097,IT,IT_23,0,-2,1,1,139,6
2020-06-19,Valle d'Aosta,4,0,4,0,4,-2,0,1041,146,1191,17183,13182,IT,IT_23,-1,-1,1,1,126,4
2020-06-20,Valle d'Aosta,4,0,4,2,6,2,2,1041,146,1193,17297,13234,IT,IT_23,0,2,0,0,114,6
2020-02-24,Veneto,12,4,16,16,32,0,32,0,1,33,2200,,IT,IT_34,,,,,,0
2020-02-25,Veneto,12,7,19,23,42,10,10,0,1,43,3780,,IT,IT_34,0,7,0,0,1580,10
2020-02-26,Veneto,16,8,24,45,69,27,28,0,2,71,4900,,IT,IT_34,4,22,0,1,1120,37
2020-02-27,Veneto,19,8,27,82,109,40,40,0,2,111,6164,,IT,IT_34,3,37,0,0,1264,77
2020-02-28,Veneto,24,9,33,116,149,40,40,0,2,151,7414,,IT,IT_34,5,34,0,0,1250,117
2020-02-29,Veneto,24,11,35,154,189,40,40,0,2,191,8659,,IT,IT_34,0,38,0,0,1245,157
2020-03-01,Veneto,51,13,64,197,261,72,72,0,2,263,9056,,IT,IT_34,27,43,0,0,397,229
2020-03-02,Veneto,53,14,67,204,271,10,10,0,2,273,9782,,IT,IT_34,2,7,0,0,726,239
2020-03-03,Veneto,49,19,68,229,297,26,34,7,3,307,10176,,IT,IT_34,-4,25,7,1,394,265
2020-03-04,Veneto,76,23,99,246,345,48,53,9,6,360,10515,,IT,IT_34,27,17,2,3,339,313
2020-03-05,Veneto,92,24,116,264,380,35,47,17,10,407,11949,,IT,IT_34,16,18,8,4,1434,348
2020-03-06,Veneto,117,27,144,310,454,74,81,22,12,488,13023,,IT,IT_34,25,46,5,2,1074,422
2020-03-07,Veneto,123,41,164,341,505,51,55,25,13,543,14429,,IT,IT_34,6,31,3,1,1406,473
2020-03-08,Veneto,146,47,193,430,623,118,127,29,18,670,15918,,IT,IT_34,23,89,4,5,1489,591
2020-03-09,Veneto,186,51,237,457,694,71,74,30,20,744,15956,,IT,IT_34,40,27,1,2,38,662
2020-03-10,Veneto,204,67,271,512,783,89,112,47,26,856,16643,,IT,IT_34,18,55,17,6,687,751
2020-03-11,Veneto,262,68,330,610,940,157,167,54,29,1023,21400,,IT,IT_34,58,98,7,3,4757,908
2020-03-12,Veneto,360,85,445,852,1297,357,361,55,32,1384,23438,,IT,IT_34,98,242,1,3,2038,1265
2020-03-13,Veneto,366,107,473,980,1453,156,211,100,42,1595,25691,,IT,IT_34,6,128,45,10,2253,1421
2020-03-14,Veneto,366,119,485,1290,1775,322,342,107,55,1937,26980,,IT,IT_34,0,310,7,13,1289,1743
2020-03-15,Veneto,426,129,555,1434,1989,214,235,120,63,2172,32546,,IT,IT_34,60,144,13,8,5566,1957
2020-03-16,Veneto,498,156,654,1620,2274,285,301,130,69,2473,35052,,IT,IT_34,72,186,10,6,2506,2242
2020-03-17,Veneto,548,171,719,1769,2488,214,231,136,80,2704,35478,,IT,IT_34,50,149,6,11,426,2456
2020-03-18,Veneto,646,195,841,2112,2953,465,510,167,94,3214,40841,,IT,IT_34,98,343,31,14,5363,2921
2020-03-19,Veneto,771,209,980,2189,3169,216,270,200,115,3484,44658,,IT,IT_34,125,77,33,21,3817,3137
2020-03-20,Veneto,843,236,1079,2598,3677,508,547,223,131,4031,49288,,IT,IT_34,72,409,23,16,4630,3645
2020-03-21,Veneto,942,249,1191,3023,4214,537,586,257,146,4617,53642,,IT,IT_34,99,425,34,15,4354,4182
2020-03-22,Veneto,1113,255,1368,3276,4644,430,505,309,169,5122,57671,,IT,IT_34,171,253,52,23,4029,4612
2020-03-23,Veneto,1206,281,1487,3499,4986,342,383,327,192,5505,61115,,IT,IT_34,93,223,18,23,3444,4954
2020-03-24,Veneto,1318,304,1622,3729,5351,365,443,381,216,5948,66178,,IT,IT_34,112,230,54,24,5063,5319
2020-03-25,Veneto,1407,316,1723,4022,5745,394,494,439,258,6442,70877,,IT,IT_34,89,293,58,42,4699,5713
2020-03-26,Veneto,1447,326,1773,4367,6140,395,493,508,287,6935,79759,,IT,IT_34,40,345,69,29,8882,6108
2020-03-27,Veneto,1536,338,1874,4774,6648,508,562,536,313,7497,83627,,IT,IT_34,89,407,28,26,3868,6616
2020-03-28,Veneto,1559,344,1903,5010,6913,265,433,655,362,7930,89380,,IT,IT_34,23,236,119,49,5753,6881
2020-03-29,Veneto,1586,355,1941,5310,7251,338,428,715,392,8358,94784,,IT,IT_34,27,300,60,30,5404,7219
2020-03-30,Veneto,1633,356,1989,5575,7564,313,366,747,413,8724,99941,,IT,IT_34,47,265,32,21,5157,7532
2020-03-31,Veneto,1680,356,2036,5814,7850,286,431,828,477,9155,106238,,IT,IT_34,47,239,81,64,6297,7818
2020-04-01,Veneto,1718,350,2068,6156,8224,374,470,902,499,9625,112746,,IT,IT_34,38,342,74,22,6508,8192
2020-04-02,Veneto,1670,345,2015,6563,8578,354,486,1001,532,10111,120320,,IT,IT_34,-48,407,99,33,7574,8546
2020-04-03,Veneto,1714,335,2049,6812,8861,283,353,1031,572,10464,126490,,IT,IT_34,44,249,30,40,6170,8829
2020-04-04,Veneto,1691,324,2015,7078,9093,232,360,1124,607,10824,133289,,IT,IT_34,-23,266,93,35,6799,9061
2020-04-05,Veneto,1674,329,2003,7406,9409,316,402,1186,631,11226,140910,,IT,IT_34,-17,328,62,24,7621,9377
2020-04-06,Veneto,1714,322,2036,7686,9722,313,362,1204,662,11588,146288,,IT,IT_34,40,280,18,31,5378,9690
2020-04-07,Veneto,1579,297,1876,8089,9965,243,337,1265,695,11925,153542,,IT,IT_34,-135,403,61,33,7254,9933
2020-04-08,Veneto,1554,285,1839,8332,10171,206,485,1503,736,12410,163247,,IT,IT_34,-25,243,238,41,9705,10139
2020-04-09,Veneto,1530,274,1804,8645,10449,278,523,1728,756,12933,171456,,IT,IT_34,-24,313,225,20,8209,10417
2020-04-10,Veneto,1521,257,1778,8869,10647,198,488,1981,793,13421,180700,,IT,IT_34,-9,224,253,37,9244,10615
2020-04-11,Veneto,1465,251,1716,9033,10749,102,347,2188,831,13768,190912,,IT,IT_34,-56,164,207,38,10212,10717
2020-04-12,Veneto,1428,249,1677,9052,10729,-20,309,2492,856,14077,198442,,IT,IT_34,-37,19,304,25,7530,10697
2020-04-13,Veneto,1427,245,1672,9094,10766,37,174,2603,882,14251,203077,,IT,IT_34,-1,42,111,26,4635,10734
2020-04-14,Veneto,1427,233,1660,9076,10736,-30,181,2790,906,14432,208878,,IT,IT_34,0,-18,187,24,5801,10704
2020-04-15,Veneto,1402,219,1621,9168,10789,53,192,2895,940,14624,216344,,IT,IT_34,-25,92,105,34,7466,10757
2020-04-16,Veneto,1388,209,1597,9203,10800,11,366,3209,981,14990,224549,,IT,IT_34,-14,35,314,41,8205,10768
2020-04-17,Veneto,1359,197,1556,9062,10618,-182,384,3730,1026,15374,236722,,IT,IT_34,-29,-141,521,45,12173,10586
2020-04-18,Veneto,1287,190,1477,8967,10444,-174,318,4189,1059,15692,247329,,IT,IT_34,-72,-95,459,33,10607,10412
2020-04-19,Veneto,1264,184,1448,8762,10210,-234,243,4638,1087,15935,255797,161231,IT,IT_34,-23,-205,449,28,8468,10178
2020-04-20,Veneto,1273,180,1453,8608,10061,-149,192,4954,1112,16127,260810,163757,IT,IT_34,9,-154,316,25,5013,10029
2020-04-21,Veneto,1230,177,1407,8670,10077,16,277,5173,1154,16404,268069,167129,IT,IT_34,-43,62,219,42,7259,10045
2020-04-22,Veneto,1205,163,1368,8623,9991,-86,334,5566,1181,16738,277543,171735,IT,IT_34,-25,-47,393,27,9474,9959
2020-04-23,Veneto,1189,140,1329,8596,9925,-66,143,5750,1206,16881,288075,177154,IT,IT_34,-16,-27,184,25,10532,9893
2020-04-24,Veneto,1159,130,1289,8390,9679,-246,348,6306,1244,17229,296896,181473,IT,IT_34,-30,-206,556,38,8821,9647
2020-04-25,Veneto,1105,129,1234,8198,9432,-247,162,6671,1288,17391,306977,186426,IT,IT_34,-54,-192,365,44,10081,9400
2020-04-26,Veneto,1097,124,1221,7917,9138,-294,80,7018,1315,17471,316361,183513,IT,IT_34,-8,-281,347,27,9384,9106
2020-04-27,Veneto,1099,123,1222,7638,8860,-278,108,7375,1344,17579,320027,192751,IT,IT_34,2,-279,357,29,3666,8828
2020-04-28,Veneto,1067,120,1187,7414,8601,-259,129,7699,1408,17708,328218,196864,IT,IT_34,-32,-224,324,64,8191,8569
2020-04-29,Veneto,1042,114,1156,7213,8369,-232,117,8019,1437,17825,337656,200737,IT,IT_34,-25,-201,320,29,9438,8337
2020-04-30,Veneto,1012,114,1126,7021,8147,-222,135,8354,1459,17960,349227,206347,IT,IT_34,-30,-192,335,22,11571,8115
2020-05-01,Veneto,977,110,1087,6692,7779,-368,138,8840,1479,18098,362459,212706,IT,IT_34,-35,-329,486,20,13232,7747
2020-05-02,Veneto,970,108,1078,6353,7431,-348,126,9291,1502,18224,370978,216997,IT,IT_34,-7,-339,451,23,8519,7399
2020-05-03,Veneto,955,103,1058,6241,7299,-132,94,9503,1516,18318,378202,220598,IT,IT_34,-15,-112,212,14,7224,7267
2020-05-04,Veneto,955,101,1056,6178,7234,-65,55,9611,1528,18373,383660,223968,IT,IT_34,0,-63,108,12,5458,7202
2020-05-05,Veneto,926,98,1024,6092,7116,-118,29,9741,1545,18402,390952,227579,IT,IT_34,-29,-86,130,17,7292,7084
2020-05-06,Veneto,902,90,992,5797,6789,-327,77,10122,1568,18479,399806,231469,IT,IT_34,-24,-295,381,23,8854,6757
2020-05-07,Veneto,872,87,959,5575,6534,-255,74,10430,1589,18553,410212,236281,IT,IT_34,-30,-222,308,21,10406,6502
2020-05-08,Veneto,831,79,910,5277,6187,-347,65,10804,1627,18618,420949,240535,IT,IT_34,-41,-298,374,38,10737,6155
2020-05-09,Veneto,435,40,475,5402,5877,-310,53,11151,1643,18671,432114,244930,IT,IT_34,-396,125,347,16,11165,5845
2020-05-10,Veneto,408,37,445,5146,5591,-286,51,11474,1657,18722,439522,247617,IT,IT_34,-27,-256,323,14,7408,5559
2020-05-11,Veneto,400,38,438,5022,5460,-131,19,11615,1666,18741,445905,250175,IT,IT_34,-8,-124,141,9,6383,5428
2020-05-12,Veneto,393,33,426,4764,5190,-270,41,11906,1686,18782,454189,253374,IT,IT_34,-7,-258,291,20,8284,5158
2020-05-13,Veneto,364,30,394,4626,5020,-170,31,12081,1712,18813,463154,257017,IT,IT_34,-29,-138,175,26,8965,4988
2020-05-14,Veneto,342,26,368,4350,4718,-302,32,12384,1743,18845,474488,260706,IT,IT_34,-22,-276,303,31,11334,4686
2020-05-15,Veneto,311,24,335,4104,4439,-279,44,12688,1762,18889,484639,264091,IT,IT_34,-31,-246,304,19,10151,4407
2020-05-16,Veneto,290,20,310,3852,4162,-277,39,12983,1783,18928,497045,269003,IT,IT_34,-21,-252,295,21,12406,4130
2020-05-17,Veneto,273,22,295,3746,4041,-121,13,13106,1794,18941,506588,272938,IT,IT_34,-17,-106,123,11,9543,4009
2020-05-18,Veneto,263,22,285,3719,4004,-37,9,13143,1803,18950,513021,275851,IT,IT_34,-10,-27,37,9,6433,3972
2020-05-19,Veneto,259,18,277,3477,3754,-250,47,13423,1820,18997,523800,280629,IT,IT_34,-4,-242,280,17,10779,3722
2020-05-20,Veneto,255,16,271,3261,3532,-222,33,13666,1832,19030,536798,285786,IT,IT_34,-4,-216,243,12,12998,3500
2020-05-21,Veneto,237,15,252,3034,3286,-246,8,13911,1841,19038,548573,290682,IT,IT_34,-18,-227,245,9,11775,3254
2020-05-22,Veneto,215,12,227,2796,3023,-263,21,14182,1854,19059,559933,295343,IT,IT_34,-22,-238,271,13,11360,2991
2020-05-23,Veneto,205,14,219,2622,2841,-182,10,14363,1865,19069,572834,300799,IT,IT_34,-10,-174,181,11,12901,2809
2020-05-24,Veneto,185,11,196,2464,2660,-181,17,14557,1869,19086,582709,304944,IT,IT_34,-20,-158,194,4,9875,2628
2020-05-25,Veneto,179,10,189,2389,2578,-82,11,14641,1878,19097,590179,308128,IT,IT_34,-6,-75,84,9,7470,2546
2020-05-26,Veneto,177,11,188,2243,2431,-147,8,14788,1886,19105,602252,312632,IT,IT_34,-2,-146,147,8,12073,2399
2020-05-27,Veneto,168,9,177,2110,2287,-144,8,14931,1895,19113,616691,317690,IT,IT_34,-9,-133,143,9,14439,2255
2020-05-28,Veneto,148,9,157,1868,2025,-262,12,15202,1898,19125,632124,323097,IT,IT_34,-20,-242,271,3,15433,1993
2020-05-29,Veneto,137,7,144,1705,1849,-176,9,15379,1906,19134,645049,326795,IT,IT_34,-11,-163,177,8,12925,1817
2020-05-30,Veneto,120,7,127,1485,1612,-237,12,15618,1916,19146,660151,331390,IT,IT_34,-17,-220,239,10,15102,1580
2020-05-31,Veneto,112,6,118,1382,1500,-112,6,15734,1918,19152,669768,333834,IT,IT_34,-8,-103,116,2,9617,1468
2020-06-01,Veneto,110,6,116,1352,1468,-32,2,15768,1918,19154,675934,335650,IT,IT_34,-2,-30,34,0,6166,1436
2020-06-02,Veneto,103,5,108,1295,1403,-65,8,15838,1921,19162,690267,340051,IT,IT_34,-7,-57,70,3,14333,1371
2020-06-03,Veneto,106,2,108,1279,1387,-16,2,15856,1921,19164,695053,341333,IT,IT_34,3,-16,18,0,4786,1355
2020-06-04,Veneto,97,2,99,1220,1319,-68,4,15915,1934,19168,706475,344495,IT,IT_34,-9,-59,59,13,11422,1287
2020-06-05,Veneto,96,2,98,1131,1229,-90,6,16007,1938,19174,713500,346872,IT,IT_34,-1,-89,92,4,7025,1197
2020-06-06,Veneto,82,2,84,1080,1164,-65,8,16069,1949,19182,734130,351519,IT,IT_34,-14,-51,62,11,20630,1132
2020-06-07,Veneto,81,1,82,1003,1085,-79,1,16144,1954,19183,745805,354338,IT,IT_34,-1,-77,75,5,11675,1053
2020-06-08,Veneto,82,1,83,997,1080,-5,4,16152,1955,19187,750248,355368,IT,IT_34,1,-6,8,1,4443,1048
2020-06-09,Veneto,77,0,77,927,1004,-76,4,16226,1961,19191,762098,358948,IT,IT_34,-5,-70,74,6,11850,972
2020-06-10,Veneto,66,0,66,899,965,-39,3,16268,1961,19194,773316,362400,IT,IT_34,-11,-28,42,0,11218,933
2020-06-11,Veneto,52,0,52,870,922,-43,5,16313,1964,19199,780445,364110,IT,IT_34,-14,-29,45,3,7129,890
2020-06-12,Veneto,49,0,49,800,849,-73,0,16383,1967,19199,795260,367579,IT,IT_34,-3,-70,70,3,14815,817
2020-06-13,Veneto,41,1,42,736,778,-71,13,16457,1977,19212,798290,368659,IT,IT_34,-8,-64,74,10,3030,746
2020-06-14,Veneto,40,1,41,731,772,-6,7,16469,1978,19219,812540,371726,IT,IT_34,-1,-5,12,1,14250,740
2020-06-15,Veneto,38,1,39,716,755,-17,1,16487,1978,19220,817064,373057,IT,IT_34,-2,-15,18,0,4524,723
2020-06-16,Veneto,36,1,37,681,718,-37,1,16521,1982,19221,826192,376001,IT,IT_34,-2,-35,34,4,9128,686
2020-06-17,Veneto,37,1,38,642,680,-38,4,16558,1987,19225,837394,379280,IT,IT_34,1,-39,37,5,11202,648
2020-06-18,Veneto,33,1,34,573,607,-73,8,16632,1994,19233,847997,382042,IT,IT_34,-4,-69,74,7,10603,575
2020-06-19,Veneto,30,1,31,551,582,-25,2,16655,1998,19235,858726,384389,IT,IT_34,-3,-22,23,4,10729,550
2020-06-20,Veneto,27,1,28,547,575,-7,3,16661,2002,19238,870830,387501,IT,IT_34,-3,-4,6,4,12104,543
