date,new_confirmed,new_deceased,total_confirmed,total_deceased,key
2020-03-02,1,0,1,0,AD
2020-03-13,1,0,2,0,AD
2020-03-15,3,0,5,0,AD
2020-03-16,9,0,14,0,AD
2020-03-17,0,0,14,0,AD
2020-03-18,39,0,53,0,AD
2020-03-19,22,0,75,0,AD
2020-03-20,0,0,75,0,AD
2020-03-21,13,0,88,0,AD
2020-03-22,25,0,113,0,AD
2020-03-23,20,0,133,0,AD
2020-03-24,31,0,164,0,AD
2020-03-25,24,0,188,0,AD
2020-03-26,36,3,224,3,AD
2020-03-27,43,0,267,3,AD
2020-03-28,41,1,308,4,AD
2020-03-29,26,2,334,6,AD
2020-03-30,36,2,370,8,AD
2020-03-31,6,4,376,12,AD
2020-04-01,14,2,390,14,AD
2020-04-02,38,1,428,15,AD
2020-04-03,11,1,439,16,AD
2020-04-04,27,1,466,17,AD
2020-04-05,35,1,501,18,AD
2020-04-06,25,3,526,21,AD
2020-04-07,19,1,545,22,AD
2020-04-08,19,1,564,23,AD
2020-04-09,19,2,583,25,AD
2020-04-10,18,1,601,26,AD
2020-04-11,21,2,622,28,AD
2020-04-12,16,1,638,29,AD
2020-04-13,8,0,646,29,AD
2020-04-14,13,2,659,31,AD
2020-04-15,14,2,673,33,AD
2020-04-16,9,0,682,33,AD
2020-04-17,14,2,696,35,AD
2020-04-18,8,0,704,35,AD
2020-04-19,9,1,713,36,AD
2020-04-20,4,0,717,36,AD
2020-04-21,0,1,717,37,AD
2020-04-22,6,0,723,37,AD
2020-04-23,1,0,724,37,AD
2020-04-24,7,3,731,40,AD
2020-04-25,2,0,733,40,AD
2020-04-26,7,0,740,40,AD
2020-04-27,3,0,743,40,AD
2020-04-28,0,1,743,41,AD
2020-04-29,0,1,743,42,AD
2020-04-30,2,0,745,42,AD
2020-05-01,1,1,746,43,AD
2020-05-02,1,1,747,44,AD
2020-05-03,1,1,748,45,AD
2020-05-04,2,0,750,45,AD
2020-05-05,1,1,751,46,AD
2020-05-06,0,0,751,46,AD
2020-05-07,1,1,752,47,AD
2020-05-08,0,0,752,47,AD
2020-05-09,2,1,754,48,AD
2020-05-10,1,0,755,48,AD
2020-05-11,1,0,756,48,AD
2020-05-12,2,0,758,48,AD
2020-05-13,2,1,760,49,AD
2020-05-14,1,0,761,49,AD
2020-05-15,0,0,761,49,AD
2020-05-16,0,2,761,51,AD
2020-05-17,0,0,761,51,AD
2020-05-18,0,0,761,51,AD
2020-05-19,0,0,761,51,AD
2020-05-20,1,0,762,51,AD
2020-05-21,0,0,762,51,AD
2020-05-22,0,0,762,51,AD
2020-05-23,0,0,762,51,AD
2020-05-24,1,0,763,51,AD
2020-05-25,0,0,763,51,AD
2020-05-26,0,0,763,51,AD
2020-05-27,0,0,763,51,AD
2020-05-28,0,0,763,51,AD
2020-05-29,1,0,764,51,AD
2020-05-30,0,0,764,51,AD
2020-05-31,0,0,764,51,AD
2020-06-01,1,0,765,51,AD
2020-06-02,79,0,844,51,AD
2020-06-03,7,0,851,51,AD
2020-06-04,1,0,852,51,AD
2020-06-05,0,0,852,51,AD
2020-06-06,0,0,852,51,AD
2020-06-07,0,0,852,51,AD
2020-06-08,0,0,852,51,AD
2020-06-09,0,0,852,51,AD
2020-06-10,0,0,852,51,AD
2020-06-11,0,0,852,51,AD
2020-06-12,1,0,853,51,AD
2020-06-13,0,0,853,51,AD
2020-06-14,0,0,853,51,AD
2020-06-15,0,0,853,51,AD
2020-06-16,1,1,854,52,AD
2020-06-17,0,0,854,52,AD
2020-06-18,1,0,855,52,AD
2020-06-19,0,0,855,52,AD
2020-06-20,0,0,855,52,AD
2020-06-21,0,0,855,52,AD
2020-06-22,0,0,855,52,AD
2020-06-23,0,0,855,52,AD
2020-06-24,0,0,855,52,AD
2020-06-25,0,0,855,52,AD
2020-06-26,0,0,855,52,AD
2019-12-30,0,0,0,0,AE
2019-12-31,0,0,0,0,AE
2020-01-01,0,0,0,0,AE
2020-01-02,0,0,0,0,AE
2020-01-03,0,0,0,0,AE
2020-01-04,0,0,0,0,AE
2020-01-05,0,0,0,0,AE
2020-01-06,0,0,0,0,AE
2020-01-07,0,0,0,0,AE
2020-01-08,0,0,0,0,AE
2020-01-09,0,0,0,0,AE
2020-01-10,0,0,0,0,AE
2020-01-11,0,0,0,0,AE
2020-01-12,0,0,0,0,AE
2020-01-13,0,0,0,0,AE
2020-01-14,0,0,0,0,AE
2020-01-15,0,0,0,0,AE
2020-01-16,0,0,0,0,AE
2020-01-17,0,0,0,0,AE
2020-01-18,0,0,0,0,AE
2020-01-19,0,0,0,0,AE
2020-01-20,0,0,0,0,AE
2020-01-21,0,0,0,0,AE
2020-01-22,0,0,0,0,AE
2020-01-23,0,0,0,0,AE
2020-01-24,0,0,0,0,AE
2020-01-25,0,0,0,0,AE
2020-01-26,1,0,1,0,AE
2020-01-27,0,0,1,0,AE
2020-01-28,0,0,1,0,AE
2020-01-29,3,0,4,0,AE
2020-01-30,0,0,4,0,AE
2020-01-31,0,0,4,0,AE
2020-02-01,1,0,5,0,AE
2020-02-02,0,0,5,0,AE
2020-02-03,0,0,5,0,AE
2020-02-04,0,0,5,0,AE
2020-02-05,0,0,5,0,AE
2020-02-06,0,0,5,0,AE
2020-02-07,2,0,7,0,AE
2020-02-08,0,0,7,0,AE
2020-02-09,0,0,7,0,AE
2020-02-10,1,0,8,0,AE
2020-02-11,0,0,8,0,AE
2020-02-12,0,0,8,0,AE
2020-02-13,0,0,8,0,AE
2020-02-14,0,0,8,0,AE
2020-02-15,0,0,8,0,AE
2020-02-16,1,0,9,0,AE
2020-02-17,0,0,9,0,AE
2020-02-18,0,0,9,0,AE
2020-02-19,0,0,9,0,AE
2020-02-20,0,0,9,0,AE
2020-02-21,2,0,11,0,AE
2020-02-22,2,0,13,0,AE
2020-02-23,0,0,13,0,AE
2020-02-24,0,0,13,0,AE
2020-02-25,0,0,13,0,AE
2020-02-26,0,0,13,0,AE
2020-02-27,6,0,19,0,AE
2020-02-28,0,0,19,0,AE
2020-02-29,2,0,21,0,AE
2020-03-01,0,0,21,0,AE
2020-03-03,6,0,27,0,AE
2020-03-05,2,0,29,0,AE
2020-03-07,16,0,45,0,AE
2020-03-09,14,0,59,0,AE
2020-03-10,15,0,74,0,AE
2020-03-12,11,0,85,0,AE
2020-03-14,0,0,85,0,AE
2020-03-15,1,0,86,0,AE
2020-03-16,12,0,98,0,AE
2020-03-17,15,0,113,0,AE
2020-03-18,0,0,113,0,AE
2020-03-19,27,0,140,0,AE
2020-03-20,0,0,140,0,AE
2020-03-21,13,2,153,2,AE
2020-03-22,0,0,153,2,AE
2020-03-23,45,0,198,2,AE
2020-03-24,50,0,248,2,AE
2020-03-25,85,0,333,2,AE
2020-03-26,0,0,333,2,AE
2020-03-27,72,0,405,2,AE
2020-03-28,63,0,468,2,AE
2020-03-29,0,0,468,2,AE
2020-03-30,143,3,611,5,AE
2020-03-31,53,1,664,6,AE
2020-04-01,0,0,664,6,AE
2020-04-02,360,2,1024,8,AE
2020-04-03,0,0,1024,8,AE
2020-04-04,481,2,1505,10,AE
2020-04-05,294,0,1799,10,AE
2020-04-06,277,1,2076,11,AE
2020-04-07,283,1,2359,12,AE
2020-04-08,300,0,2659,12,AE
2020-04-09,331,2,2990,14,AE
2020-04-10,370,2,3360,16,AE
2020-04-11,376,4,3736,20,AE
2020-04-12,387,2,4123,22,AE
2020-04-13,398,3,4521,25,AE
2020-04-14,412,3,4933,28,AE
2020-04-15,432,5,5365,33,AE
2020-04-16,460,0,5825,33,AE
2020-04-17,0,2,5825,35,AE
2020-04-18,477,2,6302,37,AE
2020-04-19,479,4,6781,41,AE
2020-04-20,484,2,7265,43,AE
2020-04-21,490,3,7755,46,AE
2020-04-22,483,6,8238,52,AE
2020-04-23,518,4,8756,56,AE
2020-04-24,525,8,9281,64,AE
2020-04-25,532,0,9813,64,AE
2020-04-26,536,12,10349,76,AE
2020-04-27,490,6,10839,82,AE
2020-04-28,541,7,11380,89,AE
2020-04-29,549,9,11929,98,AE
2020-04-30,552,7,12481,105,AE
2020-05-01,557,6,13038,111,AE
2020-05-02,561,8,13599,119,AE
2020-05-03,564,7,14163,126,AE
2020-05-04,567,11,14730,137,AE
2020-05-05,462,9,15192,146,AE
2020-05-06,546,11,15738,157,AE
2020-05-07,502,8,16240,165,AE
2020-05-08,553,9,16793,174,AE
2020-05-09,624,11,17417,185,AE
2020-05-10,781,13,18198,198,AE
2020-05-11,680,3,18878,201,AE
2020-05-12,783,2,19661,203,AE
2020-05-13,725,3,20386,206,AE
2020-05-14,698,2,21084,208,AE
2020-05-15,747,2,21831,210,AE
2020-05-16,796,4,22627,214,AE
2020-05-17,731,6,23358,220,AE
2020-05-18,832,4,24190,224,AE
2020-05-19,873,3,25063,227,AE
2020-05-20,941,6,26004,233,AE
2020-05-21,894,4,26898,237,AE
2020-05-22,994,4,27892,241,AE
2020-05-23,812,3,28704,244,AE
2020-05-24,781,1,29485,245,AE
2020-05-25,822,3,30307,248,AE
2020-05-26,779,5,31086,253,AE
2020-05-27,883,2,31969,255,AE
2020-05-28,563,3,32532,258,AE
2020-05-29,638,2,33170,260,AE
2020-05-30,726,2,33896,262,AE
2020-05-31,661,2,34557,264,AE
2020-06-01,635,2,35192,266,AE
2020-06-02,596,3,35788,269,AE
2020-06-03,571,1,36359,270,AE
2020-06-04,659,3,37018,273,AE
2020-06-05,624,1,37642,274,AE
2020-06-06,626,1,38268,275,AE
2020-06-07,540,1,38808,276,AE
2020-06-08,568,5,39376,281,AE
2020-06-09,528,2,39904,283,AE
2020-06-10,603,1,40507,284,AE
2020-06-11,479,2,40986,286,AE
2020-06-12,513,1,41499,287,AE
2020-06-13,401,1,41900,288,AE
2020-06-14,394,1,42294,289,AE
2020-06-15,342,2,42636,291,AE
2020-06-16,346,2,42982,293,AE
2020-06-17,382,2,43364,295,AE
2020-06-18,388,3,43752,298,AE
2020-06-19,393,2,44145,300,AE
2020-06-20,388,1,44533,301,AE
2020-06-21,392,1,44925,302,AE
2020-06-22,378,1,45303,303,AE
2020-06-23,380,2,45683,305,AE
2020-06-24,450,2,46133,307,AE
2020-06-25,430,1,46563,308,AE
2020-06-26,410,2,46973,310,AE
2019-12-30,0,0,0,0,AF
2019-12-31,0,0,0,0,AF
2020-01-01,0,0,0,0,AF
2020-01-02,0,0,0,0,AF
2020-01-03,0,0,0,0,AF
2020-01-04,0,0,0,0,AF
2020-01-05,0,0,0,0,AF
2020-01-06,0,0,0,0,AF
2020-01-07,0,0,0,0,AF
2020-01-08,0,0,0,0,AF
2020-01-09,0,0,0,0,AF
2020-01-10,0,0,0,0,AF
2020-01-11,0,0,0,0,AF
2020-01-12,0,0,0,0,AF
2020-01-13,0,0,0,0,AF
2020-01-14,0,0,0,0,AF
2020-01-15,0,0,0,0,AF
2020-01-16,0,0,0,0,AF
2020-01-17,0,0,0,0,AF
2020-01-18,0,0,0,0,AF
2020-01-19,0,0,0,0,AF
2020-01-20,0,0,0,0,AF
2020-01-21,0,0,0,0,AF
2020-01-22,0,0,0,0,AF
2020-01-23,0,0,0,0,AF
2020-01-24,0,0,0,0,AF
2020-01-25,0,0,0,0,AF
2020-01-26,0,0,0,0,AF
2020-01-27,0,0,0,0,AF
2020-01-28,0,0,0,0,AF
2020-01-29,0,0,0,0,AF
2020-01-30,0,0,0,0,AF
2020-01-31,0,0,0,0,AF
2020-02-01,0,0,0,0,AF
2020-02-02,0,0,0,0,AF
2020-02-03,0,0,0,0,AF
2020-02-04,0,0,0,0,AF
2020-02-05,0,0,0,0,AF
2020-02-06,0,0,0,0,AF
2020-02-07,0,0,0,0,AF
2020-02-08,0,0,0,0,AF
2020-02-09,0,0,0,0,AF
2020-02-10,0,0,0,0,AF
2020-02-11,0,0,0,0,AF
2020-02-12,0,0,0,0,AF
2020-02-13,0,0,0,0,AF
2020-02-14,0,0,0,0,AF
2020-02-15,0,0,0,0,AF
2020-02-16,0,0,0,0,AF
2020-02-17,0,0,0,0,AF
2020-02-18,0,0,0,0,AF
2020-02-19,0,0,0,0,AF
2020-02-20,0,0,0,0,AF
2020-02-21,0,0,0,0,AF
2020-02-22,0,0,0,0,AF
2020-02-23,0,0,0,0,AF
2020-02-24,1,0,1,0,AF
2020-02-25,0,0,1,0,AF
2020-02-26,0,0,1,0,AF
2020-02-27,0,0,1,0,AF
2020-02-28,0,0,1,0,AF
2020-02-29,0,0,1,0,AF
2020-03-01,0,0,1,0,AF
2020-03-07,3,0,4,0,AF
2020-03-10,3,0,7,0,AF
2020-03-14,3,0,10,0,AF
2020-03-15,6,0,16,0,AF
2020-03-16,5,0,21,0,AF
2020-03-17,1,0,22,0,AF
2020-03-18,0,0,22,0,AF
2020-03-19,0,0,22,0,AF
2020-03-20,2,0,24,0,AF
2020-03-21,0,0,24,0,AF
2020-03-22,10,0,34,0,AF
2020-03-23,6,1,40,1,AF
2020-03-24,2,0,42,1,AF
2020-03-25,33,0,75,1,AF
2020-03-26,0,0,75,1,AF
2020-03-27,16,1,91,2,AF
2020-03-28,15,1,106,3,AF
2020-03-29,8,1,114,4,AF
2020-03-30,27,0,141,4,AF
2020-03-31,25,0,166,4,AF
2020-04-01,26,0,192,4,AF
2020-04-02,43,0,235,4,AF
2020-04-03,0,0,235,4,AF
2020-04-04,35,1,270,5,AF
2020-04-05,29,2,299,7,AF
2020-04-06,38,0,337,7,AF
2020-04-07,30,4,367,11,AF
2020-04-08,56,3,423,14,AF
2020-04-09,61,1,484,15,AF
2020-04-10,37,0,521,15,AF
2020-04-11,34,3,555,18,AF
2020-04-12,52,0,607,18,AF
2020-04-13,58,3,665,21,AF
2020-04-14,49,2,714,23,AF
2020-04-15,70,2,784,25,AF
2020-04-16,10,4,794,29,AF
2020-04-17,51,1,845,30,AF
2020-04-18,63,0,908,30,AF
2020-04-19,88,3,996,33,AF
2020-04-20,35,2,1031,35,AF
2020-04-21,61,1,1092,36,AF
2020-04-22,84,4,1176,40,AF
2020-04-23,105,2,1281,42,AF
2020-04-24,70,1,1351,43,AF
2020-04-25,112,4,1463,47,AF
2020-04-26,68,10,1531,57,AF
2020-04-27,172,0,1703,57,AF
2020-04-28,124,3,1827,60,AF
2020-04-29,122,0,1949,60,AF
2020-04-30,222,4,2171,64,AF
2020-05-01,164,4,2335,68,AF
2020-05-02,134,4,2469,72,AF
2020-05-03,235,13,2704,85,AF
2020-05-04,190,5,2894,90,AF
2020-05-05,330,5,3224,95,AF
2020-05-06,168,9,3392,104,AF
2020-05-07,171,2,3563,106,AF
2020-05-08,215,3,3778,109,AF
2020-05-09,255,6,4033,115,AF
2020-05-10,369,5,4402,120,AF
2020-05-11,285,2,4687,122,AF
2020-05-12,280,5,4967,127,AF
2020-05-13,259,3,5226,130,AF
2020-05-14,113,6,5339,136,AF
2020-05-15,1063,32,6402,168,AF
2020-05-16,0,0,6402,168,AF
2020-05-17,262,1,6664,169,AF
2020-05-18,408,4,7072,173,AF
2020-05-19,581,5,7653,178,AF
2020-05-20,492,9,8145,187,AF
2020-05-21,531,6,8676,193,AF
2020-05-22,540,12,9216,205,AF
2020-05-23,782,11,9998,216,AF
2020-05-24,584,2,10582,218,AF
2020-05-25,591,1,11173,219,AF
2020-05-26,658,1,11831,220,AF
2020-05-27,625,7,12456,227,AF
2020-05-28,580,8,13036,235,AF
2020-05-29,623,11,13659,246,AF
2020-05-30,866,3,14525,249,AF
2020-05-31,680,8,15205,257,AF
2020-06-01,545,8,15750,265,AF
2020-06-02,759,5,16509,270,AF
2020-06-03,758,24,17267,294,AF
2020-06-04,787,6,18054,300,AF
2020-06-05,915,9,18969,309,AF
2020-06-06,582,18,19551,327,AF
2020-06-07,791,30,20342,357,AF
2020-06-08,575,12,20917,369,AF
2020-06-09,542,15,21459,384,AF
2020-06-10,684,21,22143,405,AF
2020-06-11,747,21,22890,426,AF
2020-06-12,656,20,23546,446,AF
2020-06-13,556,5,24102,451,AF
2020-06-14,664,20,24766,471,AF
2020-06-15,761,7,25527,478,AF
2020-06-16,783,13,26310,491,AF
2020-06-17,564,13,26874,504,AF
2020-06-18,658,42,27532,546,AF
2020-06-19,346,2,27878,548,AF
2020-06-20,546,21,28424,569,AF
2020-06-21,409,12,28833,581,AF
2020-06-22,310,17,29143,598,AF
2020-06-23,338,20,29481,618,AF
2020-06-24,234,21,29715,639,AF
2020-06-25,460,36,30175,675,AF
2020-06-26,276,8,30451,683,AF
2020-03-14,1,0,1,0,AG
2020-03-20,0,0,1,0,AG
2020-03-21,0,0,1,0,AG
2020-03-22,0,0,1,0,AG
2020-03-23,0,0,1,0,AG
2020-03-24,2,0,3,0,AG
2020-03-25,0,0,3,0,AG
2020-03-26,4,0,7,0,AG
2020-03-27,0,0,7,0,AG
2020-03-28,0,0,7,0,AG
2020-03-29,0,0,7,0,AG
2020-03-30,0,0,7,0,AG
2020-03-31,0,0,7,0,AG
2020-04-01,0,0,7,0,AG
2020-04-02,2,0,9,0,AG
2020-04-03,6,0,15,0,AG
2020-04-04,0,0,15,0,AG
2020-04-05,0,0,15,0,AG
2020-04-06,0,0,15,0,AG
2020-04-07,0,0,15,0,AG
2020-04-08,0,0,15,0,AG
2020-04-09,4,2,19,2,AG
2020-04-10,2,0,21,2,AG
2020-04-11,0,0,21,2,AG
2020-04-12,0,0,21,2,AG
2020-04-13,2,0,23,2,AG
2020-04-14,0,0,23,2,AG
2020-04-15,0,0,23,2,AG
2020-04-16,0,0,23,2,AG
2020-04-17,0,0,23,2,AG
2020-04-18,0,0,23,2,AG
2020-04-19,0,0,23,2,AG
2020-04-20,0,1,23,3,AG
2020-04-21,1,0,24,3,AG
2020-04-22,0,0,24,3,AG
2020-04-23,0,0,24,3,AG
2020-04-24,0,0,24,3,AG
2020-04-25,0,0,24,3,AG
2020-04-26,0,0,24,3,AG
2020-04-27,0,0,24,3,AG
2020-04-28,0,0,24,3,AG
2020-04-29,0,0,24,3,AG
2020-04-30,0,0,24,3,AG
2020-05-01,1,0,25,3,AG
2020-05-02,0,0,25,3,AG
2020-05-03,0,0,25,3,AG
2020-05-04,0,0,25,3,AG
2020-05-05,0,0,25,3,AG
2020-05-06,0,0,25,3,AG
2020-05-07,0,0,25,3,AG
2020-05-08,0,0,25,3,AG
2020-05-09,0,0,25,3,AG
2020-05-10,0,0,25,3,AG
2020-05-11,0,0,25,3,AG
2020-05-12,0,0,25,3,AG
2020-05-13,0,0,25,3,AG
2020-05-14,0,0,25,3,AG
2020-05-15,0,0,25,3,AG
2020-05-16,0,0,25,3,AG
2020-05-17,0,0,25,3,AG
2020-05-18,0,0,25,3,AG
2020-05-19,0,0,25,3,AG
2020-05-20,0,0,25,3,AG
2020-05-21,0,0,25,3,AG
2020-05-22,0,0,25,3,AG
2020-05-23,0,0,25,3,AG
2020-05-24,0,0,25,3,AG
2020-05-25,0,0,25,3,AG
2020-05-26,0,0,25,3,AG
2020-05-27,0,0,25,3,AG
2020-05-28,0,0,25,3,AG
2020-05-29,0,0,25,3,AG
2020-05-30,0,0,25,3,AG
2020-05-31,0,0,25,3,AG
2020-06-01,0,0,25,3,AG
2020-06-02,0,0,25,3,AG
2020-06-03,1,0,26,3,AG
2020-06-04,0,0,26,3,AG
2020-06-05,0,0,26,3,AG
2020-06-06,0,0,26,3,AG
2020-06-07,0,0,26,3,AG
2020-06-08,0,0,26,3,AG
2020-06-09,0,0,26,3,AG
2020-06-10,0,0,26,3,AG
2020-06-11,0,0,26,3,AG
2020-06-12,0,0,26,3,AG
2020-06-13,0,0,26,3,AG
2020-06-14,0,0,26,3,AG
2020-06-15,0,0,26,3,AG
2020-06-16,0,0,26,3,AG
2020-06-17,0,0,26,3,AG
2020-06-18,0,0,26,3,AG
2020-06-19,0,0,26,3,AG
2020-06-20,0,0,26,3,AG
2020-06-21,0,0,26,3,AG
2020-06-22,0,0,26,3,AG
2020-06-23,0,0,26,3,AG
2020-06-24,39,0,65,3,AG
2020-06-25,0,0,65,3,AG
2020-06-26,0,0,65,3,AG
2020-03-26,2,0,2,0,AI
2020-03-27,0,0,2,0,AI
2020-03-28,0,0,2,0,AI
2020-03-29,0,0,2,0,AI
2020-03-30,0,0,2,0,AI
2020-03-31,0,0,2,0,AI
2020-04-01,0,0,2,0,AI
2020-04-02,1,0,3,0,AI
2020-04-03,0,0,3,0,AI
2020-04-04,0,0,3,0,AI
2020-04-05,0,0,3,0,AI
2020-04-06,0,0,3,0,AI
2020-04-07,0,0,3,0,AI
2020-04-08,0,0,3,0,AI
2020-04-09,0,0,3,0,AI
2020-04-10,0,0,3,0,AI
2020-04-11,0,0,3,0,AI
2020-04-12,0,0,3,0,AI
2020-04-13,0,0,3,0,AI
2020-04-14,0,0,3,0,AI
2020-04-15,0,0,3,0,AI
2020-04-16,0,0,3,0,AI
2020-04-17,0,0,3,0,AI
2020-04-18,0,0,3,0,AI
2020-04-19,0,0,3,0,AI
2020-04-20,0,0,3,0,AI
2020-04-21,0,0,3,0,AI
2020-04-22,0,0,3,0,AI
2020-04-23,0,0,3,0,AI
2020-04-24,0,0,3,0,AI
2020-04-25,0,0,3,0,AI
2020-04-26,0,0,3,0,AI
2020-04-27,0,0,3,0,AI
2020-04-28,0,0,3,0,AI
2020-04-29,0,0,3,0,AI
2020-04-30,0,0,3,0,AI
2020-05-01,0,0,3,0,AI
2020-05-02,0,0,3,0,AI
2020-05-03,0,0,3,0,AI
2020-05-04,0,0,3,0,AI
2020-05-05,0,0,3,0,AI
2020-05-06,0,0,3,0,AI
2020-05-07,0,0,3,0,AI
2020-05-08,0,0,3,0,AI
2020-05-09,0,0,3,0,AI
2020-05-10,0,0,3,0,AI
2020-05-11,0,0,3,0,AI
2020-05-12,0,0,3,0,AI
2020-05-13,0,0,3,0,AI
2020-05-14,0,0,3,0,AI
2020-05-15,0,0,3,0,AI
2020-05-16,0,0,3,0,AI
2020-05-17,0,0,3,0,AI
2020-05-18,0,0,3,0,AI
2020-05-19,0,0,3,0,AI
2020-05-20,0,0,3,0,AI
2020-05-21,0,0,3,0,AI
2020-05-22,0,0,3,0,AI
2020-05-23,0,0,3,0,AI
2020-05-24,0,0,3,0,AI
2020-05-25,0,0,3,0,AI
2020-05-26,0,0,3,0,AI
2020-05-27,0,0,3,0,AI
2020-05-28,0,0,3,0,AI
2020-05-29,0,0,3,0,AI
2020-05-30,0,0,3,0,AI
2020-05-31,0,0,3,0,AI
2020-06-01,0,0,3,0,AI
2020-06-02,0,0,3,0,AI
2020-06-03,0,0,3,0,AI
2020-06-04,0,0,3,0,AI
2020-06-05,0,0,3,0,AI
2020-06-06,0,0,3,0,AI
2020-06-07,0,0,3,0,AI
2020-06-08,0,0,3,0,AI
2020-06-09,0,0,3,0,AI
2020-06-10,0,0,3,0,AI
2020-06-11,0,0,3,0,AI
2020-06-12,0,0,3,0,AI
2020-06-13,0,0,3,0,AI
2020-06-14,0,0,3,0,AI
2020-06-15,0,0,3,0,AI
2020-06-16,0,0,3,0,AI
2020-06-17,0,0,3,0,AI
2020-06-18,0,0,3,0,AI
2020-06-19,0,0,3,0,AI
2020-06-20,0,0,3,0,AI
2020-06-21,0,0,3,0,AI
2020-06-22,0,0,3,0,AI
2020-06-23,0,0,3,0,AI
2020-06-24,0,0,3,0,AI
2020-06-25,0,0,3,0,AI
2020-06-26,0,0,3,0,AI
2020-03-08,2,0,2,0,AL
2020-03-09,4,0,6,0,AL
2020-03-10,4,0,10,0,AL
2020-03-11,1,1,11,1,AL
2020-03-12,12,0,23,1,AL
2020-03-13,10,0,33,1,AL
2020-03-14,5,0,38,1,AL
2020-03-15,4,0,42,1,AL
2020-03-16,9,0,51,1,AL
2020-03-17,4,0,55,1,AL
2020-03-18,4,1,59,2,AL
2020-03-19,11,0,70,2,AL
2020-03-20,0,0,70,2,AL
2020-03-21,6,0,76,2,AL
2020-03-22,13,0,89,2,AL
2020-03-23,11,2,100,4,AL
2020-03-24,23,1,123,5,AL
2020-03-25,23,0,146,5,AL
2020-03-26,28,1,174,6,AL
2020-03-27,12,3,186,9,AL
2020-03-28,11,1,197,10,AL
2020-03-29,15,0,212,10,AL
2020-03-30,11,2,223,12,AL
2020-03-31,20,3,243,15,AL
2020-04-01,16,0,259,15,AL
2020-04-02,18,1,277,16,AL
2020-04-03,27,1,304,17,AL
2020-04-04,29,2,333,19,AL
2020-04-05,28,2,361,21,AL
2020-04-06,16,1,377,22,AL
2020-04-07,6,0,383,22,AL
2020-04-08,17,0,400,22,AL
2020-04-09,9,1,409,23,AL
2020-04-10,7,0,416,23,AL
2020-04-11,17,0,433,23,AL
2020-04-12,13,0,446,23,AL
2020-04-13,21,0,467,23,AL
2020-04-14,8,1,475,24,AL
2020-04-15,19,1,494,25,AL
2020-04-16,24,1,518,26,AL
2020-04-17,21,0,539,26,AL
2020-04-18,9,0,548,26,AL
2020-04-19,14,0,562,26,AL
2020-04-20,22,0,584,26,AL
2020-04-21,25,0,609,26,AL
2020-04-22,25,1,634,27,AL
2020-04-23,29,0,663,27,AL
2020-04-24,15,0,678,27,AL
2020-04-25,34,0,712,27,AL
2020-04-26,14,1,726,28,AL
2020-04-27,10,0,736,28,AL
2020-04-28,14,2,750,30,AL
2020-04-29,16,1,766,31,AL
2020-04-30,7,0,773,31,AL
2020-05-01,9,0,782,31,AL
2020-05-02,7,0,789,31,AL
2020-05-03,6,0,795,31,AL
2020-05-04,8,0,803,31,AL
2020-05-05,17,0,820,31,AL
2020-05-06,12,0,832,31,AL
2020-05-07,10,0,842,31,AL
2020-05-08,8,0,850,31,AL
2020-05-09,6,0,856,31,AL
2020-05-10,12,0,868,31,AL
2020-05-11,4,0,872,31,AL
2020-05-12,4,0,876,31,AL
2020-05-13,4,0,880,31,AL
2020-05-14,18,0,898,31,AL
2020-05-15,18,0,916,31,AL
2020-05-16,17,0,933,31,AL
2020-05-17,13,0,946,31,AL
2020-05-18,2,0,948,31,AL
2020-05-19,1,0,949,31,AL
2020-05-20,15,0,964,31,AL
2020-05-21,5,0,969,31,AL
2020-05-22,12,0,981,31,AL
2020-05-23,8,0,989,31,AL
2020-05-24,9,1,998,32,AL
2020-05-25,6,0,1004,32,AL
2020-05-26,25,1,1029,33,AL
2020-05-27,21,0,1050,33,AL
2020-05-28,26,0,1076,33,AL
2020-05-29,23,0,1099,33,AL
2020-05-30,23,0,1122,33,AL
2020-05-31,15,0,1137,33,AL
2020-06-01,6,0,1143,33,AL
2020-06-02,21,0,1164,33,AL
2020-06-03,20,0,1184,33,AL
2020-06-04,13,0,1197,33,AL
2020-06-05,15,0,1212,33,AL
2020-06-06,20,1,1232,34,AL
2020-06-07,14,0,1246,34,AL
2020-06-08,17,0,1263,34,AL
2020-06-09,36,0,1299,34,AL
2020-06-10,42,0,1341,34,AL
2020-06-11,44,1,1385,35,AL
2020-06-12,31,1,1416,36,AL
2020-06-13,48,0,1464,36,AL
2020-06-14,57,0,1521,36,AL
2020-06-15,69,0,1590,36,AL
2020-06-16,82,1,1672,37,AL
2020-06-17,50,1,1722,38,AL
2020-06-18,66,1,1788,39,AL
2020-06-19,50,3,1838,42,AL
2020-06-20,53,1,1891,43,AL
2020-06-21,36,1,1927,44,AL
2020-06-22,68,0,1995,44,AL
2020-06-23,52,1,2047,45,AL
2020-06-24,67,2,2114,47,AL
2020-06-25,78,2,2192,49,AL
2020-06-26,77,2,2269,51,AL
2019-12-30,0,0,0,0,AM
2019-12-31,0,0,0,0,AM
2020-01-01,0,0,0,0,AM
2020-01-02,0,0,0,0,AM
2020-01-03,0,0,0,0,AM
2020-01-04,0,0,0,0,AM
2020-01-05,0,0,0,0,AM
2020-01-06,0,0,0,0,AM
2020-01-07,0,0,0,0,AM
2020-01-08,0,0,0,0,AM
2020-01-09,0,0,0,0,AM
2020-01-10,0,0,0,0,AM
2020-01-11,0,0,0,0,AM
2020-01-12,0,0,0,0,AM
2020-01-13,0,0,0,0,AM
2020-01-14,0,0,0,0,AM
2020-01-15,0,0,0,0,AM
2020-01-16,0,0,0,0,AM
2020-01-17,0,0,0,0,AM
2020-01-18,0,0,0,0,AM
2020-01-19,0,0,0,0,AM
2020-01-20,0,0,0,0,AM
2020-01-21,0,0,0,0,AM
2020-01-22,0,0,0,0,AM
2020-01-23,0,0,0,0,AM
2020-01-24,0,0,0,0,AM
2020-01-25,0,0,0,0,AM
2020-01-26,0,0,0,0,AM
2020-01-27,0,0,0,0,AM
2020-01-28,0,0,0,0,AM
2020-01-29,0,0,0,0,AM
2020-01-30,0,0,0,0,AM
2020-01-31,0,0,0,0,AM
2020-02-01,0,0,0,0,AM
2020-02-02,0,0,0,0,AM
2020-02-03,0,0,0,0,AM
2020-02-04,0,0,0,0,AM
2020-02-05,0,0,0,0,AM
2020-02-06,0,0,0,0,AM
2020-02-07,0,0,0,0,AM
2020-02-08,0,0,0,0,AM
2020-02-09,0,0,0,0,AM
2020-02-10,0,0,0,0,AM
2020-02-11,0,0,0,0,AM
2020-02-12,0,0,0,0,AM
2020-02-13,0,0,0,0,AM
2020-02-14,0,0,0,0,AM
2020-02-15,0,0,0,0,AM
2020-02-16,0,0,0,0,AM
2020-02-17,0,0,0,0,AM
2020-02-18,0,0,0,0,AM
2020-02-19,0,0,0,0,AM
2020-02-20,0,0,0,0,AM
2020-02-21,0,0,0,0,AM
2020-02-22,0,0,0,0,AM
2020-02-23,0,0,0,0,AM
2020-02-24,0,0,0,0,AM
2020-02-25,0,0,0,0,AM
2020-02-26,0,0,0,0,AM
2020-02-27,0,0,0,0,AM
2020-02-28,0,0,0,0,AM
2020-02-29,1,0,1,0,AM
2020-03-01,0,0,1,0,AM
2020-03-11,3,0,4,0,AM
2020-03-12,2,0,6,0,AM
2020-03-13,7,0,13,0,AM
2020-03-14,7,0,20,0,AM
2020-03-15,10,0,30,0,AM
2020-03-16,22,0,52,0,AM
2020-03-17,26,0,78,0,AM
2020-03-18,37,0,115,0,AM
2020-03-19,7,0,122,0,AM
2020-03-20,14,0,136,0,AM
2020-03-21,24,0,160,0,AM
2020-03-22,30,0,190,0,AM
2020-03-23,4,0,194,0,AM
2020-03-24,71,0,265,0,AM
2020-03-25,25,0,290,0,AM
2020-03-26,39,1,329,1,AM
2020-03-27,43,0,372,1,AM
2020-03-28,52,2,424,3,AM
2020-03-29,0,0,424,3,AM
2020-03-30,58,0,482,3,AM
2020-03-31,50,0,532,3,AM
2020-04-01,39,0,571,3,AM
2020-04-02,92,1,663,4,AM
2020-04-03,73,3,736,7,AM
2020-04-04,34,0,770,7,AM
2020-04-05,52,0,822,7,AM
2020-04-06,11,1,833,8,AM
2020-04-07,20,0,853,8,AM
2020-04-08,28,1,881,9,AM
2020-04-09,40,1,921,10,AM
2020-04-10,16,1,937,11,AM
2020-04-11,30,2,967,13,AM
2020-04-12,46,0,1013,13,AM
2020-04-13,26,1,1039,14,AM
2020-04-14,72,3,1111,17,AM
2020-04-15,48,1,1159,18,AM
2020-04-16,42,1,1201,19,AM
2020-04-17,47,1,1248,20,AM
2020-04-18,43,0,1291,20,AM
2020-04-19,48,2,1339,22,AM
2020-04-20,62,2,1401,24,AM
2020-04-21,72,0,1473,24,AM
2020-04-22,50,0,1523,24,AM
2020-04-23,73,3,1596,27,AM
2020-04-24,81,1,1677,28,AM
2020-04-25,69,0,1746,28,AM
2020-04-26,62,1,1808,29,AM
2020-04-27,59,1,1867,30,AM
2020-04-28,65,0,1932,30,AM
2020-04-29,0,0,1932,30,AM
2020-04-30,134,2,2066,32,AM
2020-05-01,82,1,2148,33,AM
2020-05-02,125,0,2273,33,AM
2020-05-03,113,2,2386,35,AM
2020-05-04,121,4,2507,39,AM
2020-05-05,112,1,2619,40,AM
2020-05-06,163,0,2782,40,AM
2020-05-07,102,2,2884,42,AM
2020-05-08,145,1,3029,43,AM
2020-05-09,146,1,3175,44,AM
2020-05-10,138,1,3313,45,AM
2020-05-11,79,1,3392,46,AM
2020-05-12,146,1,3538,47,AM
2020-05-13,180,1,3718,48,AM
2020-05-14,142,1,3860,49,AM
2020-05-15,184,3,4044,52,AM
2020-05-16,239,3,4283,55,AM
2020-05-17,189,5,4472,60,AM
2020-05-18,351,1,4823,61,AM
2020-05-19,218,3,5041,64,AM
2020-05-20,230,3,5271,67,AM
2020-05-21,335,3,5606,70,AM
2020-05-22,322,4,5928,74,AM
2020-05-23,374,3,6302,77,AM
2020-05-24,359,4,6661,81,AM
2020-05-25,452,6,7113,87,AM
2020-05-26,289,4,7402,91,AM
2020-05-27,372,7,7774,98,AM
2020-05-28,442,15,8216,113,AM
2020-05-29,460,7,8676,120,AM
2020-05-30,251,7,8927,127,AM
2020-05-31,355,4,9282,131,AM
2020-06-01,210,8,9492,139,AM
2020-06-02,517,19,10009,158,AM
2020-06-03,515,12,10524,170,AM
2020-06-04,697,6,11221,176,AM
2020-06-05,596,7,11817,183,AM
2020-06-06,547,7,12364,190,AM
2020-06-07,766,10,13130,200,AM
2020-06-08,195,11,13325,211,AM
2020-06-09,350,6,13675,217,AM
2020-06-10,428,10,14103,227,AM
2020-06-11,566,18,14669,245,AM
2020-06-12,612,13,15281,258,AM
2020-06-13,723,6,16004,264,AM
2020-06-14,663,5,16667,269,AM
2020-06-15,397,16,17064,285,AM
2020-06-16,425,8,17489,293,AM
2020-06-17,544,9,18033,302,AM
2020-06-18,665,7,18698,309,AM
2020-06-19,459,10,19157,319,AM
2020-06-20,551,13,19708,332,AM
2020-06-21,880,28,20588,360,AM
2020-06-22,0,0,20588,360,AM
2020-06-23,1129,26,21717,386,AM
2020-06-24,0,0,21717,386,AM
2020-06-25,1530,24,23247,410,AM
2020-06-26,662,10,23909,420,AM
2020-03-21,2,0,2,0,AO
2020-03-22,0,0,2,0,AO
2020-03-23,0,0,2,0,AO
2020-03-24,0,0,2,0,AO
2020-03-25,0,0,2,0,AO
2020-03-26,1,0,3,0,AO
2020-03-27,1,0,4,0,AO
2020-03-28,0,0,4,0,AO
2020-03-29,3,2,7,2,AO
2020-03-30,0,0,7,2,AO
2020-03-31,0,0,7,2,AO
2020-04-01,1,0,8,2,AO
2020-04-02,0,0,8,2,AO
2020-04-03,0,0,8,2,AO
2020-04-04,2,0,10,2,AO
2020-04-05,4,0,14,2,AO
2020-04-06,2,0,16,2,AO
2020-04-07,1,0,17,2,AO
2020-04-08,2,0,19,2,AO
2020-04-09,0,0,19,2,AO
2020-04-10,0,0,19,2,AO
2020-04-11,0,0,19,2,AO
2020-04-12,0,0,19,2,AO
2020-04-13,0,0,19,2,AO
2020-04-14,0,0,19,2,AO
2020-04-15,0,0,19,2,AO
2020-04-16,0,0,19,2,AO
2020-04-17,0,0,19,2,AO
2020-04-18,5,0,24,2,AO
2020-04-19,0,0,24,2,AO
2020-04-20,0,0,24,2,AO
2020-04-21,0,0,24,2,AO
2020-04-22,0,0,24,2,AO
2020-04-23,1,0,25,2,AO
2020-04-24,0,0,25,2,AO
2020-04-25,0,0,25,2,AO
2020-04-26,1,0,26,2,AO
2020-04-27,1,0,27,2,AO
2020-04-28,0,0,27,2,AO
2020-04-29,0,0,27,2,AO
2020-04-30,0,0,27,2,AO
2020-05-01,2,0,29,2,AO
2020-05-02,6,0,35,2,AO
2020-05-03,0,0,35,2,AO
2020-05-04,0,0,35,2,AO
2020-05-05,1,0,36,2,AO
2020-05-06,0,0,36,2,AO
2020-05-07,0,0,36,2,AO
2020-05-08,7,0,43,2,AO
2020-05-09,0,0,43,2,AO
2020-05-10,2,0,45,2,AO
2020-05-11,0,0,45,2,AO
2020-05-12,0,0,45,2,AO
2020-05-13,0,0,45,2,AO
2020-05-14,3,0,48,2,AO
2020-05-15,0,0,48,2,AO
2020-05-16,0,0,48,2,AO
2020-05-17,0,0,48,2,AO
2020-05-18,0,0,48,2,AO
2020-05-19,2,0,50,2,AO
2020-05-20,2,1,52,3,AO
2020-05-21,6,0,58,3,AO
2020-05-22,2,0,60,3,AO
2020-05-23,0,0,60,3,AO
2020-05-24,9,1,69,4,AO
2020-05-25,0,0,69,4,AO
2020-05-26,2,0,71,4,AO
2020-05-27,0,0,71,4,AO
2020-05-28,2,0,73,4,AO
2020-05-29,4,0,77,4,AO
2020-05-30,7,0,84,4,AO
2020-05-31,2,0,86,4,AO
2020-06-01,0,0,86,4,AO
2020-06-02,0,0,86,4,AO
2020-06-03,0,0,86,4,AO
2020-06-04,0,0,86,4,AO
2020-06-05,0,0,86,4,AO
2020-06-06,0,0,86,4,AO
2020-06-07,5,0,91,4,AO
2020-06-08,1,0,92,4,AO
2020-06-09,4,0,96,4,AO
2020-06-10,17,0,113,4,AO
2020-06-11,5,1,118,5,AO
2020-06-12,12,0,130,5,AO
2020-06-13,8,1,138,6,AO
2020-06-14,2,0,140,6,AO
2020-06-15,2,0,142,6,AO
2020-06-16,0,0,142,6,AO
2020-06-17,13,1,155,7,AO
2020-06-18,0,0,155,7,AO
2020-06-19,11,1,166,8,AO
2020-06-20,6,0,172,8,AO
2020-06-21,4,1,176,9,AO
2020-06-22,7,0,183,9,AO
2020-06-23,3,1,186,10,AO
2020-06-24,3,0,189,10,AO
2020-06-25,8,0,197,10,AO
2020-06-26,15,0,212,10,AO
2020-03-03,1,0,1,0,AR
2020-03-05,1,0,2,0,AR
2020-03-06,6,0,8,0,AR
2020-03-07,1,1,9,1,AR
2020-03-08,3,0,12,1,AR
2020-03-10,7,0,19,1,AR
2020-03-12,12,0,31,1,AR
2020-03-13,3,1,34,2,AR
2020-03-14,11,0,45,2,AR
2020-03-15,11,0,56,2,AR
2020-03-16,9,0,65,2,AR
2020-03-17,14,0,79,2,AR
2020-03-18,18,0,97,2,AR
2020-03-19,31,1,128,3,AR
2020-03-20,30,0,158,3,AR
2020-03-21,67,1,225,4,AR
2020-03-22,41,0,266,4,AR
2020-03-23,35,0,301,4,AR
2020-03-24,86,2,387,6,AR
2020-03-25,115,2,502,8,AR
2020-03-26,87,4,589,12,AR
2020-03-27,101,5,690,17,AR
2020-03-28,55,2,745,19,AR
2020-03-29,75,1,820,20,AR
2020-03-30,146,4,966,24,AR
2020-03-31,0,0,966,24,AR
2020-04-01,167,7,1133,31,AR
2020-04-02,0,3,1133,34,AR
2020-04-03,132,3,1265,37,AR
2020-04-04,186,6,1451,43,AR
2020-04-05,103,3,1554,46,AR
2020-04-06,74,7,1628,53,AR
2020-04-07,87,7,1715,60,AR
2020-04-08,80,5,1795,65,AR
2020-04-09,99,14,1894,79,AR
2020-04-10,81,3,1975,82,AR
2020-04-11,162,7,2137,89,AR
2020-04-12,66,6,2203,95,AR
2020-04-13,69,3,2272,98,AR
2020-04-14,160,7,2432,105,AR
2020-04-15,0,4,2432,109,AR
2020-04-16,128,6,2560,115,AR
2020-04-17,98,7,2658,122,AR
2020-04-18,170,10,2828,132,AR
2020-04-19,102,2,2930,134,AR
2020-04-20,90,8,3020,142,AR
2020-04-21,112,9,3132,151,AR
2020-04-22,144,8,3276,159,AR
2020-04-23,147,6,3423,165,AR
2020-04-24,0,2,3423,167,AR
2020-04-25,344,18,3767,185,AR
2020-04-26,0,1,3767,186,AR
2020-04-27,223,11,3990,197,AR
2020-04-28,124,10,4114,207,AR
2020-04-29,158,7,4272,214,AR
2020-04-30,143,4,4415,218,AR
2020-05-01,104,7,4519,225,AR
2020-05-02,149,12,4668,237,AR
2020-05-03,102,9,4770,246,AR
2020-05-04,104,14,4874,260,AR
2020-05-05,133,4,5007,264,AR
2020-05-06,188,9,5195,273,AR
2020-05-07,163,9,5358,282,AR
2020-05-08,240,11,5598,293,AR
2020-05-09,165,7,5763,300,AR
2020-05-10,13,0,5776,300,AR
2020-05-11,245,5,6021,305,AR
2020-05-12,529,14,6550,319,AR
2020-05-13,316,10,6866,329,AR
2020-05-14,255,24,7121,353,AR
2020-05-15,345,3,7466,356,AR
2020-05-16,326,7,7792,363,AR
2020-05-17,0,3,7792,366,AR
2020-05-18,566,16,8358,382,AR
2020-05-19,438,11,8796,393,AR
2020-05-20,474,10,9270,403,AR
2020-05-21,648,13,9918,416,AR
2020-05-22,718,17,10636,433,AR
2020-05-23,704,12,11340,445,AR
2020-05-24,723,7,12063,452,AR
2020-05-25,552,15,12615,467,AR
2020-05-26,600,17,13215,484,AR
2020-05-27,705,16,13920,500,AR
2020-05-28,769,8,14689,508,AR
2020-05-29,717,12,15406,520,AR
2020-05-30,795,8,16201,528,AR
2020-05-31,637,11,16838,539,AR
2020-06-01,564,17,17402,556,AR
2020-06-02,904,13,18306,569,AR
2020-06-03,949,14,19255,583,AR
2020-06-04,0,5,19255,588,AR
2020-06-05,1769,44,21024,632,AR
2020-06-06,983,16,22007,648,AR
2020-06-07,774,16,22781,664,AR
2020-06-08,826,29,23607,693,AR
2020-06-09,1141,24,24748,717,AR
2020-06-10,1239,18,25987,735,AR
2020-06-11,1373,30,27360,765,AR
2020-06-12,1391,20,28751,785,AR
2020-06-13,1531,30,30282,815,AR
2020-06-14,1282,18,31564,833,AR
2020-06-15,1208,21,32772,854,AR
2020-06-16,1374,24,34146,878,AR
2020-06-17,1393,35,35539,913,AR
2020-06-18,0,16,35539,929,AR
2020-06-19,4018,50,39557,979,AR
2020-06-20,1634,13,41191,992,AR
2020-06-21,1581,19,42772,1011,AR
2020-06-22,2146,32,44918,1043,AR
2020-06-23,0,6,44918,1049,AR
2020-06-24,4920,36,49838,1085,AR
2020-06-25,2606,39,52444,1124,AR
2020-06-26,0,43,52444,1167,AR
2019-12-30,0,0,0,0,AT
2019-12-31,0,0,0,0,AT
2020-01-01,0,0,0,0,AT
2020-01-02,0,0,0,0,AT
2020-01-03,0,0,0,0,AT
2020-01-04,0,0,0,0,AT
2020-01-05,0,0,0,0,AT
2020-01-06,0,0,0,0,AT
2020-01-07,0,0,0,0,AT
2020-01-08,0,0,0,0,AT
2020-01-09,0,0,0,0,AT
2020-01-10,0,0,0,0,AT
2020-01-11,0,0,0,0,AT
2020-01-12,0,0,0,0,AT
2020-01-13,0,0,0,0,AT
2020-01-14,0,0,0,0,AT
2020-01-15,0,0,0,0,AT
2020-01-16,0,0,0,0,AT
2020-01-17,0,0,0,0,AT
2020-01-18,0,0,0,0,AT
2020-01-19,0,0,0,0,AT
2020-01-20,0,0,0,0,AT
2020-01-21,0,0,0,0,AT
2020-01-22,0,0,0,0,AT
2020-01-23,0,0,0,0,AT
2020-01-24,0,0,0,0,AT
2020-01-25,0,0,0,0,AT
2020-01-26,0,0,0,0,AT
2020-01-27,0,0,0,0,AT
2020-01-28,0,0,0,0,AT
2020-01-29,0,0,0,0,AT
2020-01-30,0,0,0,0,AT
2020-01-31,0,0,0,0,AT
2020-02-01,0,0,0,0,AT
2020-02-02,0,0,0,0,AT
2020-02-03,0,0,0,0,AT
2020-02-04,0,0,0,0,AT
2020-02-05,0,0,0,0,AT
2020-02-06,0,0,0,0,AT
2020-02-07,0,0,0,0,AT
2020-02-08,0,0,0,0,AT
2020-02-09,0,0,0,0,AT
2020-02-10,0,0,0,0,AT
2020-02-11,0,0,0,0,AT
2020-02-12,0,0,0,0,AT
2020-02-13,0,0,0,0,AT
2020-02-14,0,0,0,0,AT
2020-02-15,0,0,0,0,AT
2020-02-16,0,0,0,0,AT
2020-02-17,0,0,0,0,AT
2020-02-18,0,0,0,0,AT
2020-02-19,0,0,0,0,AT
2020-02-20,0,0,0,0,AT
2020-02-21,0,0,0,0,AT
2020-02-22,0,0,0,0,AT
2020-02-23,0,0,0,0,AT
2020-02-24,0,0,0,0,AT
2020-02-25,2,0,2,0,AT
2020-02-26,0,0,2,0,AT
2020-02-27,3,0,5,0,AT
2020-02-28,2,0,7,0,AT
2020-02-29,3,0,10,0,AT
2020-03-01,4,0,14,0,AT
2020-03-02,4,0,18,0,AT
2020-03-03,6,0,24,0,AT
2020-03-04,5,0,29,0,AT
2020-03-05,12,0,41,0,AT
2020-03-06,33,0,74,0,AT
2020-03-07,25,0,99,0,AT
2020-03-08,3,0,102,0,AT
2020-03-09,29,0,131,0,AT
2020-03-10,51,0,182,0,AT
2020-03-11,64,0,246,0,AT
2020-03-12,115,1,361,1,AT
2020-03-13,143,0,504,1,AT
2020-03-14,151,0,655,1,AT
2020-03-15,205,0,860,1,AT
2020-03-16,156,2,1016,3,AT
2020-03-17,316,0,1332,3,AT
2020-03-18,314,1,1646,4,AT
2020-03-19,550,2,2196,6,AT
2020-03-20,453,0,2649,6,AT
2020-03-21,375,2,3024,8,AT
2020-03-22,607,8,3631,16,AT
2020-03-23,855,9,4486,25,AT
2020-03-24,796,5,5282,30,AT
2020-03-25,606,4,5888,34,AT
2020-03-26,1141,18,7029,52,AT
2020-03-27,668,16,7697,68,AT
2020-03-28,594,0,8291,68,AT
2020-03-29,522,18,8813,86,AT
2020-03-30,805,22,9618,108,AT
2020-03-31,564,20,10182,128,AT
2020-04-01,529,18,10711,146,AT
2020-04-02,418,12,11129,158,AT
2020-04-03,396,10,11525,168,AT
2020-04-04,241,18,11766,186,AT
2020-04-05,217,18,11983,204,AT
2020-04-06,314,16,12297,220,AT
2020-04-07,343,23,12640,243,AT
2020-04-08,329,30,12969,273,AT
2020-04-09,279,22,13248,295,AT
2020-04-10,312,24,13560,319,AT
2020-04-11,247,18,13807,337,AT
2020-04-12,130,13,13937,350,AT
2020-04-13,106,18,14043,368,AT
2020-04-14,191,16,14234,384,AT
2020-04-15,136,9,14370,393,AT
2020-04-16,78,17,14448,410,AT
2020-04-17,155,21,14603,431,AT
2020-04-18,59,12,14662,443,AT
2020-04-19,48,9,14710,452,AT
2020-04-20,73,10,14783,462,AT
2020-04-21,50,1,14833,463,AT
2020-04-22,91,31,14924,494,AT
2020-04-23,61,14,14985,508,AT
2020-04-24,83,5,15068,513,AT
2020-04-25,66,23,15134,536,AT
2020-04-26,55,6,15189,542,AT
2020-04-27,67,7,15256,549,AT
2020-04-28,58,20,15314,569,AT
2020-04-29,50,11,15364,580,AT
2020-04-30,60,4,15424,584,AT
2020-05-01,34,5,15458,589,AT
2020-05-02,12,7,15470,596,AT
2020-05-03,68,2,15538,598,AT
2020-05-04,31,2,15569,600,AT
2020-05-05,17,6,15586,606,AT
2020-05-06,65,2,15651,608,AT
2020-05-07,22,1,15673,609,AT
2020-05-08,62,5,15735,614,AT
2020-05-09,42,1,15777,615,AT
2020-05-10,10,3,15787,618,AT
2020-05-11,87,2,15874,620,AT
2020-05-12,36,3,15910,623,AT
2020-05-13,54,1,15964,624,AT
2020-05-14,41,2,16005,626,AT
2020-05-15,63,2,16068,628,AT
2020-05-16,72,0,16140,628,AT
2020-05-17,14,1,16154,629,AT
2020-05-18,25,0,16179,629,AT
2020-05-19,78,3,16257,632,AT
2020-05-20,18,1,16275,633,AT
2020-05-21,57,0,16332,633,AT
2020-05-22,29,2,16361,635,AT
2020-05-23,46,4,16407,639,AT
2020-05-24,32,1,16439,640,AT
2020-05-25,20,1,16459,641,AT
2020-05-26,38,2,16497,643,AT
2020-05-27,18,2,16515,645,AT
2020-05-28,28,23,16543,668,AT
2020-05-29,51,0,16594,668,AT
2020-05-30,44,0,16638,668,AT
2020-05-31,4,0,16642,668,AT
2020-06-01,21,0,16663,668,AT
2020-06-02,11,1,16674,669,AT
2020-06-03,31,1,16705,670,AT
2020-06-04,36,0,16741,670,AT
2020-06-05,62,2,16803,672,AT
2020-06-06,19,0,16822,672,AT
2020-06-07,46,0,16868,672,AT
2020-06-08,21,0,16889,672,AT
2020-06-09,13,0,16902,672,AT
2020-06-10,34,1,16936,673,AT
2020-06-11,28,1,16964,674,AT
2020-06-12,30,1,16994,675,AT
2020-06-13,20,2,17014,677,AT
2020-06-14,24,0,17038,677,AT
2020-06-15,27,1,17065,678,AT
2020-06-16,33,3,17098,681,AT
2020-06-17,17,6,17115,687,AT
2020-06-18,40,1,17155,688,AT
2020-06-19,30,0,17185,688,AT
2020-06-20,62,0,17247,688,AT
2020-06-21,38,2,17285,690,AT
2020-06-22,35,0,17320,690,AT
2020-06-23,31,3,17351,693,AT
2020-06-24,33,0,17384,693,AT
2020-06-25,47,5,17431,698,AT
2020-06-26,67,0,17498,698,AT
2019-12-30,0,0,0,0,AU
2019-12-31,0,0,0,0,AU
2020-01-01,0,0,0,0,AU
2020-01-02,0,0,0,0,AU
2020-01-03,0,0,0,0,AU
2020-01-04,0,0,0,0,AU
2020-01-05,0,0,0,0,AU
2020-01-06,0,0,0,0,AU
2020-01-07,0,0,0,0,AU
2020-01-08,0,0,0,0,AU
2020-01-09,0,0,0,0,AU
2020-01-10,0,0,0,0,AU
2020-01-11,0,0,0,0,AU
2020-01-12,0,0,0,0,AU
2020-01-13,0,0,0,0,AU
2020-01-14,0,0,0,0,AU
2020-01-15,0,0,0,0,AU
2020-01-16,0,0,0,0,AU
2020-01-17,0,0,0,0,AU
2020-01-18,0,0,0,0,AU
2020-01-19,0,0,0,0,AU
2020-01-20,0,0,0,0,AU
2020-01-21,0,0,0,0,AU
2020-01-22,0,0,0,0,AU
2020-01-23,0,0,0,0,AU
2020-01-24,1,0,1,0,AU
2020-01-25,3,0,4,0,AU
2020-01-26,0,0,4,0,AU
2020-01-27,0,0,4,0,AU
2020-01-28,0,0,4,0,AU
2020-01-29,2,0,6,0,AU
2020-01-30,1,0,7,0,AU
2020-01-31,2,0,9,0,AU
2020-02-01,2,0,11,0,AU
2020-02-02,0,0,11,0,AU
2020-02-03,0,0,11,0,AU
2020-02-04,1,0,12,0,AU
2020-02-05,1,0,13,0,AU
2020-02-06,1,0,14,0,AU
2020-02-07,0,0,14,0,AU
2020-02-08,0,0,14,0,AU
2020-02-09,0,0,14,0,AU
2020-02-10,0,0,14,0,AU
2020-02-11,0,0,14,0,AU
2020-02-12,0,0,14,0,AU
2020-02-13,1,0,15,0,AU
2020-02-14,0,0,15,0,AU
2020-02-15,0,0,15,0,AU
2020-02-16,0,0,15,0,AU
2020-02-17,0,0,15,0,AU
2020-02-18,0,0,15,0,AU
2020-02-19,0,0,15,0,AU
2020-02-20,2,0,17,0,AU
2020-02-21,4,0,21,0,AU
2020-02-22,1,0,22,0,AU
2020-02-23,0,0,22,0,AU
2020-02-24,0,0,22,0,AU
2020-02-25,0,0,22,0,AU
2020-02-26,1,0,23,0,AU
2020-02-27,0,0,23,0,AU
2020-02-28,2,0,25,0,AU
2020-02-29,1,1,26,1,AU
2020-03-01,3,0,29,1,AU
2020-03-02,4,0,33,1,AU
2020-03-03,8,0,41,1,AU
2020-03-04,11,1,52,2,AU
2020-03-05,7,0,59,2,AU
2020-03-06,4,0,63,2,AU
2020-03-07,11,1,74,3,AU
2020-03-08,6,0,80,3,AU
2020-03-09,20,0,100,3,AU
2020-03-10,12,0,112,3,AU
2020-03-11,14,0,126,3,AU
2020-03-12,30,0,156,3,AU
2020-03-13,41,0,197,3,AU
2020-03-14,52,0,249,3,AU
2020-03-15,49,2,298,5,AU
2020-03-16,77,0,375,5,AU
2020-03-17,79,0,454,5,AU
2020-03-18,111,1,565,6,AU
2020-03-19,144,0,709,6,AU
2020-03-20,165,1,874,7,AU
2020-03-21,224,0,1098,7,AU
2020-03-22,611,0,1709,7,AU
2020-03-23,114,0,1823,7,AU
2020-03-24,600,1,2423,8,AU
2020-03-25,376,3,2799,11,AU
2020-03-26,367,2,3166,13,AU
2020-03-27,212,0,3378,13,AU
2020-03-28,431,1,3809,14,AU
2020-03-29,284,2,4093,16,AU
2020-03-30,464,3,4557,19,AU
2020-03-31,150,1,4707,20,AU
2020-04-01,269,1,4976,21,AU
2020-04-02,248,2,5224,23,AU
2020-04-03,324,7,5548,30,AU
2020-04-04,139,4,5687,34,AU
2020-04-05,57,2,5744,36,AU
2020-04-06,100,6,5844,42,AU
2020-04-07,112,3,5956,45,AU
2020-04-08,96,5,6052,50,AU
2020-04-09,100,2,6152,52,AU
2020-04-10,86,2,6238,54,AU
2020-04-11,51,3,6289,57,AU
2020-04-12,33,4,6322,61,AU
2020-04-13,44,0,6366,61,AU
2020-04-14,50,0,6416,61,AU
2020-04-15,42,2,6458,63,AU
2020-04-16,39,0,6497,63,AU
2020-04-17,36,4,6533,67,AU
2020-04-18,53,2,6586,69,AU
2020-04-19,26,1,6612,70,AU
2020-04-20,13,1,6625,71,AU
2020-04-21,22,3,6647,74,AU
2020-04-22,7,0,6654,74,AU
2020-04-23,13,1,6667,75,AU
2020-04-24,20,4,6687,79,AU
2020-04-25,16,2,6703,81,AU
2020-04-26,10,2,6713,83,AU
2020-04-27,12,1,6725,84,AU
2020-04-28,13,4,6738,88,AU
2020-04-29,8,2,6746,90,AU
2020-04-30,16,2,6762,92,AU
2020-05-01,5,1,6767,93,AU
2020-05-02,16,0,6783,93,AU
2020-05-03,18,2,6801,95,AU
2020-05-04,24,0,6825,95,AU
2020-05-05,24,1,6849,96,AU
2020-05-06,26,1,6875,97,AU
2020-05-07,21,0,6896,97,AU
2020-05-08,18,0,6914,97,AU
2020-05-09,15,0,6929,97,AU
2020-05-10,12,0,6941,97,AU
2020-05-11,7,0,6948,97,AU
2020-05-12,16,0,6964,97,AU
2020-05-13,11,1,6975,98,AU
2020-05-14,14,0,6989,98,AU
2020-05-15,30,0,7019,98,AU
2020-05-16,17,0,7036,98,AU
2020-05-17,9,0,7045,98,AU
2020-05-18,15,1,7060,99,AU
2020-05-19,8,0,7068,99,AU
2020-05-20,11,1,7079,100,AU
2020-05-21,2,0,7081,100,AU
2020-05-22,14,1,7095,101,AU
2020-05-23,11,1,7106,102,AU
2020-05-24,3,0,7109,102,AU
2020-05-25,9,0,7118,102,AU
2020-05-26,15,0,7133,102,AU
2020-05-27,6,0,7139,102,AU
2020-05-28,11,0,7150,102,AU
2020-05-29,23,0,7173,102,AU
2020-05-30,12,0,7185,102,AU
2020-05-31,10,0,7195,102,AU
2020-06-01,9,0,7204,102,AU
2020-06-02,17,0,7221,102,AU
2020-06-03,8,0,7229,102,AU
2020-06-04,11,0,7240,102,AU
2020-06-05,11,0,7251,102,AU
2020-06-06,4,0,7255,102,AU
2020-06-07,5,0,7260,102,AU
2020-06-08,5,0,7265,102,AU
2020-06-09,2,0,7267,102,AU
2020-06-10,9,0,7276,102,AU
2020-06-11,9,0,7285,102,AU
2020-06-12,5,0,7290,102,AU
2020-06-13,12,0,7302,102,AU
2020-06-14,18,0,7320,102,AU
2020-06-15,15,0,7335,102,AU
2020-06-16,12,0,7347,102,AU
2020-06-17,23,0,7370,102,AU
2020-06-18,21,0,7391,102,AU
2020-06-19,18,0,7409,102,AU
2020-06-20,27,0,7436,102,AU
2020-06-21,25,0,7461,102,AU
2020-06-22,13,0,7474,102,AU
2020-06-23,18,0,7492,102,AU
2020-06-24,29,1,7521,103,AU
2020-06-25,37,1,7558,104,AU
2020-06-26,37,0,7595,104,AU
2020-03-12,2,0,2,0,AW
2020-03-19,2,0,4,0,AW
2020-03-23,8,0,12,0,AW
2020-03-24,5,0,17,0,AW
2020-03-25,2,0,19,0,AW
2020-03-26,9,0,28,0,AW
2020-03-27,0,0,28,0,AW
2020-03-28,0,0,28,0,AW
2020-03-29,22,0,50,0,AW
2020-03-31,5,0,55,0,AW
2020-04-01,0,0,55,0,AW
2020-04-02,5,0,60,0,AW
2020-04-03,2,0,62,0,AW
2020-04-04,2,0,64,0,AW
2020-04-05,0,0,64,0,AW
2020-04-06,7,0,71,0,AW
2020-04-07,3,0,74,0,AW
2020-04-08,3,0,77,0,AW
2020-04-09,5,0,82,0,AW
2020-04-10,4,0,86,0,AW
2020-04-11,6,0,92,0,AW
2020-04-12,0,0,92,0,AW
2020-04-13,0,0,92,0,AW
2020-04-14,0,0,92,0,AW
2020-04-15,1,1,93,1,AW
2020-04-16,2,0,95,1,AW
2020-04-17,1,1,96,2,AW
2020-04-18,0,0,96,2,AW
2020-04-19,1,0,97,2,AW
2020-04-20,0,0,97,2,AW
2020-04-21,0,0,97,2,AW
2020-04-22,3,0,100,2,AW
2020-04-23,0,0,100,2,AW
2020-04-24,0,0,100,2,AW
2020-04-25,0,0,100,2,AW
2020-04-26,0,0,100,2,AW
2020-04-27,0,0,100,2,AW
2020-04-28,0,0,100,2,AW
2020-04-29,0,0,100,2,AW
2020-04-30,0,0,100,2,AW
2020-05-01,0,0,100,2,AW
2020-05-02,0,0,100,2,AW
2020-05-03,0,0,100,2,AW
2020-05-04,0,0,100,2,AW
2020-05-05,0,0,100,2,AW
2020-05-06,1,0,101,2,AW
2020-05-07,0,1,101,3,AW
2020-05-08,0,0,101,3,AW
2020-05-09,0,0,101,3,AW
2020-05-10,0,0,101,3,AW
2020-05-11,0,0,101,3,AW
2020-05-12,0,0,101,3,AW
2020-05-13,0,0,101,3,AW
2020-05-14,0,0,101,3,AW
2020-05-15,0,0,101,3,AW
2020-05-16,0,0,101,3,AW
2020-05-17,0,0,101,3,AW
2020-05-18,0,0,101,3,AW
2020-05-19,0,0,101,3,AW
2020-05-20,0,0,101,3,AW
2020-05-21,0,0,101,3,AW
2020-05-22,0,0,101,3,AW
2020-05-23,0,0,101,3,AW
2020-05-24,0,0,101,3,AW
2020-05-25,0,0,101,3,AW
2020-05-26,0,0,101,3,AW
2020-05-27,0,0,101,3,AW
2020-05-28,0,0,101,3,AW
2020-05-29,0,0,101,3,AW
2020-05-30,0,0,101,3,AW
2020-05-31,0,0,101,3,AW
2020-06-01,0,0,101,3,AW
2020-06-02,0,0,101,3,AW
2020-06-03,0,0,101,3,AW
2020-06-04,0,0,101,3,AW
2020-06-05,0,0,101,3,AW
2020-06-06,0,0,101,3,AW
2020-06-07,0,0,101,3,AW
2020-06-08,0,0,101,3,AW
2020-06-09,0,0,101,3,AW
2020-06-10,0,0,101,3,AW
2020-06-11,0,0,101,3,AW
2020-06-12,0,0,101,3,AW
2020-06-13,0,0,101,3,AW
2020-06-14,0,0,101,3,AW
2020-06-15,0,0,101,3,AW
2020-06-16,0,0,101,3,AW
2020-06-17,0,0,101,3,AW
2020-06-18,0,0,101,3,AW
2020-06-19,0,0,101,3,AW
2020-06-20,0,0,101,3,AW
2020-06-21,0,0,101,3,AW
2020-06-22,0,0,101,3,AW
2020-06-23,0,0,101,3,AW
2020-06-24,0,0,101,3,AW
2020-06-25,0,0,101,3,AW
2020-06-26,0,0,101,3,AW
2019-12-30,0,0,0,0,AZ
2019-12-31,0,0,0,0,AZ
2020-01-01,0,0,0,0,AZ
2020-01-02,0,0,0,0,AZ
2020-01-03,0,0,0,0,AZ
2020-01-04,0,0,0,0,AZ
2020-01-05,0,0,0,0,AZ
2020-01-06,0,0,0,0,AZ
2020-01-07,0,0,0,0,AZ
2020-01-08,0,0,0,0,AZ
2020-01-09,0,0,0,0,AZ
2020-01-10,0,0,0,0,AZ
2020-01-11,0,0,0,0,AZ
2020-01-12,0,0,0,0,AZ
2020-01-13,0,0,0,0,AZ
2020-01-14,0,0,0,0,AZ
2020-01-15,0,0,0,0,AZ
2020-01-16,0,0,0,0,AZ
2020-01-17,0,0,0,0,AZ
2020-01-18,0,0,0,0,AZ
2020-01-19,0,0,0,0,AZ
2020-01-20,0,0,0,0,AZ
2020-01-21,0,0,0,0,AZ
2020-01-22,0,0,0,0,AZ
2020-01-23,0,0,0,0,AZ
2020-01-24,0,0,0,0,AZ
2020-01-25,0,0,0,0,AZ
2020-01-26,0,0,0,0,AZ
2020-01-27,0,0,0,0,AZ
2020-01-28,0,0,0,0,AZ
2020-01-29,0,0,0,0,AZ
2020-01-30,0,0,0,0,AZ
2020-01-31,0,0,0,0,AZ
2020-02-01,0,0,0,0,AZ
2020-02-02,0,0,0,0,AZ
2020-02-03,0,0,0,0,AZ
2020-02-04,0,0,0,0,AZ
2020-02-05,0,0,0,0,AZ
2020-02-06,0,0,0,0,AZ
2020-02-07,0,0,0,0,AZ
2020-02-08,0,0,0,0,AZ
2020-02-09,0,0,0,0,AZ
2020-02-10,0,0,0,0,AZ
2020-02-11,0,0,0,0,AZ
2020-02-12,0,0,0,0,AZ
2020-02-13,0,0,0,0,AZ
2020-02-14,0,0,0,0,AZ
2020-02-15,0,0,0,0,AZ
2020-02-16,0,0,0,0,AZ
2020-02-17,0,0,0,0,AZ
2020-02-18,0,0,0,0,AZ
2020-02-19,0,0,0,0,AZ
2020-02-20,0,0,0,0,AZ
2020-02-21,0,0,0,0,AZ
2020-02-22,0,0,0,0,AZ
2020-02-23,0,0,0,0,AZ
2020-02-24,0,0,0,0,AZ
2020-02-25,0,0,0,0,AZ
2020-02-26,0,0,0,0,AZ
2020-02-27,0,0,0,0,AZ
2020-02-28,1,0,1,0,AZ
2020-02-29,0,0,1,0,AZ
2020-03-01,2,0,3,0,AZ
2020-03-05,3,0,6,0,AZ
2020-03-06,3,0,9,0,AZ
2020-03-10,2,0,11,0,AZ
2020-03-11,2,0,13,0,AZ
2020-03-12,0,0,13,0,AZ
2020-03-14,6,0,19,0,AZ
2020-03-15,0,0,19,0,AZ
2020-03-16,0,0,19,0,AZ
2020-03-17,9,0,28,0,AZ
2020-03-18,6,0,34,0,AZ
2020-03-19,10,0,44,0,AZ
2020-03-20,0,1,44,1,AZ
2020-03-21,9,0,53,1,AZ
2020-03-22,12,0,65,1,AZ
2020-03-23,7,0,72,1,AZ
2020-03-24,15,0,87,1,AZ
2020-03-25,6,1,93,2,AZ
2020-03-26,29,1,122,3,AZ
2020-03-27,43,0,165,3,AZ
2020-03-28,17,1,182,4,AZ
2020-03-29,27,0,209,4,AZ
2020-03-30,64,0,273,4,AZ
2020-03-31,25,1,298,5,AZ
2020-04-01,61,0,359,5,AZ
2020-04-02,41,0,400,5,AZ
2020-04-03,43,0,443,5,AZ
2020-04-04,78,0,521,5,AZ
2020-04-05,63,2,584,7,AZ
2020-04-06,57,0,641,7,AZ
2020-04-07,76,1,717,8,AZ
2020-04-08,105,0,822,8,AZ
2020-04-09,104,1,926,9,AZ
2020-04-10,65,1,991,10,AZ
2020-04-11,67,1,1058,11,AZ
2020-04-12,40,0,1098,11,AZ
2020-04-13,50,1,1148,12,AZ
2020-04-14,49,1,1197,13,AZ
2020-04-15,56,0,1253,13,AZ
2020-04-16,30,2,1283,15,AZ
2020-04-17,57,0,1340,15,AZ
2020-04-18,33,3,1373,18,AZ
2020-04-19,25,1,1398,19,AZ
2020-04-20,38,0,1436,19,AZ
2020-04-21,44,1,1480,20,AZ
2020-04-22,38,0,1518,20,AZ
2020-04-23,30,0,1548,20,AZ
2020-04-24,44,1,1592,21,AZ
2020-04-25,25,0,1617,21,AZ
2020-04-26,28,0,1645,21,AZ
2020-04-27,33,1,1678,22,AZ
2020-04-28,39,0,1717,22,AZ
2020-04-29,49,1,1766,23,AZ
2020-04-30,38,1,1804,24,AZ
2020-05-01,50,1,1854,25,AZ
2020-05-02,40,0,1894,25,AZ
2020-05-03,38,0,1932,25,AZ
2020-05-04,52,1,1984,26,AZ
2020-05-05,76,0,2060,26,AZ
2020-05-06,67,2,2127,28,AZ
2020-05-07,77,0,2204,28,AZ
2020-05-08,75,0,2279,28,AZ
2020-05-09,143,3,2422,31,AZ
2020-05-10,97,1,2519,32,AZ
2020-05-11,70,0,2589,32,AZ
2020-05-12,104,1,2693,33,AZ
2020-05-13,65,2,2758,35,AZ
2020-05-14,121,0,2879,35,AZ
2020-05-15,101,1,2980,36,AZ
2020-05-16,158,0,3138,36,AZ
2020-05-17,136,3,3274,39,AZ
2020-05-18,13,1,3287,40,AZ
2020-05-19,231,1,3518,41,AZ
2020-05-20,113,2,3631,43,AZ
2020-05-21,118,1,3749,44,AZ
2020-05-22,106,2,3855,46,AZ
2020-05-23,127,3,3982,49,AZ
2020-05-24,140,0,4122,49,AZ
2020-05-25,149,2,4271,51,AZ
2020-05-26,132,1,4403,52,AZ
2020-05-27,165,2,4568,54,AZ
2020-05-28,191,2,4759,56,AZ
2020-05-29,230,2,4989,58,AZ
2020-05-30,257,3,5246,61,AZ
2020-05-31,248,2,5494,63,AZ
2020-06-01,168,5,5662,68,AZ
2020-06-02,273,3,5935,71,AZ
2020-06-03,325,5,6260,76,AZ
2020-06-04,262,2,6522,78,AZ
2020-06-05,338,4,6860,82,AZ
2020-06-06,379,2,7239,84,AZ
2020-06-07,314,4,7553,88,AZ
2020-06-08,323,5,7876,93,AZ
2020-06-09,315,5,8191,98,AZ
2020-06-10,339,4,8530,102,AZ
2020-06-11,352,6,8882,108,AZ
2020-06-12,336,5,9218,113,AZ
2020-06-13,352,2,9570,115,AZ
2020-06-14,387,4,9957,119,AZ
2020-06-15,367,3,10324,122,AZ
2020-06-16,338,4,10662,126,AZ
2020-06-17,329,7,10991,133,AZ
2020-06-18,338,6,11329,139,AZ
2020-06-19,0,0,11329,139,AZ
2020-06-20,909,9,12238,148,AZ
2020-06-21,491,6,12729,154,AZ
2020-06-22,478,7,13207,161,AZ
2020-06-23,508,6,13715,167,AZ
2020-06-24,590,7,14305,174,AZ
2020-06-25,547,6,14852,180,AZ
2020-06-26,517,7,15369,187,AZ
2020-03-05,2,0,2,0,BA
2020-03-11,1,0,3,0,BA
2020-03-12,0,0,3,0,BA
2020-03-15,15,0,18,0,BA
2020-03-16,3,0,21,0,BA
2020-03-17,0,0,21,0,BA
2020-03-18,15,0,36,0,BA
2020-03-19,8,0,44,0,BA
2020-03-20,0,0,44,0,BA
2020-03-21,48,1,92,1,BA
2020-03-22,33,0,125,1,BA
2020-03-23,4,0,129,1,BA
2020-03-24,33,1,162,2,BA
2020-03-25,19,1,181,3,BA
2020-03-26,0,0,181,3,BA
2020-03-27,48,0,229,3,BA
2020-03-28,28,2,257,5,BA
2020-03-29,66,1,323,6,BA
2020-03-30,30,2,353,8,BA
2020-03-31,60,4,413,12,BA
2020-04-01,51,1,464,13,BA
2020-04-02,68,4,532,17,BA
2020-04-03,54,1,586,18,BA
2020-04-04,46,3,632,21,BA
2020-04-05,31,3,663,24,BA
2020-04-06,32,4,695,28,BA
2020-04-07,86,4,781,32,BA
2020-04-08,35,3,816,35,BA
2020-04-09,59,1,875,36,BA
2020-04-10,26,1,901,37,BA
2020-04-11,47,0,948,37,BA
2020-04-12,59,1,1007,38,BA
2020-04-13,21,0,1028,38,BA
2020-04-14,45,1,1073,39,BA
2020-04-15,27,1,1100,40,BA
2020-04-16,52,1,1152,41,BA
2020-04-17,58,3,1210,44,BA
2020-04-18,44,1,1254,45,BA
2020-04-19,15,1,1269,46,BA
2020-04-20,31,2,1300,48,BA
2020-04-21,40,2,1340,50,BA
2020-04-22,27,2,1367,52,BA
2020-04-23,46,1,1413,53,BA
2020-04-24,7,1,1420,54,BA
2020-04-25,65,2,1485,56,BA
2020-04-26,31,2,1516,58,BA
2020-04-27,48,2,1564,60,BA
2020-04-28,24,2,1588,62,BA
2020-04-29,0,0,1588,62,BA
2020-04-30,101,2,1689,64,BA
2020-05-01,92,6,1781,70,BA
2020-05-02,58,2,1839,72,BA
2020-05-03,18,5,1857,77,BA
2020-05-04,69,1,1926,78,BA
2020-05-05,20,1,1946,79,BA
2020-05-06,41,7,1987,86,BA
2020-05-07,40,4,2027,90,BA
2020-05-08,43,8,2070,98,BA
2020-05-09,0,0,2070,98,BA
2020-05-10,20,4,2090,102,BA
2020-05-11,52,10,2142,112,BA
2020-05-12,16,5,2158,117,BA
2020-05-13,23,3,2181,120,BA
2020-05-14,35,3,2216,123,BA
2020-05-15,21,4,2237,127,BA
2020-05-16,30,2,2267,129,BA
2020-05-17,22,3,2289,132,BA
2020-05-18,14,0,2303,132,BA
2020-05-19,16,1,2319,133,BA
2020-05-20,15,2,2334,135,BA
2020-05-21,18,4,2352,139,BA
2020-05-22,20,2,2372,141,BA
2020-05-23,19,0,2391,141,BA
2020-05-24,10,3,2401,144,BA
2020-05-25,5,2,2406,146,BA
2020-05-26,10,3,2416,149,BA
2020-05-27,19,2,2435,151,BA
2020-05-28,27,2,2462,153,BA
2020-05-29,23,0,2485,153,BA
2020-05-30,9,0,2494,153,BA
2020-05-31,15,0,2509,153,BA
2020-06-01,14,0,2523,153,BA
2020-06-02,11,3,2534,156,BA
2020-06-03,16,0,2550,156,BA
2020-06-04,43,2,2593,158,BA
2020-06-05,12,0,2605,158,BA
2020-06-06,0,0,2605,158,BA
2020-06-07,0,0,2605,158,BA
2020-06-08,98,1,2703,159,BA
2020-06-09,24,0,2727,159,BA
2020-06-10,49,1,2776,160,BA
2020-06-11,55,0,2831,160,BA
2020-06-12,61,2,2892,162,BA
2020-06-13,48,1,2940,163,BA
2020-06-14,61,0,3001,163,BA
2020-06-15,38,1,3039,164,BA
2020-06-16,45,3,3084,167,BA
2020-06-17,60,0,3144,167,BA
2020-06-18,58,0,3202,167,BA
2020-06-19,86,1,3288,168,BA
2020-06-20,66,1,3354,169,BA
2020-06-21,0,0,3354,169,BA
2020-06-22,170,1,3524,170,BA
2020-06-23,63,1,3587,171,BA
2020-06-24,88,1,3675,172,BA
2020-06-25,121,3,3796,175,BA
2020-06-26,138,2,3934,177,BA
2020-03-17,1,0,1,0,BB
2020-03-18,0,0,1,0,BB
2020-03-19,1,0,2,0,BB
2020-03-20,4,0,6,0,BB
2020-03-21,8,0,14,0,BB
2020-03-22,3,0,17,0,BB
2020-03-23,0,0,17,0,BB
2020-03-24,1,0,18,0,BB
2020-03-25,0,0,18,0,BB
2020-03-26,6,0,24,0,BB
2020-03-27,0,0,24,0,BB
2020-03-28,2,0,26,0,BB
2020-03-29,7,0,33,0,BB
2020-03-30,1,0,34,0,BB
2020-03-31,0,0,34,0,BB
2020-04-01,11,0,45,0,BB
2020-04-02,0,0,45,0,BB
2020-04-03,0,0,45,0,BB
2020-04-04,6,0,51,0,BB
2020-04-05,5,1,56,1,BB
2020-04-06,4,1,60,2,BB
2020-04-07,3,1,63,3,BB
2020-04-08,0,0,63,3,BB
2020-04-09,3,0,66,3,BB
2020-04-10,1,1,67,4,BB
2020-04-11,1,0,68,4,BB
2020-04-12,3,0,71,4,BB
2020-04-13,1,0,72,4,BB
2020-04-14,1,1,73,5,BB
2020-04-15,2,0,75,5,BB
2020-04-16,0,0,75,5,BB
2020-04-17,0,0,75,5,BB
2020-04-18,0,0,75,5,BB
2020-04-19,0,0,75,5,BB
2020-04-20,0,0,75,5,BB
2020-04-21,0,0,75,5,BB
2020-04-22,1,1,76,6,BB
2020-04-23,0,0,76,6,BB
2020-04-24,0,0,76,6,BB
2020-04-25,3,0,79,6,BB
2020-04-26,0,0,79,6,BB
2020-04-27,1,0,80,6,BB
2020-04-28,0,0,80,6,BB
2020-04-29,0,1,80,7,BB
2020-04-30,1,0,81,7,BB
2020-05-01,0,0,81,7,BB
2020-05-02,0,0,81,7,BB
2020-05-03,1,0,82,7,BB
2020-05-04,0,0,82,7,BB
2020-05-05,0,0,82,7,BB
2020-05-06,0,0,82,7,BB
2020-05-07,0,0,82,7,BB
2020-05-08,1,0,83,7,BB
2020-05-09,1,0,84,7,BB
2020-05-10,0,0,84,7,BB
2020-05-11,0,0,84,7,BB
2020-05-12,1,0,85,7,BB
2020-05-13,0,0,85,7,BB
2020-05-14,0,0,85,7,BB
2020-05-15,0,0,85,7,BB
2020-05-16,1,0,86,7,BB
2020-05-17,2,0,88,7,BB
2020-05-18,0,0,88,7,BB
2020-05-19,2,0,90,7,BB
2020-05-20,0,0,90,7,BB
2020-05-21,0,0,90,7,BB
2020-05-22,0,0,90,7,BB
2020-05-23,2,0,92,7,BB
2020-05-24,0,0,92,7,BB
2020-05-25,0,0,92,7,BB
2020-05-26,0,0,92,7,BB
2020-05-27,0,0,92,7,BB
2020-05-28,0,0,92,7,BB
2020-05-29,0,0,92,7,BB
2020-05-30,0,0,92,7,BB
2020-05-31,0,0,92,7,BB
2020-06-01,0,0,92,7,BB
2020-06-02,0,0,92,7,BB
2020-06-03,0,0,92,7,BB
2020-06-04,0,0,92,7,BB
2020-06-05,0,0,92,7,BB
2020-06-06,0,0,92,7,BB
2020-06-07,0,0,92,7,BB
2020-06-08,0,0,92,7,BB
2020-06-09,0,0,92,7,BB
2020-06-10,4,0,96,7,BB
2020-06-11,0,0,96,7,BB
2020-06-12,0,0,96,7,BB
2020-06-13,0,0,96,7,BB
2020-06-14,0,0,96,7,BB
2020-06-15,1,0,97,7,BB
2020-06-16,0,0,97,7,BB
2020-06-17,0,0,97,7,BB
2020-06-18,0,0,97,7,BB
2020-06-19,0,0,97,7,BB
2020-06-20,0,0,97,7,BB
2020-06-21,0,0,97,7,BB
2020-06-22,0,0,97,7,BB
2020-06-23,0,0,97,7,BB
2020-06-24,0,0,97,7,BB
2020-06-25,0,0,97,7,BB
2020-06-26,0,0,97,7,BB
2020-03-08,3,0,3,0,BD
2020-03-14,0,0,3,0,BD
2020-03-16,2,0,5,0,BD
2020-03-17,3,0,8,0,BD
2020-03-18,2,0,10,0,BD
2020-03-19,0,0,10,0,BD
2020-03-20,7,0,17,0,BD
2020-03-21,7,2,24,2,BD
2020-03-22,3,1,27,3,BD
2020-03-23,6,0,33,3,BD
2020-03-24,6,1,39,4,BD
2020-03-25,0,1,39,5,BD
2020-03-26,9,0,48,5,BD
2020-03-27,0,0,48,5,BD
2020-03-28,0,0,48,5,BD
2020-03-29,1,0,49,5,BD
2020-03-30,0,0,49,5,BD
2020-03-31,2,0,51,5,BD
2020-04-01,3,1,54,6,BD
2020-04-02,2,0,56,6,BD
2020-04-03,5,0,61,6,BD
2020-04-04,9,2,70,8,BD
2020-04-05,18,1,88,9,BD
2020-04-06,35,3,123,12,BD
2020-04-07,41,5,164,17,BD
2020-04-08,54,3,218,20,BD
2020-04-09,112,1,330,21,BD
2020-04-10,94,6,424,27,BD
2020-04-11,58,3,482,30,BD
2020-04-12,139,4,621,34,BD
2020-04-13,182,5,803,39,BD
2020-04-14,209,7,1012,46,BD
2020-04-15,219,4,1231,50,BD
2020-04-16,341,10,1572,60,BD
2020-04-17,266,15,1838,75,BD
2020-04-18,306,9,2144,84,BD
2020-04-19,312,7,2456,91,BD
2020-04-20,492,10,2948,101,BD
2020-04-21,434,9,3382,110,BD
2020-04-22,390,10,3772,120,BD
2020-04-23,414,7,4186,127,BD
2020-04-24,503,4,4689,131,BD
2020-04-25,309,9,4998,140,BD
2020-04-26,418,5,5416,145,BD
2020-04-27,497,7,5913,152,BD
2020-04-28,549,3,6462,155,BD
2020-04-29,641,8,7103,163,BD
2020-04-30,564,5,7667,168,BD
2020-05-01,571,2,8238,170,BD
2020-05-02,552,5,8790,175,BD
2020-05-03,665,2,9455,177,BD
2020-05-04,688,5,10143,182,BD
2020-05-05,786,1,10929,183,BD
2020-05-06,790,3,11719,186,BD
2020-05-07,706,13,12425,199,BD
2020-05-08,709,7,13134,206,BD
2020-05-09,636,8,13770,214,BD
2020-05-10,887,14,14657,228,BD
2020-05-11,1034,11,15691,239,BD
2020-05-12,969,11,16660,250,BD
2020-05-13,1162,19,17822,269,BD
2020-05-14,1041,14,18863,283,BD
2020-05-15,1202,15,20065,298,BD
2020-05-16,930,16,20995,314,BD
2020-05-17,1273,14,22268,328,BD
2020-05-18,1602,21,23870,349,BD
2020-05-19,1251,21,25121,370,BD
2020-05-20,1617,16,26738,386,BD
2020-05-21,1773,22,28511,408,BD
2020-05-22,1694,24,30205,432,BD
2020-05-23,1873,20,32078,452,BD
2020-05-24,1532,28,33610,480,BD
2020-05-25,1975,21,35585,501,BD
2020-05-26,1166,21,36751,522,BD
2020-05-27,1541,22,38292,544,BD
2020-05-28,2029,15,40321,559,BD
2020-05-29,2523,23,42844,582,BD
2020-05-30,1764,28,44608,610,BD
2020-05-31,2545,40,47153,650,BD
2020-06-01,2381,22,49534,672,BD
2020-06-02,2911,37,52445,709,BD
2020-06-03,2695,37,55140,746,BD
2020-06-04,2423,35,57563,781,BD
2020-06-05,2828,30,60391,811,BD
2020-06-06,2635,35,63026,846,BD
2020-06-07,2743,42,65769,888,BD
2020-06-08,2735,42,68504,930,BD
2020-06-09,3171,45,71675,975,BD
2020-06-10,3190,37,74865,1012,BD
2020-06-11,3187,37,78052,1049,BD
2020-06-12,3471,46,81523,1095,BD
2020-06-13,2856,44,84379,1139,BD
2020-06-14,3141,32,87520,1171,BD
2020-06-15,3099,38,90619,1209,BD
2020-06-16,3862,53,94481,1262,BD
2020-06-17,4008,43,98489,1305,BD
2020-06-18,3803,38,102292,1343,BD
2020-06-19,3243,45,105535,1388,BD
2020-06-20,3240,37,108775,1425,BD
2020-06-21,3531,39,112306,1464,BD
2020-06-22,3480,38,115786,1502,BD
2020-06-23,3412,43,119198,1545,BD
2020-06-24,3462,37,122660,1582,BD
2020-06-25,3946,39,126606,1621,BD
2020-06-26,3868,40,130474,1661,BD
2019-12-30,0,0,0,0,BE
2019-12-31,0,0,0,0,BE
2020-01-01,0,0,0,0,BE
2020-01-02,0,0,0,0,BE
2020-01-03,0,0,0,0,BE
2020-01-04,0,0,0,0,BE
2020-01-05,0,0,0,0,BE
2020-01-06,0,0,0,0,BE
2020-01-07,0,0,0,0,BE
2020-01-08,0,0,0,0,BE
2020-01-09,0,0,0,0,BE
2020-01-10,0,0,0,0,BE
2020-01-11,0,0,0,0,BE
2020-01-12,0,0,0,0,BE
2020-01-13,0,0,0,0,BE
2020-01-14,0,0,0,0,BE
2020-01-15,0,0,0,0,BE
2020-01-16,0,0,0,0,BE
2020-01-17,0,0,0,0,BE
2020-01-18,0,0,0,0,BE
2020-01-19,0,0,0,0,BE
2020-01-20,0,0,0,0,BE
2020-01-21,0,0,0,0,BE
2020-01-22,0,0,0,0,BE
2020-01-23,0,0,0,0,BE
2020-01-24,0,0,0,0,BE
2020-01-25,0,0,0,0,BE
2020-01-26,0,0,0,0,BE
2020-01-27,0,0,0,0,BE
2020-01-28,0,0,0,0,BE
2020-01-29,0,0,0,0,BE
2020-01-30,0,0,0,0,BE
2020-01-31,0,0,0,0,BE
2020-02-01,0,0,0,0,BE
2020-02-02,0,0,0,0,BE
2020-02-03,1,0,1,0,BE
2020-02-04,0,0,1,0,BE
2020-02-05,0,0,1,0,BE
2020-02-06,0,0,1,0,BE
2020-02-07,0,0,1,0,BE
2020-02-08,0,0,1,0,BE
2020-02-09,0,0,1,0,BE
2020-02-10,0,0,1,0,BE
2020-02-11,0,0,1,0,BE
2020-02-12,0,0,1,0,BE
2020-02-13,0,0,1,0,BE
2020-02-14,0,0,1,0,BE
2020-02-15,0,0,1,0,BE
2020-02-16,0,0,1,0,BE
2020-02-17,0,0,1,0,BE
2020-02-18,0,0,1,0,BE
2020-02-19,0,0,1,0,BE
2020-02-20,0,0,1,0,BE
2020-02-21,0,0,1,0,BE
2020-02-22,0,0,1,0,BE
2020-02-23,0,0,1,0,BE
2020-02-24,0,0,1,0,BE
2020-02-25,0,0,1,0,BE
2020-02-26,0,0,1,0,BE
2020-02-27,0,0,1,0,BE
2020-02-28,0,0,1,0,BE
2020-02-29,0,0,1,0,BE
2020-03-01,16,0,17,0,BE
2020-03-02,17,0,34,0,BE
2020-03-03,36,0,70,0,BE
2020-03-04,55,0,125,0,BE
2020-03-05,81,0,206,0,BE
2020-03-06,111,0,317,0,BE
2020-03-07,27,0,344,0,BE
2020-03-08,64,0,408,0,BE
2020-03-09,94,0,502,0,BE
2020-03-10,99,1,601,1,BE
2020-03-11,174,3,775,4,BE
2020-03-12,250,1,1025,5,BE
2020-03-13,338,3,1363,8,BE
2020-03-14,179,4,1542,12,BE
2020-03-15,214,6,1756,18,BE
2020-03-16,387,11,2143,29,BE
2020-03-17,422,12,2565,41,BE
2020-03-18,534,22,3099,63,BE
2020-03-19,713,28,3812,91,BE
2020-03-20,663,31,4475,122,BE
2020-03-21,470,39,4945,161,BE
2020-03-22,486,42,5431,203,BE
2020-03-23,1329,77,6760,280,BE
2020-03-24,1195,74,7955,354,BE
2020-03-25,1199,97,9154,451,BE
2020-03-26,1363,101,10517,552,BE
2020-03-27,1519,124,12036,676,BE
2020-03-28,844,133,12880,809,BE
2020-03-29,683,139,13563,948,BE
2020-03-30,1738,169,15301,1117,BE
2020-03-31,1681,185,16982,1302,BE
2020-04-01,1503,248,18485,1550,BE
2020-04-02,1460,209,19945,1759,BE
2020-04-03,1691,231,21636,1990,BE
2020-04-04,925,273,22561,2263,BE
2020-04-05,665,233,23226,2496,BE
2020-04-06,1922,273,25148,2769,BE
2020-04-07,1500,303,26648,3072,BE
2020-04-08,1587,317,28235,3389,BE
2020-04-09,2224,271,30459,3660,BE
2020-04-10,2319,318,32778,3978,BE
2020-04-11,1023,290,33801,4268,BE
2020-04-12,517,343,34318,4611,BE
2020-04-13,532,282,34850,4893,BE
2020-04-14,1562,275,36412,5168,BE
2020-04-15,1620,275,38032,5443,BE
2020-04-16,1664,254,39696,5697,BE
2020-04-17,1382,204,41078,5901,BE
2020-04-18,717,210,41795,6111,BE
2020-04-19,443,213,42238,6324,BE
2020-04-20,1272,199,43510,6523,BE
2020-04-21,1263,202,44773,6725,BE
2020-04-22,775,192,45548,6917,BE
2020-04-23,968,175,46516,7092,BE
2020-04-24,803,147,47319,7239,BE
2020-04-25,387,155,47706,7394,BE
2020-04-26,205,176,47911,7570,BE
2020-04-27,748,127,48659,7697,BE
2020-04-28,568,115,49227,7812,BE
2020-04-29,514,98,49741,7910,BE
2020-04-30,587,84,50328,7994,BE
2020-05-01,237,98,50565,8092,BE
2020-05-02,284,73,50849,8165,BE
2020-05-03,141,96,50990,8261,BE
2020-05-04,669,98,51659,8359,BE
2020-05-05,536,82,52195,8441,BE
2020-05-06,551,75,52746,8516,BE
2020-05-07,426,78,53172,8594,BE
2020-05-08,479,70,53651,8664,BE
2020-05-09,240,68,53891,8732,BE
2020-05-10,118,73,54009,8805,BE
2020-05-11,462,62,54471,8867,BE
2020-05-12,395,48,54866,8915,BE
2020-05-13,318,54,55184,8969,BE
2020-05-14,294,46,55478,9015,BE
2020-05-15,340,37,55818,9052,BE
2020-05-16,146,28,55964,9080,BE
2020-05-17,81,35,56045,9115,BE
2020-05-18,307,35,56352,9150,BE
2020-05-19,284,30,56636,9180,BE
2020-05-20,381,32,57017,9212,BE
2020-05-21,71,29,57088,9241,BE
2020-05-22,246,37,57334,9278,BE
2020-05-23,122,24,57456,9302,BE
2020-05-24,75,34,57531,9336,BE
2020-05-25,304,24,57835,9360,BE
2020-05-26,198,40,58033,9400,BE
2020-05-27,181,24,58214,9424,BE
2020-05-28,159,22,58373,9446,BE
2020-05-29,159,13,58532,9459,BE
2020-05-30,60,24,58592,9483,BE
2020-05-31,48,19,58640,9502,BE
2020-06-01,58,22,58698,9524,BE
2020-06-02,178,20,58876,9544,BE
2020-06-03,160,20,59036,9564,BE
2020-06-04,168,14,59204,9578,BE
2020-06-05,155,12,59359,9590,BE
2020-06-06,69,11,59428,9601,BE
2020-06-07,53,11,59481,9612,BE
2020-06-08,150,9,59631,9621,BE
2020-06-09,144,11,59775,9632,BE
2020-06-10,116,12,59891,9644,BE
2020-06-11,94,7,59985,9651,BE
2020-06-12,88,10,60073,9661,BE
2020-06-13,47,5,60120,9666,BE
2020-06-14,22,3,60142,9669,BE
2020-06-15,148,8,60290,9677,BE
2020-06-16,97,7,60387,9684,BE
2020-06-17,122,7,60509,9691,BE
2020-06-18,106,5,60615,9696,BE
2020-06-19,117,4,60732,9700,BE
2020-06-20,49,3,60781,9703,BE
2020-06-21,17,9,60798,9712,BE
2020-06-22,112,11,60910,9723,BE
2020-06-23,90,4,61000,9727,BE
2020-06-24,13,3,61013,9730,BE
2020-06-25,93,1,61106,9731,BE
2020-06-26,0,0,61106,9731,BE
2020-03-10,2,0,2,0,BF
2020-03-11,0,0,2,0,BF
2020-03-14,1,0,3,0,BF
2020-03-15,0,0,3,0,BF
2020-03-16,17,0,20,0,BF
2020-03-17,0,0,20,0,BF
2020-03-18,6,1,26,1,BF
2020-03-19,7,0,33,1,BF
2020-03-20,7,0,40,1,BF
2020-03-21,24,2,64,3,BF
2020-03-22,0,0,64,3,BF
2020-03-23,11,0,75,3,BF
2020-03-24,24,0,99,3,BF
2020-03-25,15,0,114,3,BF
2020-03-26,32,0,146,3,BF
2020-03-27,0,0,146,3,BF
2020-03-28,34,6,180,9,BF
2020-03-29,0,0,180,9,BF
2020-03-30,42,3,222,12,BF
2020-03-31,24,0,246,12,BF
2020-04-01,15,2,261,14,BF
2020-04-02,27,2,288,16,BF
2020-04-03,0,0,288,16,BF
2020-04-04,14,0,302,16,BF
2020-04-05,43,1,345,17,BF
2020-04-06,19,0,364,17,BF
2020-04-07,20,2,384,19,BF
2020-04-08,30,4,414,23,BF
2020-04-09,29,1,443,24,BF
2020-04-10,5,2,448,26,BF
2020-04-11,36,1,484,27,BF
2020-04-12,13,0,497,27,BF
2020-04-13,18,1,515,28,BF
2020-04-14,13,2,528,30,BF
2020-04-15,14,2,542,32,BF
2020-04-16,1,0,543,32,BF
2020-04-17,14,3,557,35,BF
2020-04-18,8,1,565,36,BF
2020-04-19,11,0,576,36,BF
2020-04-20,5,2,581,38,BF
2020-04-21,19,0,600,38,BF
2020-04-22,9,1,609,39,BF
2020-04-23,7,2,616,41,BF
2020-04-24,10,0,626,41,BF
2020-04-25,3,0,629,41,BF
2020-04-26,3,1,632,42,BF
2020-04-27,3,0,635,42,BF
2020-04-28,3,0,638,42,BF
2020-04-29,3,1,641,43,BF
2020-04-30,4,0,645,43,BF
2020-05-01,4,1,649,44,BF
2020-05-02,3,0,652,44,BF
2020-05-03,10,1,662,45,BF
2020-05-04,10,1,672,46,BF
2020-05-05,16,2,688,48,BF
2020-05-06,41,0,729,48,BF
2020-05-07,7,0,736,48,BF
2020-05-08,8,0,744,48,BF
2020-05-09,4,0,748,48,BF
2020-05-10,3,1,751,49,BF
2020-05-11,9,1,760,50,BF
2020-05-12,6,1,766,51,BF
2020-05-13,7,0,773,51,BF
2020-05-14,0,0,773,51,BF
2020-05-15,9,0,782,51,BF
2020-05-16,0,0,782,51,BF
2020-05-17,14,0,796,51,BF
2020-05-18,0,0,796,51,BF
2020-05-19,10,1,806,52,BF
2020-05-20,3,0,809,52,BF
2020-05-21,3,0,812,52,BF
2020-05-22,2,0,814,52,BF
2020-05-23,0,0,814,52,BF
2020-05-24,18,0,832,52,BF
2020-05-25,9,0,841,52,BF
2020-05-26,4,1,845,53,BF
2020-05-27,0,0,845,53,BF
2020-05-28,2,0,847,53,BF
2020-05-29,0,0,847,53,BF
2020-05-30,6,0,853,53,BF
2020-05-31,28,0,881,53,BF
2020-06-01,0,0,881,53,BF
2020-06-02,2,0,883,53,BF
2020-06-03,1,0,884,53,BF
2020-06-04,1,0,885,53,BF
2020-06-05,3,0,888,53,BF
2020-06-06,0,0,888,53,BF
2020-06-07,1,0,889,53,BF
2020-06-08,1,0,890,53,BF
2020-06-09,1,0,891,53,BF
2020-06-10,0,0,891,53,BF
2020-06-11,1,0,892,53,BF
2020-06-12,0,0,892,53,BF
2020-06-13,2,0,894,53,BF
2020-06-14,0,0,894,53,BF
2020-06-15,0,0,894,53,BF
2020-06-16,1,0,895,53,BF
2020-06-17,4,0,899,53,BF
2020-06-18,0,0,899,53,BF
2020-06-19,1,0,900,53,BF
2020-06-20,2,0,902,53,BF
2020-06-21,1,0,903,53,BF
2020-06-22,4,0,907,53,BF
2020-06-23,12,0,919,53,BF
2020-06-24,15,0,934,53,BF
2020-06-25,7,0,941,53,BF
2020-06-26,0,0,941,53,BF
2020-03-07,2,0,2,0,BG
2020-03-08,2,0,4,0,BG
2020-03-11,3,1,7,1,BG
2020-03-12,16,0,23,1,BG
2020-03-13,8,0,31,1,BG
2020-03-14,10,1,41,2,BG
2020-03-15,10,0,51,2,BG
2020-03-16,11,0,62,2,BG
2020-03-17,19,0,81,2,BG
2020-03-18,11,0,92,2,BG
2020-03-19,13,1,105,3,BG
2020-03-20,22,0,127,3,BG
2020-03-21,36,0,163,3,BG
2020-03-22,22,0,185,3,BG
2020-03-23,16,0,201,3,BG
2020-03-24,19,0,220,3,BG
2020-03-25,22,0,242,3,BG
2020-03-26,22,0,264,3,BG
2020-03-27,29,0,293,3,BG
2020-03-28,38,4,331,7,BG
2020-03-29,15,1,346,8,BG
2020-03-30,13,0,359,8,BG
2020-03-31,40,0,399,8,BG
2020-04-01,23,2,422,10,BG
2020-04-02,35,0,457,10,BG
2020-04-03,28,4,485,14,BG
2020-04-04,18,3,503,17,BG
2020-04-05,28,3,531,20,BG
2020-04-06,18,2,549,22,BG
2020-04-07,28,1,577,23,BG
2020-04-08,16,1,593,24,BG
2020-04-09,31,0,624,24,BG
2020-04-10,11,1,635,25,BG
2020-04-11,26,3,661,28,BG
2020-04-12,14,1,675,29,BG
2020-04-13,10,3,685,32,BG
2020-04-14,28,3,713,35,BG
2020-04-15,34,1,747,36,BG
2020-04-16,53,2,800,38,BG
2020-04-17,46,3,846,41,BG
2020-04-18,32,0,878,41,BG
2020-04-19,37,2,915,43,BG
2020-04-20,14,0,929,43,BG
2020-04-21,46,2,975,45,BG
2020-04-22,49,4,1024,49,BG
2020-04-23,73,3,1097,52,BG
2020-04-24,91,2,1188,54,BG
2020-04-25,59,1,1247,55,BG
2020-04-26,53,1,1300,56,BG
2020-04-27,63,2,1363,58,BG
2020-04-28,36,0,1399,58,BG
2020-04-29,48,6,1447,64,BG
2020-04-30,59,2,1506,66,BG
2020-05-01,82,3,1588,69,BG
2020-05-02,6,3,1594,72,BG
2020-05-03,24,1,1618,73,BG
2020-05-04,34,5,1652,78,BG
2020-05-05,37,0,1689,78,BG
2020-05-06,89,6,1778,84,BG
2020-05-07,51,0,1829,84,BG
2020-05-08,82,4,1911,88,BG
2020-05-09,44,2,1955,90,BG
2020-05-10,10,1,1965,91,BG
2020-05-11,25,2,1990,93,BG
2020-05-12,33,2,2023,95,BG
2020-05-13,46,1,2069,96,BG
2020-05-14,31,3,2100,99,BG
2020-05-15,38,3,2138,102,BG
2020-05-16,73,6,2211,108,BG
2020-05-17,24,2,2235,110,BG
2020-05-18,24,2,2259,112,BG
2020-05-19,33,4,2292,116,BG
2020-05-20,39,4,2331,120,BG
2020-05-21,41,5,2372,125,BG
2020-05-22,36,1,2408,126,BG
2020-05-23,0,0,2408,126,BG
2020-05-24,25,4,2433,130,BG
2020-05-25,0,0,2433,130,BG
2020-05-26,27,3,2460,133,BG
2020-05-27,0,0,2460,133,BG
2020-05-28,25,3,2485,136,BG
2020-05-29,14,3,2499,139,BG
2020-05-30,14,1,2513,140,BG
2020-05-31,0,0,2513,140,BG
2020-06-01,0,4,2513,144,BG
2020-06-02,25,0,2538,144,BG
2020-06-03,47,3,2585,147,BG
2020-06-04,0,0,2585,147,BG
2020-06-05,83,13,2668,160,BG
2020-06-06,43,0,2711,160,BG
2020-06-07,16,0,2727,160,BG
2020-06-08,83,4,2810,164,BG
2020-06-09,79,3,2889,167,BG
2020-06-10,0,0,2889,167,BG
2020-06-11,197,1,3086,168,BG
2020-06-12,105,4,3191,172,BG
2020-06-13,75,0,3266,172,BG
2020-06-14,24,2,3290,174,BG
2020-06-15,51,2,3341,176,BG
2020-06-16,112,5,3453,181,BG
2020-06-17,89,3,3542,184,BG
2020-06-18,132,6,3674,190,BG
2020-06-19,81,3,3755,193,BG
2020-06-20,117,6,3872,199,BG
2020-06-21,33,0,3905,199,BG
2020-06-22,79,8,3984,207,BG
2020-06-23,130,1,4114,208,BG
2020-06-24,128,1,4242,209,BG
2020-06-25,166,2,4408,211,BG
2020-06-26,105,4,4513,215,BG
2019-12-30,0,0,0,0,BH
2019-12-31,0,0,0,0,BH
2020-01-01,0,0,0,0,BH
2020-01-02,0,0,0,0,BH
2020-01-03,0,0,0,0,BH
2020-01-04,0,0,0,0,BH
2020-01-05,0,0,0,0,BH
2020-01-06,0,0,0,0,BH
2020-01-07,0,0,0,0,BH
2020-01-08,0,0,0,0,BH
2020-01-09,0,0,0,0,BH
2020-01-10,0,0,0,0,BH
2020-01-11,0,0,0,0,BH
2020-01-12,0,0,0,0,BH
2020-01-13,0,0,0,0,BH
2020-01-14,0,0,0,0,BH
2020-01-15,0,0,0,0,BH
2020-01-16,0,0,0,0,BH
2020-01-17,0,0,0,0,BH
2020-01-18,0,0,0,0,BH
2020-01-19,0,0,0,0,BH
2020-01-20,0,0,0,0,BH
2020-01-21,0,0,0,0,BH
2020-01-22,0,0,0,0,BH
2020-01-23,0,0,0,0,BH
2020-01-24,0,0,0,0,BH
2020-01-25,0,0,0,0,BH
2020-01-26,0,0,0,0,BH
2020-01-27,0,0,0,0,BH
2020-01-28,0,0,0,0,BH
2020-01-29,0,0,0,0,BH
2020-01-30,0,0,0,0,BH
2020-01-31,0,0,0,0,BH
2020-02-01,0,0,0,0,BH
2020-02-02,0,0,0,0,BH
2020-02-03,0,0,0,0,BH
2020-02-04,0,0,0,0,BH
2020-02-05,0,0,0,0,BH
2020-02-06,0,0,0,0,BH
2020-02-07,0,0,0,0,BH
2020-02-08,0,0,0,0,BH
2020-02-09,0,0,0,0,BH
2020-02-10,0,0,0,0,BH
2020-02-11,0,0,0,0,BH
2020-02-12,0,0,0,0,BH
2020-02-13,0,0,0,0,BH
2020-02-14,0,0,0,0,BH
2020-02-15,0,0,0,0,BH
2020-02-16,0,0,0,0,BH
2020-02-17,0,0,0,0,BH
2020-02-18,0,0,0,0,BH
2020-02-19,0,0,0,0,BH
2020-02-20,0,0,0,0,BH
2020-02-21,0,0,0,0,BH
2020-02-22,0,0,0,0,BH
2020-02-23,1,0,1,0,BH
2020-02-24,1,0,2,0,BH
2020-02-25,21,0,23,0,BH
2020-02-26,10,0,33,0,BH
2020-02-27,0,0,33,0,BH
2020-02-28,5,0,38,0,BH
2020-02-29,3,0,41,0,BH
2020-03-01,6,0,47,0,BH
2020-03-03,2,0,49,0,BH
2020-03-04,3,0,52,0,BH
2020-03-05,0,0,52,0,BH
2020-03-06,4,0,56,0,BH
2020-03-07,7,0,63,0,BH
2020-03-08,16,0,79,0,BH
2020-03-09,30,0,109,0,BH
2020-03-10,1,0,110,0,BH
2020-03-11,52,0,162,0,BH
2020-03-12,0,0,162,0,BH
2020-03-13,48,0,210,0,BH
2020-03-14,1,0,211,0,BH
2020-03-15,3,0,214,0,BH
2020-03-16,7,1,221,1,BH
2020-03-17,16,0,237,1,BH
2020-03-18,19,0,256,1,BH
2020-03-19,13,0,269,1,BH
2020-03-20,16,0,285,1,BH
2020-03-21,21,0,306,1,BH
2020-03-22,28,1,334,2,BH
2020-03-23,5,0,339,2,BH
2020-03-24,51,1,390,3,BH
2020-03-25,29,0,419,3,BH
2020-03-26,39,1,458,4,BH
2020-03-27,8,0,466,4,BH
2020-03-28,7,0,473,4,BH
2020-03-29,27,0,500,4,BH
2020-03-30,15,0,515,4,BH
2020-03-31,52,0,567,4,BH
2020-04-01,2,0,569,4,BH
2020-04-02,74,0,643,4,BH
2020-04-03,0,0,643,4,BH
2020-04-04,45,0,688,4,BH
2020-04-05,12,0,700,4,BH
2020-04-06,56,0,756,4,BH
2020-04-07,55,1,811,5,BH
2020-04-08,12,0,823,5,BH
2020-04-09,64,0,887,5,BH
2020-04-10,111,1,998,6,BH
2020-04-11,42,0,1040,6,BH
2020-04-12,96,0,1136,6,BH
2020-04-13,225,1,1361,7,BH
2020-04-14,167,0,1528,7,BH
2020-04-15,145,0,1673,7,BH
2020-04-16,27,0,1700,7,BH
2020-04-17,44,0,1744,7,BH
2020-04-18,29,0,1773,7,BH
2020-04-19,100,0,1873,7,BH
2020-04-20,34,0,1907,7,BH
2020-04-21,66,0,1973,7,BH
2020-04-22,34,0,2007,7,BH
2020-04-23,210,1,2217,8,BH
2020-04-24,301,0,2518,8,BH
2020-04-25,71,0,2589,8,BH
2020-04-26,58,0,2647,8,BH
2020-04-27,76,0,2723,8,BH
2020-04-28,88,0,2811,8,BH
2020-04-29,110,0,2921,8,BH
2020-04-30,119,0,3040,8,BH
2020-05-01,130,0,3170,8,BH
2020-05-02,114,0,3284,8,BH
2020-05-03,99,0,3383,8,BH
2020-05-04,150,0,3533,8,BH
2020-05-05,187,0,3720,8,BH
2020-05-06,214,0,3934,8,BH
2020-05-07,265,0,4199,8,BH
2020-05-08,245,0,4444,8,BH
2020-05-09,330,0,4774,8,BH
2020-05-10,167,0,4941,8,BH
2020-05-11,295,0,5236,8,BH
2020-05-12,295,1,5531,9,BH
2020-05-13,285,1,5816,10,BH
2020-05-14,382,0,6198,10,BH
2020-05-15,385,2,6583,12,BH
2020-05-16,164,0,6747,12,BH
2020-05-17,209,0,6956,12,BH
2020-05-18,228,0,7184,12,BH
2020-05-19,348,0,7532,12,BH
2020-05-20,356,0,7888,12,BH
2020-05-21,286,0,8174,12,BH
2020-05-22,240,0,8414,12,BH
2020-05-23,388,1,8802,13,BH
2020-05-24,336,1,9138,14,BH
2020-05-25,33,0,9171,14,BH
2020-05-26,195,0,9366,14,BH
2020-05-27,267,1,9633,15,BH
2020-05-28,419,0,10052,15,BH
2020-05-29,397,0,10449,15,BH
2020-05-30,344,2,10793,17,BH
2020-05-31,605,2,11398,19,BH
2020-06-01,406,0,11804,19,BH
2020-06-02,507,0,12311,19,BH
2020-06-03,504,1,12815,20,BH
2020-06-04,481,1,13296,21,BH
2020-06-05,539,2,13835,23,BH
2020-06-06,548,1,14383,24,BH
2020-06-07,380,2,14763,26,BH
2020-06-08,654,0,15417,26,BH
2020-06-09,783,3,16200,29,BH
2020-06-10,0,2,16200,31,BH
2020-06-11,1069,5,17269,36,BH
2020-06-12,444,0,17713,36,BH
2020-06-13,514,3,18227,39,BH
2020-06-14,0,4,18227,43,BH
2020-06-15,786,3,19013,46,BH
2020-06-16,540,1,19553,47,BH
2020-06-17,408,2,19961,49,BH
2020-06-18,469,6,20430,55,BH
2020-06-19,486,2,20916,57,BH
2020-06-20,415,3,21331,60,BH
2020-06-21,433,3,21764,63,BH
2020-06-22,643,2,22407,65,BH
2020-06-23,655,2,23062,67,BH
2020-06-24,508,2,23570,69,BH
2020-06-25,511,2,24081,71,BH
2020-06-26,724,8,24805,79,BH
2020-03-31,2,0,2,0,BI
2020-04-01,0,0,2,0,BI
2020-04-02,1,0,3,0,BI
2020-04-03,0,0,3,0,BI
2020-04-04,0,0,3,0,BI
2020-04-05,0,0,3,0,BI
2020-04-06,0,0,3,0,BI
2020-04-07,0,0,3,0,BI
2020-04-08,0,0,3,0,BI
2020-04-09,0,0,3,0,BI
2020-04-10,0,0,3,0,BI
2020-04-11,2,0,5,0,BI
2020-04-12,0,0,5,0,BI
2020-04-13,0,0,5,0,BI
2020-04-14,0,1,5,1,BI
2020-04-15,0,0,5,1,BI
2020-04-16,0,0,5,1,BI
2020-04-17,1,0,6,1,BI
2020-04-18,0,0,6,1,BI
2020-04-19,0,0,6,1,BI
2020-04-20,0,0,6,1,BI
2020-04-21,0,0,6,1,BI
2020-04-22,5,0,11,1,BI
2020-04-23,0,0,11,1,BI
2020-04-24,1,0,12,1,BI
2020-04-25,3,0,15,1,BI
2020-04-26,0,0,15,1,BI
2020-04-27,0,0,15,1,BI
2020-04-28,0,0,15,1,BI
2020-04-29,0,0,15,1,BI
2020-04-30,0,0,15,1,BI
2020-05-01,0,0,15,1,BI
2020-05-02,4,0,19,1,BI
2020-05-03,0,0,19,1,BI
2020-05-04,0,0,19,1,BI
2020-05-05,0,0,19,1,BI
2020-05-06,0,0,19,1,BI
2020-05-07,0,0,19,1,BI
2020-05-08,0,0,19,1,BI
2020-05-09,0,0,19,1,BI
2020-05-10,0,0,19,1,BI
2020-05-11,0,0,19,1,BI
2020-05-12,8,0,27,1,BI
2020-05-13,0,0,27,1,BI
2020-05-14,0,0,27,1,BI
2020-05-15,0,0,27,1,BI
2020-05-16,0,0,27,1,BI
2020-05-17,15,0,42,1,BI
2020-05-18,0,0,42,1,BI
2020-05-19,0,0,42,1,BI
2020-05-20,0,0,42,1,BI
2020-05-21,0,0,42,1,BI
2020-05-22,0,0,42,1,BI
2020-05-23,0,0,42,1,BI
2020-05-24,0,0,42,1,BI
2020-05-25,0,0,42,1,BI
2020-05-26,0,0,42,1,BI
2020-05-27,0,0,42,1,BI
2020-05-28,0,0,42,1,BI
2020-05-29,0,0,42,1,BI
2020-05-30,0,0,42,1,BI
2020-05-31,21,0,63,1,BI
2020-06-01,0,0,63,1,BI
2020-06-02,0,0,63,1,BI
2020-06-03,0,0,63,1,BI
2020-06-04,0,0,63,1,BI
2020-06-05,0,0,63,1,BI
2020-06-06,20,0,83,1,BI
2020-06-07,0,0,83,1,BI
2020-06-08,0,0,83,1,BI
2020-06-09,0,0,83,1,BI
2020-06-10,0,0,83,1,BI
2020-06-11,11,0,94,1,BI
2020-06-12,0,0,94,1,BI
2020-06-13,0,0,94,1,BI
2020-06-14,0,0,94,1,BI
2020-06-15,10,0,104,1,BI
2020-06-16,0,0,104,1,BI
2020-06-17,0,0,104,1,BI
2020-06-18,0,0,104,1,BI
2020-06-19,0,0,104,1,BI
2020-06-20,40,0,144,1,BI
2020-06-21,0,0,144,1,BI
2020-06-22,0,0,144,1,BI
2020-06-23,0,0,144,1,BI
2020-06-24,0,0,144,1,BI
2020-06-25,0,0,144,1,BI
2020-06-26,0,0,144,1,BI
2020-03-16,1,0,1,0,BJ
2020-03-17,0,0,1,0,BJ
2020-03-18,0,0,1,0,BJ
2020-03-19,1,0,2,0,BJ
2020-03-20,0,0,2,0,BJ
2020-03-21,0,0,2,0,BJ
2020-03-22,0,0,2,0,BJ
2020-03-23,3,0,5,0,BJ
2020-03-24,0,0,5,0,BJ
2020-03-25,0,0,5,0,BJ
2020-03-26,1,0,6,0,BJ
2020-03-27,0,0,6,0,BJ
2020-03-28,0,0,6,0,BJ
2020-03-29,0,0,6,0,BJ
2020-03-30,0,0,6,0,BJ
2020-03-31,2,0,8,0,BJ
2020-04-01,5,0,13,0,BJ
2020-04-02,0,0,13,0,BJ
2020-04-03,3,0,16,0,BJ
2020-04-04,0,0,16,0,BJ
2020-04-05,6,0,22,0,BJ
2020-04-06,4,1,26,1,BJ
2020-04-07,0,0,26,1,BJ
2020-04-08,0,0,26,1,BJ
2020-04-09,4,0,30,1,BJ
2020-04-10,5,0,35,1,BJ
2020-04-11,0,0,35,1,BJ
2020-04-12,0,0,35,1,BJ
2020-04-13,0,0,35,1,BJ
2020-04-14,0,0,35,1,BJ
2020-04-15,0,0,35,1,BJ
2020-04-16,2,0,37,1,BJ
2020-04-17,0,0,37,1,BJ
2020-04-18,0,0,37,1,BJ
2020-04-19,0,0,37,1,BJ
2020-04-20,17,0,54,1,BJ
2020-04-21,0,0,54,1,BJ
2020-04-22,0,0,54,1,BJ
2020-04-23,4,0,58,1,BJ
2020-04-24,0,0,58,1,BJ
2020-04-25,0,0,58,1,BJ
2020-04-26,6,0,64,1,BJ
2020-04-27,0,0,64,1,BJ
2020-04-28,0,0,64,1,BJ
2020-04-29,5,1,69,2,BJ
2020-04-30,15,0,84,2,BJ
2020-05-01,6,0,90,2,BJ
2020-05-02,0,0,90,2,BJ
2020-05-03,0,0,90,2,BJ
2020-05-04,6,0,96,2,BJ
2020-05-05,0,0,96,2,BJ
2020-05-06,6,0,102,2,BJ
2020-05-07,38,0,140,2,BJ
2020-05-08,102,0,242,2,BJ
2020-05-09,42,0,284,2,BJ
2020-05-10,35,0,319,2,BJ
2020-05-11,0,0,319,2,BJ
2020-05-12,8,0,327,2,BJ
2020-05-13,0,0,327,2,BJ
2020-05-14,12,0,339,2,BJ
2020-05-15,0,0,339,2,BJ
2020-05-16,0,0,339,2,BJ
2020-05-17,0,0,339,2,BJ
2020-05-18,0,0,339,2,BJ
2020-05-19,-209,0,130,2,BJ
2020-05-20,0,0,130,2,BJ
2020-05-21,5,1,135,3,BJ
2020-05-22,0,0,135,3,BJ
2020-05-23,0,0,135,3,BJ
2020-05-24,56,0,191,3,BJ
2020-05-25,0,0,191,3,BJ
2020-05-26,17,0,208,3,BJ
2020-05-27,2,0,210,3,BJ
2020-05-28,0,0,210,3,BJ
2020-05-29,14,0,224,3,BJ
2020-05-30,8,0,232,3,BJ
2020-05-31,0,0,232,3,BJ
2020-06-01,11,0,243,3,BJ
2020-06-02,1,0,244,3,BJ
2020-06-03,0,0,244,3,BJ
2020-06-04,17,0,261,3,BJ
2020-06-05,0,0,261,3,BJ
2020-06-06,7,1,268,4,BJ
2020-06-07,0,0,268,4,BJ
2020-06-08,37,0,305,4,BJ
2020-06-09,0,0,305,4,BJ
2020-06-10,0,0,305,4,BJ
2020-06-11,0,0,305,4,BJ
2020-06-12,83,1,388,5,BJ
2020-06-13,24,1,412,6,BJ
2020-06-14,58,1,470,7,BJ
2020-06-15,13,2,483,9,BJ
2020-06-16,49,0,532,9,BJ
2020-06-17,40,0,572,9,BJ
2020-06-18,25,2,597,11,BJ
2020-06-19,53,0,650,11,BJ
2020-06-20,0,0,650,11,BJ
2020-06-21,115,2,765,13,BJ
2020-06-22,42,0,807,13,BJ
2020-06-23,43,0,850,13,BJ
2020-06-24,52,0,902,13,BJ
2020-06-25,115,1,1017,14,BJ
2020-06-26,36,0,1053,14,BJ
2020-03-19,2,0,2,0,BM
2020-03-20,0,0,2,0,BM
2020-03-21,0,0,2,0,BM
2020-03-22,4,0,6,0,BM
2020-03-23,0,0,6,0,BM
2020-03-24,0,0,6,0,BM
2020-03-25,0,0,6,0,BM
2020-03-26,9,0,15,0,BM
2020-03-27,2,0,17,0,BM
2020-03-28,5,0,22,0,BM
2020-03-29,0,0,22,0,BM
2020-03-30,5,0,27,0,BM
2020-03-31,5,0,32,0,BM
2020-04-01,0,0,32,0,BM
2020-04-02,3,0,35,0,BM
2020-04-03,0,0,35,0,BM
2020-04-04,2,0,37,0,BM
2020-04-05,0,0,37,0,BM
2020-04-06,2,2,39,2,BM
2020-04-07,0,0,39,2,BM
2020-04-08,0,1,39,3,BM
2020-04-09,9,1,48,4,BM
2020-04-10,0,0,48,4,BM
2020-04-11,2,0,50,4,BM
2020-04-12,7,0,57,4,BM
2020-04-13,0,0,57,4,BM
2020-04-14,0,1,57,5,BM
2020-04-15,24,0,81,5,BM
2020-04-16,2,0,83,5,BM
2020-04-17,0,0,83,5,BM
2020-04-18,3,0,86,5,BM
2020-04-19,0,0,86,5,BM
2020-04-20,0,0,86,5,BM
2020-04-21,12,0,98,5,BM
2020-04-22,1,0,99,5,BM
2020-04-23,0,0,99,5,BM
2020-04-24,0,0,99,5,BM
2020-04-25,0,0,99,5,BM
2020-04-26,10,0,109,5,BM
2020-04-27,1,1,110,6,BM
2020-04-28,0,0,110,6,BM
2020-04-29,1,0,111,6,BM
2020-04-30,3,0,114,6,BM
2020-05-01,0,0,114,6,BM
2020-05-02,0,1,114,7,BM
2020-05-03,1,0,115,7,BM
2020-05-04,0,0,115,7,BM
2020-05-05,0,0,115,7,BM
2020-05-06,3,0,118,7,BM
2020-05-07,0,0,118,7,BM
2020-05-08,0,0,118,7,BM
2020-05-09,0,0,118,7,BM
2020-05-10,0,0,118,7,BM
2020-05-11,1,1,119,8,BM
2020-05-12,2,0,121,8,BM
2020-05-13,0,0,121,8,BM
2020-05-14,1,1,122,9,BM
2020-05-15,1,0,123,9,BM
2020-05-16,0,0,123,9,BM
2020-05-17,0,0,123,9,BM
2020-05-18,2,0,125,9,BM
2020-05-19,0,0,125,9,BM
2020-05-20,0,0,125,9,BM
2020-05-21,0,0,125,9,BM
2020-05-22,3,0,128,9,BM
2020-05-23,5,0,133,9,BM
2020-05-24,0,0,133,9,BM
2020-05-25,0,0,133,9,BM
2020-05-26,6,0,139,9,BM
2020-05-27,0,0,139,9,BM
2020-05-28,1,0,140,9,BM
2020-05-29,0,0,140,9,BM
2020-05-30,0,0,140,9,BM
2020-05-31,0,0,140,9,BM
2020-06-01,1,0,141,9,BM
2020-06-02,0,0,141,9,BM
2020-06-03,0,0,141,9,BM
2020-06-04,0,0,141,9,BM
2020-06-05,0,0,141,9,BM
2020-06-06,0,0,141,9,BM
2020-06-07,0,0,141,9,BM
2020-06-08,0,0,141,9,BM
2020-06-09,0,0,141,9,BM
2020-06-10,0,0,141,9,BM
2020-06-11,0,0,141,9,BM
2020-06-12,1,0,142,9,BM
2020-06-13,2,0,144,9,BM
2020-06-14,0,0,144,9,BM
2020-06-15,0,0,144,9,BM
2020-06-16,0,0,144,9,BM
2020-06-17,0,0,144,9,BM
2020-06-18,0,0,144,9,BM
2020-06-19,2,0,146,9,BM
2020-06-20,0,0,146,9,BM
2020-06-21,0,0,146,9,BM
2020-06-22,0,0,146,9,BM
2020-06-23,0,0,146,9,BM
2020-06-24,0,0,146,9,BM
2020-06-25,0,0,146,9,BM
2020-06-26,0,0,146,9,BM
2020-03-09,1,0,1,0,BN
2020-03-11,10,0,11,0,BN
2020-03-12,14,0,25,0,BN
2020-03-13,12,0,37,0,BN
2020-03-14,3,0,40,0,BN
2020-03-15,10,0,50,0,BN
2020-03-16,4,0,54,0,BN
2020-03-17,2,0,56,0,BN
2020-03-18,12,0,68,0,BN
2020-03-19,5,0,73,0,BN
2020-03-20,5,0,78,0,BN
2020-03-21,5,0,83,0,BN
2020-03-22,5,0,88,0,BN
2020-03-23,3,0,91,0,BN
2020-03-24,13,0,104,0,BN
2020-03-25,3,0,107,0,BN
2020-03-26,7,0,114,0,BN
2020-03-27,1,0,115,0,BN
2020-03-28,5,1,120,1,BN
2020-03-29,6,0,126,1,BN
2020-03-30,1,0,127,1,BN
2020-03-31,2,0,129,1,BN
2020-04-01,2,0,131,1,BN
2020-04-02,2,0,133,1,BN
2020-04-03,0,0,133,1,BN
2020-04-04,2,0,135,1,BN
2020-04-05,0,0,135,1,BN
2020-04-06,0,0,135,1,BN
2020-04-07,0,0,135,1,BN
2020-04-08,0,0,135,1,BN
2020-04-09,0,0,135,1,BN
2020-04-10,1,0,136,1,BN
2020-04-11,0,0,136,1,BN
2020-04-12,0,0,136,1,BN
2020-04-13,0,0,136,1,BN
2020-04-14,0,0,136,1,BN
2020-04-15,0,0,136,1,BN
2020-04-16,0,0,136,1,BN
2020-04-17,0,0,136,1,BN
2020-04-18,1,0,137,1,BN
2020-04-19,1,0,138,1,BN
2020-04-20,0,0,138,1,BN
2020-04-21,0,0,138,1,BN
2020-04-22,0,0,138,1,BN
2020-04-23,0,0,138,1,BN
2020-04-24,0,0,138,1,BN
2020-04-25,0,0,138,1,BN
2020-04-26,0,0,138,1,BN
2020-04-27,0,0,138,1,BN
2020-04-28,0,0,138,1,BN
2020-04-29,0,0,138,1,BN
2020-04-30,0,0,138,1,BN
2020-05-01,0,0,138,1,BN
2020-05-02,0,0,138,1,BN
2020-05-03,0,0,138,1,BN
2020-05-04,0,0,138,1,BN
2020-05-05,0,0,138,1,BN
2020-05-06,1,0,139,1,BN
2020-05-07,2,0,141,1,BN
2020-05-08,0,0,141,1,BN
2020-05-09,0,0,141,1,BN
2020-05-10,0,0,141,1,BN
2020-05-11,0,0,141,1,BN
2020-05-12,0,0,141,1,BN
2020-05-13,0,0,141,1,BN
2020-05-14,0,0,141,1,BN
2020-05-15,0,0,141,1,BN
2020-05-16,0,0,141,1,BN
2020-05-17,0,0,141,1,BN
2020-05-18,0,0,141,1,BN
2020-05-19,0,0,141,1,BN
2020-05-20,0,0,141,1,BN
2020-05-21,0,0,141,1,BN
2020-05-22,0,0,141,1,BN
2020-05-23,0,0,141,1,BN
2020-05-24,0,0,141,1,BN
2020-05-25,0,0,141,1,BN
2020-05-26,0,0,141,1,BN
2020-05-27,0,1,141,2,BN
2020-05-28,0,0,141,2,BN
2020-05-29,0,0,141,2,BN
2020-05-30,0,0,141,2,BN
2020-05-31,0,0,141,2,BN
2020-06-01,0,0,141,2,BN
2020-06-02,0,0,141,2,BN
2020-06-03,0,0,141,2,BN
2020-06-04,0,0,141,2,BN
2020-06-05,0,0,141,2,BN
2020-06-06,0,0,141,2,BN
2020-06-07,0,0,141,2,BN
2020-06-08,0,0,141,2,BN
2020-06-09,0,0,141,2,BN
2020-06-10,0,0,141,2,BN
2020-06-11,0,0,141,2,BN
2020-06-12,0,0,141,2,BN
2020-06-13,0,0,141,2,BN
2020-06-14,0,0,141,2,BN
2020-06-15,0,0,141,2,BN
2020-06-16,0,1,141,3,BN
2020-06-17,0,0,141,3,BN
2020-06-18,0,0,141,3,BN
2020-06-19,0,0,141,3,BN
2020-06-20,0,0,141,3,BN
2020-06-21,0,0,141,3,BN
2020-06-22,0,0,141,3,BN
2020-06-23,0,0,141,3,BN
2020-06-24,0,0,141,3,BN
2020-06-25,0,0,141,3,BN
2020-06-26,0,0,141,3,BN
2020-03-11,2,0,2,0,BO
2020-03-12,1,0,3,0,BO
2020-03-13,7,0,10,0,BO
2020-03-14,0,0,10,0,BO
2020-03-16,1,0,11,0,BO
2020-03-17,1,0,12,0,BO
2020-03-18,0,0,12,0,BO
2020-03-19,3,0,15,0,BO
2020-03-20,4,0,19,0,BO
2020-03-21,1,0,20,0,BO
2020-03-22,7,0,27,0,BO
2020-03-23,1,0,28,0,BO
2020-03-24,4,0,32,0,BO
2020-03-25,7,0,39,0,BO
2020-03-26,22,0,61,0,BO
2020-03-27,13,0,74,0,BO
2020-03-28,7,0,81,0,BO
2020-03-29,15,3,96,3,BO
2020-03-30,11,3,107,6,BO
2020-03-31,8,1,115,7,BO
2020-04-01,8,1,123,8,BO
2020-04-02,9,1,132,9,BO
2020-04-03,7,1,139,10,BO
2020-04-04,18,0,157,10,BO
2020-04-05,26,1,183,11,BO
2020-04-06,11,3,194,14,BO
2020-04-07,16,1,210,15,BO
2020-04-08,54,3,264,18,BO
2020-04-09,4,1,268,19,BO
2020-04-10,8,1,276,20,BO
2020-04-11,24,4,300,24,BO
2020-04-12,30,3,330,27,BO
2020-04-13,24,1,354,28,BO
2020-04-14,43,0,397,28,BO
2020-04-15,44,1,441,29,BO
2020-04-16,24,2,465,31,BO
2020-04-17,28,0,493,31,BO
2020-04-18,27,1,520,32,BO
2020-04-19,44,1,564,33,BO
2020-04-20,34,1,598,34,BO
2020-04-21,11,3,609,37,BO
2020-04-22,63,3,672,40,BO
2020-04-23,31,3,703,43,BO
2020-04-24,104,1,807,44,BO
2020-04-25,59,2,866,46,BO
2020-04-26,84,4,950,50,BO
2020-04-27,64,3,1014,53,BO
2020-04-28,39,2,1053,55,BO
2020-04-29,57,4,1110,59,BO
2020-04-30,57,3,1167,62,BO
2020-05-01,62,4,1229,66,BO
2020-05-02,241,5,1470,71,BO
2020-05-03,124,5,1594,76,BO
2020-05-04,87,6,1681,82,BO
2020-05-05,121,4,1802,86,BO
2020-05-06,84,5,1886,91,BO
2020-05-07,195,11,2081,102,BO
2020-05-08,185,4,2266,106,BO
2020-05-09,171,8,2437,114,BO
2020-05-10,119,4,2556,118,BO
2020-05-11,275,4,2831,122,BO
2020-05-12,133,6,2964,128,BO
2020-05-13,184,14,3148,142,BO
2020-05-14,224,10,3372,152,BO
2020-05-15,205,12,3577,164,BO
2020-05-16,249,1,3826,165,BO
2020-05-17,262,4,4088,169,BO
2020-05-18,175,5,4263,174,BO
2020-05-19,218,15,4481,189,BO
2020-05-20,438,10,4919,199,BO
2020-05-21,268,16,5187,215,BO
2020-05-22,392,15,5579,230,BO
2020-05-23,336,10,5915,240,BO
2020-05-24,348,10,6263,250,BO
2020-05-25,397,11,6660,261,BO
2020-05-26,476,13,7136,274,BO
2020-05-27,632,6,7768,280,BO
2020-05-28,619,13,8387,293,BO
2020-05-29,344,7,8731,300,BO
2020-05-30,861,10,9592,310,BO
2020-05-31,390,3,9982,313,BO
2020-06-01,549,30,10531,343,BO
2020-06-02,460,33,10991,376,BO
2020-06-03,647,24,11638,400,BO
2020-06-04,607,15,12245,415,BO
2020-06-05,483,12,12728,427,BO
2020-06-06,630,27,13358,454,BO
2020-06-07,285,11,13643,465,BO
2020-06-08,306,10,13949,475,BO
2020-06-09,695,12,14644,487,BO
2020-06-10,637,25,15281,512,BO
2020-06-11,884,21,16165,533,BO
2020-06-12,764,26,16929,559,BO
2020-06-13,913,26,17842,585,BO
2020-06-14,617,26,18459,611,BO
2020-06-15,614,21,19073,632,BO
2020-06-16,810,27,19883,659,BO
2020-06-17,802,20,20685,679,BO
2020-06-18,814,18,21499,697,BO
2020-06-19,977,18,22476,715,BO
2020-06-20,1036,25,23512,740,BO
2020-06-21,876,33,24388,773,BO
2020-06-22,1105,47,25493,820,BO
2020-06-23,896,26,26389,846,BO
2020-06-24,1098,30,27487,876,BO
2020-06-25,1016,37,28503,913,BO
2020-06-26,920,21,29423,934,BO
2020-04-01,2,0,2,0,BQ
2020-04-02,0,0,2,0,BQ
2020-04-03,0,0,2,0,BQ
2020-04-04,0,0,2,0,BQ
2020-04-05,0,0,2,0,BQ
2020-04-06,0,0,2,0,BQ
2020-04-07,0,0,2,0,BQ
2020-04-08,0,0,2,0,BQ
2020-04-09,0,0,2,0,BQ
2020-04-10,0,0,2,0,BQ
2020-04-11,0,0,2,0,BQ
2020-04-12,1,0,3,0,BQ
2020-04-13,1,0,4,0,BQ
2020-04-14,0,0,4,0,BQ
2020-04-15,0,0,4,0,BQ
2020-04-16,0,0,4,0,BQ
2020-04-17,0,0,4,0,BQ
2020-04-18,0,0,4,0,BQ
2020-04-19,1,0,5,0,BQ
2020-04-20,0,0,5,0,BQ
2020-04-21,1,0,6,0,BQ
2020-04-22,0,0,6,0,BQ
2020-04-23,0,0,6,0,BQ
2020-04-24,0,0,6,0,BQ
2020-04-25,0,0,6,0,BQ
2020-04-26,0,0,6,0,BQ
2020-04-27,0,0,6,0,BQ
2020-04-28,0,0,6,0,BQ
2020-04-29,0,0,6,0,BQ
2020-04-30,0,0,6,0,BQ
2020-05-01,0,0,6,0,BQ
2020-05-02,0,0,6,0,BQ
2020-05-03,0,0,6,0,BQ
2020-05-04,0,0,6,0,BQ
2020-05-05,0,0,6,0,BQ
2020-05-06,0,0,6,0,BQ
2020-05-07,0,0,6,0,BQ
2020-05-08,0,0,6,0,BQ
2020-05-09,0,0,6,0,BQ
2020-05-10,0,0,6,0,BQ
2020-05-11,0,0,6,0,BQ
2020-05-12,0,0,6,0,BQ
2020-05-13,0,0,6,0,BQ
2020-05-14,0,0,6,0,BQ
2020-05-15,0,0,6,0,BQ
2020-05-16,0,0,6,0,BQ
2020-05-17,0,0,6,0,BQ
2020-05-18,0,0,6,0,BQ
2020-05-19,0,0,6,0,BQ
2020-05-20,0,0,6,0,BQ
2020-05-21,0,0,6,0,BQ
2020-05-22,0,0,6,0,BQ
2020-05-23,0,0,6,0,BQ
2020-05-24,1,0,7,0,BQ
2020-05-25,0,0,7,0,BQ
2020-05-26,0,0,7,0,BQ
2020-05-27,0,0,7,0,BQ
2020-05-28,0,0,7,0,BQ
2020-05-29,0,0,7,0,BQ
2020-05-30,0,0,7,0,BQ
2020-05-31,0,0,7,0,BQ
2020-06-01,0,0,7,0,BQ
2020-06-02,0,0,7,0,BQ
2020-06-03,0,0,7,0,BQ
2020-06-04,0,0,7,0,BQ
2020-06-05,0,0,7,0,BQ
2020-06-06,0,0,7,0,BQ
2020-06-07,0,0,7,0,BQ
2020-06-08,0,0,7,0,BQ
2020-06-09,0,0,7,0,BQ
2020-06-10,0,0,7,0,BQ
2020-06-11,0,0,7,0,BQ
2020-06-12,0,0,7,0,BQ
2020-06-13,0,0,7,0,BQ
2020-06-14,0,0,7,0,BQ
2020-06-15,0,0,7,0,BQ
2020-06-16,0,0,7,0,BQ
2020-06-17,0,0,7,0,BQ
2020-06-18,0,0,7,0,BQ
2020-06-19,0,0,7,0,BQ
2020-06-20,0,0,7,0,BQ
2020-06-21,0,0,7,0,BQ
2020-06-22,0,0,7,0,BQ
2020-06-23,0,0,7,0,BQ
2020-06-24,0,0,7,0,BQ
2020-06-25,0,0,7,0,BQ
2020-06-26,0,0,7,0,BQ
2019-12-30,0,0,0,0,BR
2019-12-31,0,0,0,0,BR
2020-01-01,0,0,0,0,BR
2020-01-02,0,0,0,0,BR
2020-01-03,0,0,0,0,BR
2020-01-04,0,0,0,0,BR
2020-01-05,0,0,0,0,BR
2020-01-06,0,0,0,0,BR
2020-01-07,0,0,0,0,BR
2020-01-08,0,0,0,0,BR
2020-01-09,0,0,0,0,BR
2020-01-10,0,0,0,0,BR
2020-01-11,0,0,0,0,BR
2020-01-12,0,0,0,0,BR
2020-01-13,0,0,0,0,BR
2020-01-14,0,0,0,0,BR
2020-01-15,0,0,0,0,BR
2020-01-16,0,0,0,0,BR
2020-01-17,0,0,0,0,BR
2020-01-18,0,0,0,0,BR
2020-01-19,0,0,0,0,BR
2020-01-20,0,0,0,0,BR
2020-01-21,0,0,0,0,BR
2020-01-22,0,0,0,0,BR
2020-01-23,0,0,0,0,BR
2020-01-24,0,0,0,0,BR
2020-01-25,0,0,0,0,BR
2020-01-26,0,0,0,0,BR
2020-01-27,0,0,0,0,BR
2020-01-28,0,0,0,0,BR
2020-01-29,0,0,0,0,BR
2020-01-30,0,0,0,0,BR
2020-01-31,0,0,0,0,BR
2020-02-01,0,0,0,0,BR
2020-02-02,0,0,0,0,BR
2020-02-03,0,0,0,0,BR
2020-02-04,0,0,0,0,BR
2020-02-05,0,0,0,0,BR
2020-02-06,0,0,0,0,BR
2020-02-07,0,0,0,0,BR
2020-02-08,0,0,0,0,BR
2020-02-09,0,0,0,0,BR
2020-02-10,0,0,0,0,BR
2020-02-11,0,0,0,0,BR
2020-02-12,0,0,0,0,BR
2020-02-13,0,0,0,0,BR
2020-02-14,0,0,0,0,BR
2020-02-15,0,0,0,0,BR
2020-02-16,0,0,0,0,BR
2020-02-17,0,0,0,0,BR
2020-02-18,0,0,0,0,BR
2020-02-19,0,0,0,0,BR
2020-02-20,0,0,0,0,BR
2020-02-21,0,0,0,0,BR
2020-02-22,0,0,0,0,BR
2020-02-23,0,0,0,0,BR
2020-02-24,0,0,0,0,BR
2020-02-25,1,0,1,0,BR
2020-02-26,0,0,1,0,BR
2020-02-27,0,0,1,0,BR
2020-02-28,0,0,1,0,BR
2020-02-29,1,0,2,0,BR
2020-03-01,0,0,2,0,BR
2020-03-02,0,0,2,0,BR
2020-03-03,0,0,2,0,BR
2020-03-04,1,0,3,0,BR
2020-03-05,5,0,8,0,BR
2020-03-06,5,0,13,0,BR
2020-03-07,0,0,13,0,BR
2020-03-08,12,0,25,0,BR
2020-03-09,0,0,25,0,BR
2020-03-10,9,0,34,0,BR
2020-03-11,18,0,52,0,BR
2020-03-12,25,0,77,0,BR
2020-03-13,21,0,98,0,BR
2020-03-14,23,0,121,0,BR
2020-03-15,79,0,200,0,BR
2020-03-16,34,0,234,0,BR
2020-03-17,57,1,291,1,BR
2020-03-18,137,3,428,4,BR
2020-03-19,193,2,621,6,BR
2020-03-20,283,5,904,11,BR
2020-03-21,224,7,1128,18,BR
2020-03-22,418,7,1546,25,BR
2020-03-23,345,9,1891,34,BR
2020-03-24,310,12,2201,46,BR
2020-03-25,232,11,2433,57,BR
2020-03-26,482,20,2915,77,BR
2020-03-27,502,15,3417,92,BR
2020-03-28,487,22,3904,114,BR
2020-03-29,352,22,4256,136,BR
2020-03-30,323,23,4579,159,BR
2020-03-31,1138,42,5717,201,BR
2020-04-01,1119,40,6836,241,BR
2020-04-02,1074,58,7910,299,BR
2020-04-03,1146,60,9056,359,BR
2020-04-04,1222,73,10278,432,BR
2020-04-05,852,54,11130,486,BR
2020-04-06,926,67,12056,553,BR
2020-04-07,1661,114,13717,667,BR
2020-04-08,2210,133,15927,800,BR
2020-04-09,1930,141,17857,941,BR
2020-04-10,1781,115,19638,1056,BR
2020-04-11,1089,68,20727,1124,BR
2020-04-12,1442,99,22169,1223,BR
2020-04-13,1261,105,23430,1328,BR
2020-04-14,1832,204,25262,1532,BR
2020-04-15,3058,204,28320,1736,BR
2020-04-16,2105,188,30425,1924,BR
2020-04-17,3257,217,33682,2141,BR
2020-04-18,2917,206,36599,2347,BR
2020-04-19,2055,115,38654,2462,BR
2020-04-20,1927,113,40581,2575,BR
2020-04-21,2498,166,43079,2741,BR
2020-04-22,2678,165,45757,2906,BR
2020-04-23,3735,407,49492,3313,BR
2020-04-24,3503,357,52995,3670,BR
2020-04-25,5514,346,58509,4016,BR
2020-04-26,3379,189,61888,4205,BR
2020-04-27,4613,338,66501,4543,BR
2020-04-28,5385,474,71886,5017,BR
2020-04-29,6276,449,78162,5466,BR
2020-04-30,7218,435,85380,5901,BR
2020-05-01,6209,428,91589,6329,BR
2020-05-02,4970,421,96559,6750,BR
2020-05-03,4588,275,101147,7025,BR
2020-05-04,6633,296,107780,7321,BR
2020-05-05,6935,600,114715,7921,BR
2020-05-06,10503,615,125218,8536,BR
2020-05-07,9888,610,135106,9146,BR
2020-05-08,10222,751,145328,9897,BR
2020-05-09,10611,730,155939,10627,BR
2020-05-10,6760,496,162699,11123,BR
2020-05-11,5632,396,168331,11519,BR
2020-05-12,9258,881,177589,12400,BR
2020-05-13,11385,749,188974,13149,BR
2020-05-14,13944,844,202918,13993,BR
2020-05-15,15305,824,218223,14817,BR
2020-05-16,14919,816,233142,15633,BR
2020-05-17,7938,485,241080,16118,BR
2020-05-18,13140,674,254220,16792,BR
2020-05-19,17408,1179,271628,17971,BR
2020-05-20,19951,888,291579,18859,BR
2020-05-21,18508,1188,310087,20047,BR
2020-05-22,20803,1001,330890,21048,BR
2020-05-23,16508,965,347398,22013,BR
2020-05-24,15813,653,363211,22666,BR
2020-05-25,11687,807,374898,23473,BR
2020-05-26,16324,1039,391222,24512,BR
2020-05-27,20599,1086,411821,25598,BR
2020-05-28,26417,1156,438238,26754,BR
2020-05-29,26928,1124,465166,27878,BR
2020-05-30,33274,956,498440,28834,BR
2020-05-31,16409,480,514849,29314,BR
2020-06-01,11598,623,526447,29937,BR
2020-06-02,28936,1262,555383,31199,BR
2020-06-03,28633,1349,584016,32548,BR
2020-06-04,30916,1473,614932,34021,BR
2020-06-05,30830,1005,645762,35026,BR
2020-06-06,27075,904,672837,35930,BR
2020-06-07,18921,525,691758,36455,BR
2020-06-08,15654,679,707412,37134,BR
2020-06-09,32091,1272,739503,38406,BR
2020-06-10,32913,1274,772416,39680,BR
2020-06-11,30412,1239,802828,40919,BR
2020-06-12,25982,909,828810,41828,BR
2020-06-13,21704,892,850514,42720,BR
2020-06-14,17110,612,867624,43332,BR
2020-06-15,20647,627,888271,43959,BR
2020-06-16,34918,1282,923189,45241,BR
2020-06-17,32188,1269,955377,46510,BR
2020-06-18,22765,1238,978142,47748,BR
2020-06-19,54771,1206,1032913,48954,BR
2020-06-20,34666,1022,1067579,49976,BR
2020-06-21,17459,641,1085038,50617,BR
2020-06-22,21432,654,1106470,51271,BR
2020-06-23,39436,1374,1145906,52645,BR
2020-06-24,42725,1185,1188631,53830,BR
2020-06-25,39483,1141,1228114,54971,BR
2020-06-26,46860,990,1274974,55961,BR
2020-03-15,1,0,1,0,BS
2020-03-16,0,0,1,0,BS
2020-03-19,2,0,3,0,BS
2020-03-20,1,0,4,0,BS
2020-03-21,0,0,4,0,BS
2020-03-22,0,0,4,0,BS
2020-03-23,0,0,4,0,BS
2020-03-24,0,0,4,0,BS
2020-03-25,1,0,5,0,BS
2020-03-26,4,0,9,0,BS
2020-03-27,0,0,9,0,BS
2020-03-28,2,0,11,0,BS
2020-03-29,3,0,14,0,BS
2020-03-30,0,0,14,0,BS
2020-03-31,1,0,15,0,BS
2020-04-01,6,1,21,1,BS
2020-04-02,3,0,24,1,BS
2020-04-03,0,2,24,3,BS
2020-04-04,4,1,28,4,BS
2020-04-05,1,1,29,5,BS
2020-04-06,4,0,33,5,BS
2020-04-07,3,1,36,6,BS
2020-04-08,4,1,40,7,BS
2020-04-09,1,1,41,8,BS
2020-04-10,1,0,42,8,BS
2020-04-11,4,0,46,8,BS
2020-04-12,1,0,47,8,BS
2020-04-13,2,0,49,8,BS
2020-04-14,0,0,49,8,BS
2020-04-15,4,0,53,8,BS
2020-04-16,1,1,54,9,BS
2020-04-17,1,0,55,9,BS
2020-04-18,3,0,58,9,BS
2020-04-19,2,0,60,9,BS
2020-04-20,4,0,64,9,BS
2020-04-21,1,0,65,9,BS
2020-04-22,5,0,70,9,BS
2020-04-23,2,2,72,11,BS
2020-04-24,1,0,73,11,BS
2020-04-25,5,0,78,11,BS
2020-04-26,2,0,80,11,BS
2020-04-27,0,0,80,11,BS
2020-04-28,0,0,80,11,BS
2020-04-29,0,0,80,11,BS
2020-04-30,1,0,81,11,BS
2020-05-01,1,0,82,11,BS
2020-05-02,1,0,83,11,BS
2020-05-03,0,0,83,11,BS
2020-05-04,0,0,83,11,BS
2020-05-05,6,0,89,11,BS
2020-05-06,3,0,92,11,BS
2020-05-07,0,0,92,11,BS
2020-05-08,0,0,92,11,BS
2020-05-09,0,0,92,11,BS
2020-05-10,0,0,92,11,BS
2020-05-11,1,0,93,11,BS
2020-05-12,0,0,93,11,BS
2020-05-13,1,0,94,11,BS
2020-05-14,2,0,96,11,BS
2020-05-15,0,0,96,11,BS
2020-05-16,0,0,96,11,BS
2020-05-17,0,0,96,11,BS
2020-05-18,0,0,96,11,BS
2020-05-19,0,0,96,11,BS
2020-05-20,1,0,97,11,BS
2020-05-21,0,0,97,11,BS
2020-05-22,0,0,97,11,BS
2020-05-23,3,0,100,11,BS
2020-05-24,0,0,100,11,BS
2020-05-25,0,0,100,11,BS
2020-05-26,0,0,100,11,BS
2020-05-27,0,0,100,11,BS
2020-05-28,1,0,101,11,BS
2020-05-29,1,0,102,11,BS
2020-05-30,0,0,102,11,BS
2020-05-31,0,0,102,11,BS
2020-06-01,0,0,102,11,BS
2020-06-02,0,0,102,11,BS
2020-06-03,0,0,102,11,BS
2020-06-04,0,0,102,11,BS
2020-06-05,0,0,102,11,BS
2020-06-06,1,0,103,11,BS
2020-06-07,0,0,103,11,BS
2020-06-08,0,0,103,11,BS
2020-06-09,0,0,103,11,BS
2020-06-10,0,0,103,11,BS
2020-06-11,0,0,103,11,BS
2020-06-12,0,0,103,11,BS
2020-06-13,0,0,103,11,BS
2020-06-14,0,0,103,11,BS
2020-06-15,1,0,104,11,BS
2020-06-16,0,0,104,11,BS
2020-06-17,0,0,104,11,BS
2020-06-18,0,0,104,11,BS
2020-06-19,0,0,104,11,BS
2020-06-20,0,0,104,11,BS
2020-06-21,0,0,104,11,BS
2020-06-22,0,0,104,11,BS
2020-06-23,0,0,104,11,BS
2020-06-24,0,0,104,11,BS
2020-06-25,0,0,104,11,BS
2020-06-26,0,0,104,11,BS
2020-03-05,1,0,1,0,BT
2020-03-12,0,0,1,0,BT
2020-03-14,0,0,1,0,BT
2020-03-16,0,0,1,0,BT
2020-03-17,0,0,1,0,BT
2020-03-18,0,0,1,0,BT
2020-03-19,0,0,1,0,BT
2020-03-20,1,0,2,0,BT
2020-03-21,0,0,2,0,BT
2020-03-22,0,0,2,0,BT
2020-03-23,0,0,2,0,BT
2020-03-24,0,0,2,0,BT
2020-03-25,1,0,3,0,BT
2020-03-26,0,0,3,0,BT
2020-03-27,0,0,3,0,BT
2020-03-28,1,0,4,0,BT
2020-03-29,0,0,4,0,BT
2020-03-30,0,0,4,0,BT
2020-03-31,0,0,4,0,BT
2020-04-01,1,0,5,0,BT
2020-04-02,0,0,5,0,BT
2020-04-03,0,0,5,0,BT
2020-04-04,0,0,5,0,BT
2020-04-05,0,0,5,0,BT
2020-04-06,0,0,5,0,BT
2020-04-07,0,0,5,0,BT
2020-04-08,0,0,5,0,BT
2020-04-09,0,0,5,0,BT
2020-04-10,0,0,5,0,BT
2020-04-11,0,0,5,0,BT
2020-04-12,0,0,5,0,BT
2020-04-13,0,0,5,0,BT
2020-04-14,0,0,5,0,BT
2020-04-15,0,0,5,0,BT
2020-04-16,0,0,5,0,BT
2020-04-17,0,0,5,0,BT
2020-04-18,0,0,5,0,BT
2020-04-19,0,0,5,0,BT
2020-04-20,1,0,6,0,BT
2020-04-21,0,0,6,0,BT
2020-04-22,1,0,7,0,BT
2020-04-23,0,0,7,0,BT
2020-04-24,0,0,7,0,BT
2020-04-25,0,0,7,0,BT
2020-04-26,0,0,7,0,BT
2020-04-27,0,0,7,0,BT
2020-04-28,0,0,7,0,BT
2020-04-29,0,0,7,0,BT
2020-04-30,0,0,7,0,BT
2020-05-01,0,0,7,0,BT
2020-05-02,0,0,7,0,BT
2020-05-03,0,0,7,0,BT
2020-05-04,0,0,7,0,BT
2020-05-05,0,0,7,0,BT
2020-05-06,0,0,7,0,BT
2020-05-07,0,0,7,0,BT
2020-05-08,0,0,7,0,BT
2020-05-09,0,0,7,0,BT
2020-05-10,2,0,9,0,BT
2020-05-11,2,0,11,0,BT
2020-05-12,0,0,11,0,BT
2020-05-13,4,0,15,0,BT
2020-05-14,5,0,20,0,BT
2020-05-15,1,0,21,0,BT
2020-05-16,0,0,21,0,BT
2020-05-17,0,0,21,0,BT
2020-05-18,0,0,21,0,BT
2020-05-19,0,0,21,0,BT
2020-05-20,0,0,21,0,BT
2020-05-21,0,0,21,0,BT
2020-05-22,3,0,24,0,BT
2020-05-23,0,0,24,0,BT
2020-05-24,3,0,27,0,BT
2020-05-25,0,0,27,0,BT
2020-05-26,0,0,27,0,BT
2020-05-27,1,0,28,0,BT
2020-05-28,3,0,31,0,BT
2020-05-29,2,0,33,0,BT
2020-05-30,10,0,43,0,BT
2020-05-31,0,0,43,0,BT
2020-06-01,4,0,47,0,BT
2020-06-02,0,0,47,0,BT
2020-06-03,0,0,47,0,BT
2020-06-04,1,0,48,0,BT
2020-06-05,0,0,48,0,BT
2020-06-06,0,0,48,0,BT
2020-06-07,11,0,59,0,BT
2020-06-08,0,0,59,0,BT
2020-06-09,0,0,59,0,BT
2020-06-10,3,0,62,0,BT
2020-06-11,0,0,62,0,BT
2020-06-12,0,0,62,0,BT
2020-06-13,4,0,66,0,BT
2020-06-14,0,0,66,0,BT
2020-06-15,1,0,67,0,BT
2020-06-16,0,0,67,0,BT
2020-06-17,0,0,67,0,BT
2020-06-18,0,0,67,0,BT
2020-06-19,1,0,68,0,BT
2020-06-20,0,0,68,0,BT
2020-06-21,0,0,68,0,BT
2020-06-22,1,0,69,0,BT
2020-06-23,1,0,70,0,BT
2020-06-24,0,0,70,0,BT
2020-06-25,0,0,70,0,BT
2020-06-26,5,0,75,0,BT
2020-03-31,3,0,3,0,BW
2020-04-01,1,1,4,1,BW
2020-04-02,0,0,4,1,BW
2020-04-03,0,0,4,1,BW
2020-04-04,0,0,4,1,BW
2020-04-05,2,0,6,1,BW
2020-04-06,0,0,6,1,BW
2020-04-07,0,0,6,1,BW
2020-04-08,1,0,7,1,BW
2020-04-09,6,0,13,1,BW
2020-04-10,0,0,13,1,BW
2020-04-11,0,0,13,1,BW
2020-04-12,0,0,13,1,BW
2020-04-13,0,0,13,1,BW
2020-04-14,0,0,13,1,BW
2020-04-15,0,0,13,1,BW
2020-04-16,2,0,15,1,BW
2020-04-17,0,0,15,1,BW
2020-04-18,0,0,15,1,BW
2020-04-19,5,0,20,1,BW
2020-04-20,0,0,20,1,BW
2020-04-21,0,0,20,1,BW
2020-04-22,2,0,22,1,BW
2020-04-23,0,0,22,1,BW
2020-04-24,0,0,22,1,BW
2020-04-25,0,0,22,1,BW
2020-04-26,0,0,22,1,BW
2020-04-27,0,0,22,1,BW
2020-04-28,1,0,23,1,BW
2020-04-29,0,0,23,1,BW
2020-04-30,0,0,23,1,BW
2020-05-01,0,0,23,1,BW
2020-05-02,0,0,23,1,BW
2020-05-03,0,0,23,1,BW
2020-05-04,0,0,23,1,BW
2020-05-05,0,0,23,1,BW
2020-05-06,0,0,23,1,BW
2020-05-07,0,0,23,1,BW
2020-05-08,0,0,23,1,BW
2020-05-09,0,0,23,1,BW
2020-05-10,0,0,23,1,BW
2020-05-11,1,0,24,1,BW
2020-05-12,0,0,24,1,BW
2020-05-13,0,0,24,1,BW
2020-05-14,0,0,24,1,BW
2020-05-15,0,0,24,1,BW
2020-05-16,0,0,24,1,BW
2020-05-17,1,0,25,1,BW
2020-05-18,0,0,25,1,BW
2020-05-19,0,0,25,1,BW
2020-05-20,4,0,29,1,BW
2020-05-21,0,0,29,1,BW
2020-05-22,1,0,30,1,BW
2020-05-23,0,0,30,1,BW
2020-05-24,5,0,35,1,BW
2020-05-25,0,0,35,1,BW
2020-05-26,0,0,35,1,BW
2020-05-27,0,0,35,1,BW
2020-05-28,0,0,35,1,BW
2020-05-29,0,0,35,1,BW
2020-05-30,0,0,35,1,BW
2020-05-31,3,0,38,1,BW
2020-06-01,0,0,38,1,BW
2020-06-02,0,0,38,1,BW
2020-06-03,2,0,40,1,BW
2020-06-04,0,0,40,1,BW
2020-06-05,0,0,40,1,BW
2020-06-06,0,0,40,1,BW
2020-06-07,0,0,40,1,BW
2020-06-08,2,0,42,1,BW
2020-06-09,0,0,42,1,BW
2020-06-10,6,0,48,1,BW
2020-06-11,0,0,48,1,BW
2020-06-12,12,0,60,1,BW
2020-06-13,0,0,60,1,BW
2020-06-14,0,0,60,1,BW
2020-06-15,0,0,60,1,BW
2020-06-16,0,0,60,1,BW
2020-06-17,0,0,60,1,BW
2020-06-18,19,0,79,1,BW
2020-06-19,10,0,89,1,BW
2020-06-20,0,0,89,1,BW
2020-06-21,0,0,89,1,BW
2020-06-22,0,0,89,1,BW
2020-06-23,0,0,89,1,BW
2020-06-24,0,0,89,1,BW
2020-06-25,0,0,89,1,BW
2020-06-26,36,0,125,1,BW
2019-12-30,0,0,0,0,BY
2019-12-31,0,0,0,0,BY
2020-01-01,0,0,0,0,BY
2020-01-02,0,0,0,0,BY
2020-01-03,0,0,0,0,BY
2020-01-04,0,0,0,0,BY
2020-01-05,0,0,0,0,BY
2020-01-06,0,0,0,0,BY
2020-01-07,0,0,0,0,BY
2020-01-08,0,0,0,0,BY
2020-01-09,0,0,0,0,BY
2020-01-10,0,0,0,0,BY
2020-01-11,0,0,0,0,BY
2020-01-12,0,0,0,0,BY
2020-01-13,0,0,0,0,BY
2020-01-14,0,0,0,0,BY
2020-01-15,0,0,0,0,BY
2020-01-16,0,0,0,0,BY
2020-01-17,0,0,0,0,BY
2020-01-18,0,0,0,0,BY
2020-01-19,0,0,0,0,BY
2020-01-20,0,0,0,0,BY
2020-01-21,0,0,0,0,BY
2020-01-22,0,0,0,0,BY
2020-01-23,0,0,0,0,BY
2020-01-24,0,0,0,0,BY
2020-01-25,0,0,0,0,BY
2020-01-26,0,0,0,0,BY
2020-01-27,0,0,0,0,BY
2020-01-28,0,0,0,0,BY
2020-01-29,0,0,0,0,BY
2020-01-30,0,0,0,0,BY
2020-01-31,0,0,0,0,BY
2020-02-01,0,0,0,0,BY
2020-02-02,0,0,0,0,BY
2020-02-03,0,0,0,0,BY
2020-02-04,0,0,0,0,BY
2020-02-05,0,0,0,0,BY
2020-02-06,0,0,0,0,BY
2020-02-07,0,0,0,0,BY
2020-02-08,0,0,0,0,BY
2020-02-09,0,0,0,0,BY
2020-02-10,0,0,0,0,BY
2020-02-11,0,0,0,0,BY
2020-02-12,0,0,0,0,BY
2020-02-13,0,0,0,0,BY
2020-02-14,0,0,0,0,BY
2020-02-15,0,0,0,0,BY
2020-02-16,0,0,0,0,BY
2020-02-17,0,0,0,0,BY
2020-02-18,0,0,0,0,BY
2020-02-19,0,0,0,0,BY
2020-02-20,0,0,0,0,BY
2020-02-21,0,0,0,0,BY
2020-02-22,0,0,0,0,BY
2020-02-23,0,0,0,0,BY
2020-02-24,0,0,0,0,BY
2020-02-25,0,0,0,0,BY
2020-02-26,0,0,0,0,BY
2020-02-27,1,0,1,0,BY
2020-02-28,0,0,1,0,BY
2020-02-29,0,0,1,0,BY
2020-03-01,0,0,1,0,BY
2020-03-03,3,0,4,0,BY
2020-03-04,2,0,6,0,BY
2020-03-10,3,0,9,0,BY
2020-03-11,3,0,12,0,BY
2020-03-12,9,0,21,0,BY
2020-03-15,6,0,27,0,BY
2020-03-16,9,0,36,0,BY
2020-03-17,0,0,36,0,BY
2020-03-18,10,0,46,0,BY
2020-03-19,11,0,57,0,BY
2020-03-20,0,0,57,0,BY
2020-03-21,19,0,76,0,BY
2020-03-22,0,0,76,0,BY
2020-03-23,5,0,81,0,BY
2020-03-24,0,0,81,0,BY
2020-03-25,5,0,86,0,BY
2020-03-26,0,0,86,0,BY
2020-03-27,8,0,94,0,BY
2020-03-28,0,0,94,0,BY
2020-03-29,0,0,94,0,BY
2020-03-30,11,0,105,0,BY
2020-03-31,47,0,152,0,BY
2020-04-01,0,0,152,0,BY
2020-04-02,102,4,254,4,BY
2020-04-03,97,0,351,4,BY
2020-04-04,43,1,394,5,BY
2020-04-05,170,3,564,8,BY
2020-04-06,136,5,700,13,BY
2020-04-07,161,0,861,13,BY
2020-04-08,205,0,1066,13,BY
2020-04-09,420,3,1486,16,BY
2020-04-10,495,3,1981,19,BY
2020-04-11,245,4,2226,23,BY
2020-04-12,352,3,2578,26,BY
2020-04-13,341,3,2919,29,BY
2020-04-14,362,4,3281,33,BY
2020-04-15,447,3,3728,36,BY
2020-04-16,476,4,4204,40,BY
2020-04-17,575,2,4779,42,BY
2020-04-18,0,3,4779,45,BY
2020-04-19,0,2,4779,47,BY
2020-04-20,1485,4,6264,51,BY
2020-04-21,459,4,6723,55,BY
2020-04-22,558,3,7281,58,BY
2020-04-23,741,2,8022,60,BY
2020-04-24,751,3,8773,63,BY
2020-04-25,817,4,9590,67,BY
2020-04-26,873,5,10463,72,BY
2020-04-27,826,3,11289,75,BY
2020-04-28,919,4,12208,79,BY
2020-04-29,973,5,13181,84,BY
2020-04-30,846,5,14027,89,BY
2020-05-01,890,4,14917,93,BY
2020-05-02,911,4,15828,97,BY
2020-05-03,877,2,16705,99,BY
2020-05-04,784,4,17489,103,BY
2020-05-05,861,4,18350,107,BY
2020-05-06,905,5,19255,112,BY
2020-05-07,913,4,20168,116,BY
2020-05-08,933,5,21101,121,BY
2020-05-09,951,5,22052,126,BY
2020-05-10,921,5,22973,131,BY
2020-05-11,933,4,23906,135,BY
2020-05-12,967,7,24873,142,BY
2020-05-13,952,4,25825,146,BY
2020-05-14,947,5,26772,151,BY
2020-05-15,958,5,27730,156,BY
2020-05-16,951,4,28681,160,BY
2020-05-17,969,5,29650,165,BY
2020-05-18,922,6,30572,171,BY
2020-05-19,936,4,31508,175,BY
2020-05-20,918,4,32426,179,BY
2020-05-21,945,6,33371,185,BY
2020-05-22,932,5,34303,190,BY
2020-05-23,941,4,35244,194,BY
2020-05-24,954,5,36198,199,BY
2020-05-25,946,5,37144,204,BY
2020-05-26,915,4,38059,208,BY
2020-05-27,897,6,38956,214,BY
2020-05-28,902,5,39858,219,BY
2020-05-29,906,5,40764,224,BY
2020-05-30,894,5,41658,229,BY
2020-05-31,898,6,42556,235,BY
2020-06-01,847,5,43403,240,BY
2020-06-02,852,3,44255,243,BY
2020-06-03,861,5,45116,248,BY
2020-06-04,865,5,45981,253,BY
2020-06-05,887,6,46868,259,BY
2020-06-06,883,4,47751,263,BY
2020-06-07,879,6,48630,269,BY
2020-06-08,823,7,49453,276,BY
2020-06-09,812,6,50265,282,BY
2020-06-10,801,6,51066,288,BY
2020-06-11,750,5,51816,293,BY
2020-06-12,704,5,52520,298,BY
2020-06-13,721,5,53241,303,BY
2020-06-14,732,5,53973,308,BY
2020-06-15,707,4,54680,312,BY
2020-06-16,689,6,55369,318,BY
2020-06-17,663,6,56032,324,BY
2020-06-18,625,7,56657,331,BY
2020-06-19,676,2,57333,333,BY
2020-06-20,603,10,57936,343,BY
2020-06-21,569,3,58505,346,BY
2020-06-22,518,5,59023,351,BY
2020-06-23,464,6,59487,357,BY
2020-06-24,458,5,59945,362,BY
2020-06-25,437,5,60382,367,BY
2020-06-26,331,6,60713,373,BY
2020-03-23,1,0,1,0,BZ
2020-03-24,0,0,1,0,BZ
2020-03-25,1,0,2,0,BZ
2020-03-26,0,0,2,0,BZ
2020-03-27,0,0,2,0,BZ
2020-03-28,0,0,2,0,BZ
2020-03-29,0,0,2,0,BZ
2020-03-30,1,0,3,0,BZ
2020-03-31,0,0,3,0,BZ
2020-04-01,0,0,3,0,BZ
2020-04-02,0,0,3,0,BZ
2020-04-03,1,0,4,0,BZ
2020-04-04,0,0,4,0,BZ
2020-04-05,1,1,5,1,BZ
2020-04-06,2,0,7,1,BZ
2020-04-07,0,0,7,1,BZ
2020-04-08,1,0,8,1,BZ
2020-04-09,1,0,9,1,BZ
2020-04-10,1,1,10,2,BZ
2020-04-11,3,0,13,2,BZ
2020-04-12,1,0,14,2,BZ
2020-04-13,4,0,18,2,BZ
2020-04-14,0,0,18,2,BZ
2020-04-15,0,0,18,2,BZ
2020-04-16,0,0,18,2,BZ
2020-04-17,0,0,18,2,BZ
2020-04-18,0,0,18,2,BZ
2020-04-19,0,0,18,2,BZ
2020-04-20,0,0,18,2,BZ
2020-04-21,0,0,18,2,BZ
2020-04-22,0,0,18,2,BZ
2020-04-23,0,0,18,2,BZ
2020-04-24,0,0,18,2,BZ
2020-04-25,0,0,18,2,BZ
2020-04-26,0,0,18,2,BZ
2020-04-27,0,0,18,2,BZ
2020-04-28,0,0,18,2,BZ
2020-04-29,0,0,18,2,BZ
2020-04-30,0,0,18,2,BZ
2020-05-01,0,0,18,2,BZ
2020-05-02,0,0,18,2,BZ
2020-05-03,0,0,18,2,BZ
2020-05-04,0,0,18,2,BZ
2020-05-05,0,0,18,2,BZ
2020-05-06,0,0,18,2,BZ
2020-05-07,0,0,18,2,BZ
2020-05-08,0,0,18,2,BZ
2020-05-09,0,0,18,2,BZ
2020-05-10,0,0,18,2,BZ
2020-05-11,0,0,18,2,BZ
2020-05-12,0,0,18,2,BZ
2020-05-13,0,0,18,2,BZ
2020-05-14,0,0,18,2,BZ
2020-05-15,0,0,18,2,BZ
2020-05-16,0,0,18,2,BZ
2020-05-17,0,0,18,2,BZ
2020-05-18,0,0,18,2,BZ
2020-05-19,0,0,18,2,BZ
2020-05-20,0,0,18,2,BZ
2020-05-21,0,0,18,2,BZ
2020-05-22,0,0,18,2,BZ
2020-05-23,0,0,18,2,BZ
2020-05-24,0,0,18,2,BZ
2020-05-25,0,0,18,2,BZ
2020-05-26,0,0,18,2,BZ
2020-05-27,0,0,18,2,BZ
2020-05-28,0,0,18,2,BZ
2020-05-29,0,0,18,2,BZ
2020-05-30,0,0,18,2,BZ
2020-05-31,0,0,18,2,BZ
2020-06-01,0,0,18,2,BZ
2020-06-02,0,0,18,2,BZ
2020-06-03,0,0,18,2,BZ
2020-06-04,0,0,18,2,BZ
2020-06-05,0,0,18,2,BZ
2020-06-06,0,0,18,2,BZ
2020-06-07,0,0,18,2,BZ
2020-06-08,1,0,19,2,BZ
2020-06-09,1,0,20,2,BZ
2020-06-10,0,0,20,2,BZ
2020-06-11,0,0,20,2,BZ
2020-06-12,0,0,20,2,BZ
2020-06-13,0,0,20,2,BZ
2020-06-14,1,0,21,2,BZ
2020-06-15,0,0,21,2,BZ
2020-06-16,0,0,21,2,BZ
2020-06-17,1,0,22,2,BZ
2020-06-18,0,0,22,2,BZ
2020-06-19,0,0,22,2,BZ
2020-06-20,0,0,22,2,BZ
2020-06-21,0,0,22,2,BZ
2020-06-22,1,0,23,2,BZ
2020-06-23,0,0,23,2,BZ
2020-06-24,0,0,23,2,BZ
2020-06-25,0,0,23,2,BZ
2020-06-26,1,0,24,2,BZ
2019-12-30,0,0,0,0,CA
2019-12-31,0,0,0,0,CA
2020-01-01,0,0,0,0,CA
2020-01-02,0,0,0,0,CA
2020-01-03,0,0,0,0,CA
2020-01-04,0,0,0,0,CA
2020-01-05,0,0,0,0,CA
2020-01-06,0,0,0,0,CA
2020-01-07,0,0,0,0,CA
2020-01-08,0,0,0,0,CA
2020-01-09,0,0,0,0,CA
2020-01-10,0,0,0,0,CA
2020-01-11,0,0,0,0,CA
2020-01-12,0,0,0,0,CA
2020-01-13,0,0,0,0,CA
2020-01-14,0,0,0,0,CA
2020-01-15,0,0,0,0,CA
2020-01-16,0,0,0,0,CA
2020-01-17,0,0,0,0,CA
2020-01-18,0,0,0,0,CA
2020-01-19,0,0,0,0,CA
2020-01-20,0,0,0,0,CA
2020-01-21,0,0,0,0,CA
2020-01-22,0,0,0,0,CA
2020-01-23,0,0,0,0,CA
2020-01-24,0,0,0,0,CA
2020-01-25,1,0,1,0,CA
2020-01-26,0,0,1,0,CA
2020-01-27,1,0,2,0,CA
2020-01-28,1,0,3,0,CA
2020-01-29,0,0,3,0,CA
2020-01-30,0,0,3,0,CA
2020-01-31,1,0,4,0,CA
2020-02-01,0,0,4,0,CA
2020-02-02,0,0,4,0,CA
2020-02-03,0,0,4,0,CA
2020-02-04,1,0,5,0,CA
2020-02-05,0,0,5,0,CA
2020-02-06,2,0,7,0,CA
2020-02-07,0,0,7,0,CA
2020-02-08,0,0,7,0,CA
2020-02-09,0,0,7,0,CA
2020-02-10,0,0,7,0,CA
2020-02-11,0,0,7,0,CA
2020-02-12,0,0,7,0,CA
2020-02-13,0,0,7,0,CA
2020-02-14,1,0,8,0,CA
2020-02-15,0,0,8,0,CA
2020-02-16,0,0,8,0,CA
2020-02-17,0,0,8,0,CA
2020-02-18,0,0,8,0,CA
2020-02-19,0,0,8,0,CA
2020-02-20,1,0,9,0,CA
2020-02-21,0,0,9,0,CA
2020-02-22,0,0,9,0,CA
2020-02-23,0,0,9,0,CA
2020-02-24,2,0,11,0,CA
2020-02-25,0,0,11,0,CA
2020-02-26,1,0,12,0,CA
2020-02-27,2,0,14,0,CA
2020-02-28,2,0,16,0,CA
2020-02-29,4,0,20,0,CA
2020-03-01,4,0,24,0,CA
2020-03-02,3,0,27,0,CA
2020-03-03,3,0,30,0,CA
2020-03-04,3,0,33,0,CA
2020-03-05,12,0,45,0,CA
2020-03-06,6,0,51,0,CA
2020-03-07,6,0,57,0,CA
2020-03-08,5,0,62,0,CA
2020-03-09,15,1,77,1,CA
2020-03-10,16,0,93,1,CA
2020-03-11,10,0,103,1,CA
2020-03-12,35,0,138,1,CA
2020-03-13,38,0,176,1,CA
2020-03-14,68,0,244,1,CA
2020-03-15,60,0,304,1,CA
2020-03-16,120,3,424,4,CA
2020-03-17,145,4,569,8,CA
2020-03-18,121,1,690,9,CA
2020-03-19,156,1,846,10,CA
2020-03-20,125,2,971,12,CA
2020-03-21,331,6,1302,18,CA
2020-03-22,128,2,1430,20,CA
2020-03-23,216,4,1646,24,CA
2020-03-24,313,3,1959,27,CA
2020-03-25,1426,8,3385,35,CA
2020-03-26,633,4,4018,39,CA
2020-03-27,657,14,4675,53,CA
2020-03-28,711,7,5386,60,CA
2020-03-29,869,1,6255,61,CA
2020-03-30,1169,28,7424,89,CA
2020-03-31,1112,7,8536,96,CA
2020-04-01,1059,13,9595,109,CA
2020-04-02,1673,29,11268,138,CA
2020-04-03,1251,49,12519,187,CA
2020-04-04,1363,44,13882,231,CA
2020-04-05,1614,49,15496,280,CA
2020-04-06,1157,43,16653,323,CA
2020-04-07,1230,57,17883,380,CA
2020-04-08,1391,55,19274,435,CA
2020-04-09,1474,74,20748,509,CA
2020-04-10,1385,60,22133,569,CA
2020-04-11,1168,84,23301,653,CA
2020-04-12,1064,64,24365,717,CA
2020-04-13,1298,63,25663,780,CA
2020-04-14,1383,123,27046,903,CA
2020-04-15,1318,107,28364,1010,CA
2020-04-16,1717,183,30081,1193,CA
2020-04-17,1791,116,31872,1309,CA
2020-04-18,1469,158,33341,1467,CA
2020-04-19,1436,113,34777,1580,CA
2020-04-20,2046,110,36823,1690,CA
2020-04-21,1590,144,38413,1834,CA
2020-04-22,1766,140,40179,1974,CA
2020-04-23,1920,172,42099,2146,CA
2020-04-24,1778,156,43877,2302,CA
2020-04-25,1464,163,45341,2465,CA
2020-04-26,1543,95,46884,2560,CA
2020-04-27,1605,147,48489,2707,CA
2020-04-28,1526,152,50015,2859,CA
2020-04-29,1572,137,51587,2996,CA
2020-04-30,1649,188,53236,3184,CA
2020-05-01,1825,207,55061,3391,CA
2020-05-02,1653,175,56714,3566,CA
2020-05-03,2760,116,59474,3682,CA
2020-05-04,1298,172,60772,3854,CA
2020-05-05,1274,189,62046,4043,CA
2020-05-06,1450,189,63496,4232,CA
2020-05-07,1426,176,64922,4408,CA
2020-05-08,1512,161,66434,4569,CA
2020-05-09,1268,124,67702,4693,CA
2020-05-10,1146,178,68848,4871,CA
2020-05-11,1133,122,69981,4993,CA
2020-05-12,1176,176,71157,5169,CA
2020-05-13,1121,135,72278,5304,CA
2020-05-14,1123,168,73401,5472,CA
2020-05-15,1201,90,74602,5562,CA
2020-05-16,1251,117,75853,5679,CA
2020-05-17,1138,103,76991,5782,CA
2020-05-18,1070,60,78061,5842,CA
2020-05-19,1040,70,79101,5912,CA
2020-05-20,990,118,80091,6030,CA
2020-05-21,1222,122,81313,6152,CA
2020-05-22,1156,98,82469,6250,CA
2020-05-23,1141,105,83610,6355,CA
2020-05-24,1078,69,84688,6424,CA
2020-05-25,1012,121,85700,6545,CA
2020-05-26,936,94,86636,6639,CA
2020-05-27,872,126,87508,6765,CA
2020-05-28,993,112,88501,6877,CA
2020-05-29,906,102,89407,6979,CA
2020-05-30,772,94,90179,7073,CA
2020-05-31,757,222,90936,7295,CA
2020-06-01,758,31,91694,7326,CA
2020-06-02,705,69,92399,7395,CA
2020-06-03,675,103,93074,7498,CA
2020-06-04,641,139,93715,7637,CA
2020-06-05,609,66,94324,7703,CA
2020-06-06,722,70,95046,7773,CA
2020-06-07,642,27,95688,7800,CA
2020-06-08,545,35,96233,7835,CA
2020-06-09,409,62,96642,7897,CA
2020-06-10,472,63,97114,7960,CA
2020-06-11,405,34,97519,7994,CA
2020-06-12,413,55,97932,8049,CA
2020-06-13,467,58,98399,8107,CA
2020-06-14,377,39,98776,8146,CA
2020-06-15,360,29,99136,8175,CA
2020-06-16,320,38,99456,8213,CA
2020-06-17,386,41,99842,8254,CA
2020-06-18,367,46,100209,8300,CA
2020-06-19,409,46,100618,8346,CA
2020-06-20,390,64,101008,8410,CA
2020-06-21,318,20,101326,8430,CA
2020-06-22,311,6,101637,8436,CA
2020-06-23,326,18,101963,8454,CA
2020-06-24,279,30,102242,8484,CA
2020-06-25,369,20,102611,8504,CA
2020-06-26,172,4,102783,8508,CA
2020-03-10,1,0,1,0,CD
2020-03-13,1,0,2,0,CD
2020-03-14,0,0,2,0,CD
2020-03-15,0,0,2,0,CD
2020-03-16,1,0,3,0,CD
2020-03-17,0,0,3,0,CD
2020-03-18,11,0,14,0,CD
2020-03-19,0,0,14,0,CD
2020-03-20,0,0,14,0,CD
2020-03-21,9,1,23,1,CD
2020-03-22,3,1,26,2,CD
2020-03-23,0,0,26,2,CD
2020-03-24,19,1,45,3,CD
2020-03-25,0,0,45,3,CD
2020-03-26,9,1,54,4,CD
2020-03-27,4,0,58,4,CD
2020-03-28,0,2,58,6,CD
2020-03-29,23,2,81,8,CD
2020-03-30,17,0,98,8,CD
2020-03-31,0,0,98,8,CD
2020-04-01,25,3,123,11,CD
2020-04-02,0,0,123,11,CD
2020-04-03,11,2,134,13,CD
2020-04-04,20,5,154,18,CD
2020-04-05,0,0,154,18,CD
2020-04-06,7,0,161,18,CD
2020-04-07,19,0,180,18,CD
2020-04-08,3,2,183,20,CD
2020-04-09,32,0,215,20,CD
2020-04-10,8,0,223,20,CD
2020-04-11,11,0,234,20,CD
2020-04-12,0,0,234,20,CD
2020-04-13,1,0,235,20,CD
2020-04-14,19,1,254,21,CD
2020-04-15,13,1,267,22,CD
2020-04-16,20,1,287,23,CD
2020-04-17,20,2,307,25,CD
2020-04-18,20,0,327,25,CD
2020-04-19,5,0,332,25,CD
2020-04-20,18,0,350,25,CD
2020-04-21,9,0,359,25,CD
2020-04-22,18,0,377,25,CD
2020-04-23,17,0,394,25,CD
2020-04-24,22,3,416,28,CD
2020-04-25,26,0,442,28,CD
2020-04-26,17,0,459,28,CD
2020-04-27,12,2,471,30,CD
2020-04-28,20,0,491,30,CD
2020-04-29,9,1,500,31,CD
2020-04-30,72,0,572,31,CD
2020-05-01,32,1,604,32,CD
2020-05-02,70,1,674,33,CD
2020-05-03,10,1,684,34,CD
2020-05-04,0,0,684,34,CD
2020-05-05,21,0,705,34,CD
2020-05-06,158,2,863,36,CD
2020-05-07,34,0,897,36,CD
2020-05-08,40,3,937,39,CD
2020-05-09,54,2,991,41,CD
2020-05-10,33,0,1024,41,CD
2020-05-11,78,3,1102,44,CD
2020-05-12,67,6,1169,50,CD
2020-05-13,73,0,1242,50,CD
2020-05-14,56,0,1298,50,CD
2020-05-15,71,10,1369,60,CD
2020-05-16,85,0,1454,60,CD
2020-05-17,0,0,1454,60,CD
2020-05-18,175,1,1629,61,CD
2020-05-19,102,0,1731,61,CD
2020-05-20,104,0,1835,61,CD
2020-05-21,110,2,1945,63,CD
2020-05-22,80,0,2025,63,CD
2020-05-23,116,0,2141,63,CD
2020-05-24,156,4,2297,67,CD
2020-05-25,0,0,2297,67,CD
2020-05-26,248,0,2545,67,CD
2020-05-27,114,1,2659,68,CD
2020-05-28,173,1,2832,69,CD
2020-05-29,1,0,2833,69,CD
2020-05-30,133,0,2966,69,CD
2020-05-31,83,2,3049,71,CD
2020-06-01,145,1,3194,72,CD
2020-06-02,131,0,3325,72,CD
2020-06-03,169,3,3494,75,CD
2020-06-04,149,3,3643,78,CD
2020-06-05,121,3,3764,81,CD
2020-06-06,114,0,3878,81,CD
2020-06-07,138,4,4016,85,CD
2020-06-08,89,2,4105,87,CD
2020-06-09,153,2,4258,89,CD
2020-06-10,131,6,4389,95,CD
2020-06-11,125,2,4514,97,CD
2020-06-12,122,3,4636,100,CD
2020-06-13,87,5,4723,105,CD
2020-06-14,54,1,4777,106,CD
2020-06-15,60,6,4837,112,CD
2020-06-16,137,0,4974,112,CD
2020-06-17,125,3,5099,115,CD
2020-06-18,183,2,5282,117,CD
2020-06-19,194,4,5476,121,CD
2020-06-20,195,3,5671,124,CD
2020-06-21,155,6,5826,130,CD
2020-06-22,99,5,5925,135,CD
2020-06-23,102,0,6027,135,CD
2020-06-24,0,0,6027,135,CD
2020-06-25,384,7,6411,142,CD
2020-06-26,141,7,6552,149,CD
2020-03-15,1,0,1,0,CF
2020-03-16,0,0,1,0,CF
2020-03-17,0,0,1,0,CF
2020-03-18,0,0,1,0,CF
2020-03-19,0,0,1,0,CF
2020-03-20,0,0,1,0,CF
2020-03-21,2,0,3,0,CF
2020-03-22,1,0,4,0,CF
2020-03-23,0,0,4,0,CF
2020-03-24,0,0,4,0,CF
2020-03-25,0,0,4,0,CF
2020-03-26,1,0,5,0,CF
2020-03-27,0,0,5,0,CF
2020-03-28,1,0,6,0,CF
2020-03-29,0,0,6,0,CF
2020-03-30,0,0,6,0,CF
2020-03-31,0,0,6,0,CF
2020-04-01,2,0,8,0,CF
2020-04-02,0,0,8,0,CF
2020-04-03,0,0,8,0,CF
2020-04-04,1,0,9,0,CF
2020-04-05,0,0,9,0,CF
2020-04-06,0,0,9,0,CF
2020-04-07,0,0,9,0,CF
2020-04-08,1,0,10,0,CF
2020-04-09,1,0,11,0,CF
2020-04-10,0,0,11,0,CF
2020-04-11,0,0,11,0,CF
2020-04-12,0,0,11,0,CF
2020-04-13,0,0,11,0,CF
2020-04-14,0,0,11,0,CF
2020-04-15,0,0,11,0,CF
2020-04-16,1,0,12,0,CF
2020-04-17,0,0,12,0,CF
2020-04-18,0,0,12,0,CF
2020-04-19,0,0,12,0,CF
2020-04-20,0,0,12,0,CF
2020-04-21,2,0,14,0,CF
2020-04-22,2,0,16,0,CF
2020-04-23,1,0,17,0,CF
2020-04-24,2,0,19,0,CF
2020-04-25,0,0,19,0,CF
2020-04-26,0,0,19,0,CF
2020-04-27,31,0,50,0,CF
2020-04-28,0,0,50,0,CF
2020-04-29,0,0,50,0,CF
2020-04-30,0,0,50,0,CF
2020-05-01,22,0,72,0,CF
2020-05-02,0,0,72,0,CF
2020-05-03,0,0,72,0,CF
2020-05-04,22,0,94,0,CF
2020-05-05,0,0,94,0,CF
2020-05-06,0,0,94,0,CF
2020-05-07,0,0,94,0,CF
2020-05-08,49,0,143,0,CF
2020-05-09,0,0,143,0,CF
2020-05-10,36,0,179,0,CF
2020-05-11,0,0,179,0,CF
2020-05-12,0,0,179,0,CF
2020-05-13,18,0,197,0,CF
2020-05-14,24,0,221,0,CF
2020-05-15,80,0,301,0,CF
2020-05-16,26,0,327,0,CF
2020-05-17,0,0,327,0,CF
2020-05-18,9,0,336,0,CF
2020-05-19,75,0,411,0,CF
2020-05-20,0,0,411,0,CF
2020-05-21,25,0,436,0,CF
2020-05-22,43,0,479,0,CF
2020-05-23,73,1,552,1,CF
2020-05-24,52,0,604,1,CF
2020-05-25,48,0,652,1,CF
2020-05-26,19,0,671,1,CF
2020-05-27,31,0,702,1,CF
2020-05-28,53,0,755,1,CF
2020-05-29,119,0,874,1,CF
2020-05-30,88,0,962,1,CF
2020-05-31,49,1,1011,2,CF
2020-06-01,58,2,1069,4,CF
2020-06-02,104,0,1173,4,CF
2020-06-03,16,0,1189,4,CF
2020-06-04,99,0,1288,4,CF
2020-06-05,163,0,1451,4,CF
2020-06-06,119,1,1570,5,CF
2020-06-07,64,0,1634,5,CF
2020-06-08,216,0,1850,5,CF
2020-06-09,38,0,1888,5,CF
2020-06-10,64,1,1952,6,CF
2020-06-11,92,1,2044,7,CF
2020-06-12,13,0,2057,7,CF
2020-06-13,0,0,2057,7,CF
2020-06-14,165,0,2222,7,CF
2020-06-15,67,3,2289,10,CF
2020-06-16,121,4,2410,14,CF
2020-06-17,154,4,2564,18,CF
2020-06-18,41,1,2605,19,CF
2020-06-19,0,0,2605,19,CF
2020-06-20,203,4,2808,23,CF
2020-06-21,0,0,2808,23,CF
2020-06-22,155,7,2963,30,CF
2020-06-23,88,7,3051,37,CF
2020-06-24,48,1,3099,38,CF
2020-06-25,145,2,3244,40,CF
2020-06-26,96,0,3340,40,CF
2020-03-15,1,0,1,0,CG
2020-03-16,0,0,1,0,CG
2020-03-17,0,0,1,0,CG
2020-03-18,2,0,3,0,CG
2020-03-19,0,0,3,0,CG
2020-03-20,0,0,3,0,CG
2020-03-21,1,0,4,0,CG
2020-03-22,0,0,4,0,CG
2020-03-23,0,0,4,0,CG
2020-03-24,0,0,4,0,CG
2020-03-25,0,0,4,0,CG
2020-03-26,0,0,4,0,CG
2020-03-27,0,0,4,0,CG
2020-03-28,15,0,19,0,CG
2020-03-29,0,0,19,0,CG
2020-03-30,0,0,19,0,CG
2020-03-31,3,2,22,2,CG
2020-04-01,0,0,22,2,CG
2020-04-02,19,1,41,3,CG
2020-04-03,0,0,41,3,CG
2020-04-04,4,2,45,5,CG
2020-04-05,0,0,45,5,CG
2020-04-06,0,0,45,5,CG
2020-04-07,0,0,45,5,CG
2020-04-08,15,0,60,5,CG
2020-04-09,0,0,60,5,CG
2020-04-10,0,0,60,5,CG
2020-04-11,0,0,60,5,CG
2020-04-12,10,0,70,5,CG
2020-04-13,0,0,70,5,CG
2020-04-14,4,0,74,5,CG
2020-04-15,43,0,117,5,CG
2020-04-16,0,0,117,5,CG
2020-04-17,26,1,143,6,CG
2020-04-18,0,0,143,6,CG
2020-04-19,17,0,160,6,CG
2020-04-20,0,0,160,6,CG
2020-04-21,5,0,165,6,CG
2020-04-22,21,0,186,6,CG
2020-04-23,0,0,186,6,CG
2020-04-24,14,0,200,6,CG
2020-04-25,0,2,200,8,CG
2020-04-26,0,0,200,8,CG
2020-04-27,7,0,207,8,CG
2020-04-28,0,0,207,8,CG
2020-04-29,13,1,220,9,CG
2020-04-30,0,0,220,9,CG
2020-05-01,9,1,229,10,CG
2020-05-02,0,0,229,10,CG
2020-05-03,0,0,229,10,CG
2020-05-04,7,0,236,10,CG
2020-05-05,0,0,236,10,CG
2020-05-06,28,0,264,10,CG
2020-05-07,10,0,274,10,CG
2020-05-08,13,0,287,10,CG
2020-05-09,0,0,287,10,CG
2020-05-10,0,0,287,10,CG
2020-05-11,46,1,333,11,CG
2020-05-12,0,0,333,11,CG
2020-05-13,8,0,341,11,CG
2020-05-14,50,4,391,15,CG
2020-05-15,0,0,391,15,CG
2020-05-16,21,0,412,15,CG
2020-05-17,0,0,412,15,CG
2020-05-18,0,0,412,15,CG
2020-05-19,8,0,420,15,CG
2020-05-20,0,0,420,15,CG
2020-05-21,49,1,469,16,CG
2020-05-22,0,0,469,16,CG
2020-05-23,18,0,487,16,CG
2020-05-24,0,0,487,16,CG
2020-05-25,44,1,531,17,CG
2020-05-26,38,2,569,19,CG
2020-05-27,2,0,571,19,CG
2020-05-28,0,0,571,19,CG
2020-05-29,16,0,587,19,CG
2020-05-30,0,0,587,19,CG
2020-05-31,24,1,611,20,CG
2020-06-01,0,0,611,20,CG
2020-06-02,0,0,611,20,CG
2020-06-03,7,0,618,20,CG
2020-06-04,17,0,635,20,CG
2020-06-05,4,0,639,20,CG
2020-06-06,44,2,683,22,CG
2020-06-07,0,0,683,22,CG
2020-06-08,0,0,683,22,CG
2020-06-09,45,2,728,24,CG
2020-06-10,17,1,745,25,CG
2020-06-11,0,0,745,25,CG
2020-06-12,0,0,745,25,CG
2020-06-13,34,0,779,25,CG
2020-06-14,0,0,779,25,CG
2020-06-15,104,2,883,27,CG
2020-06-16,0,0,883,27,CG
2020-06-17,0,0,883,27,CG
2020-06-18,0,0,883,27,CG
2020-06-19,0,0,883,27,CG
2020-06-20,130,1,1013,28,CG
2020-06-21,0,0,1013,28,CG
2020-06-22,74,9,1087,37,CG
2020-06-23,0,0,1087,37,CG
2020-06-24,0,0,1087,37,CG
2020-06-25,117,1,1204,38,CG
2020-06-26,0,0,1204,38,CG
2019-12-30,0,0,0,0,CH
2019-12-31,0,0,0,0,CH
2020-01-01,0,0,0,0,CH
2020-01-02,0,0,0,0,CH
2020-01-03,0,0,0,0,CH
2020-01-04,0,0,0,0,CH
2020-01-05,0,0,0,0,CH
2020-01-06,0,0,0,0,CH
2020-01-07,0,0,0,0,CH
2020-01-08,0,0,0,0,CH
2020-01-09,0,0,0,0,CH
2020-01-10,0,0,0,0,CH
2020-01-11,0,0,0,0,CH
2020-01-12,0,0,0,0,CH
2020-01-13,0,0,0,0,CH
2020-01-14,0,0,0,0,CH
2020-01-15,0,0,0,0,CH
2020-01-16,0,0,0,0,CH
2020-01-17,0,0,0,0,CH
2020-01-18,0,0,0,0,CH
2020-01-19,0,0,0,0,CH
2020-01-20,0,0,0,0,CH
2020-01-21,0,0,0,0,CH
2020-01-22,0,0,0,0,CH
2020-01-23,0,0,0,0,CH
2020-01-24,0,0,0,0,CH
2020-01-25,0,0,0,0,CH
2020-01-26,0,0,0,0,CH
2020-01-27,0,0,0,0,CH
2020-01-28,0,0,0,0,CH
2020-01-29,0,0,0,0,CH
2020-01-30,0,0,0,0,CH
2020-01-31,0,0,0,0,CH
2020-02-01,0,0,0,0,CH
2020-02-02,0,0,0,0,CH
2020-02-03,0,0,0,0,CH
2020-02-04,0,0,0,0,CH
2020-02-05,0,0,0,0,CH
2020-02-06,0,0,0,0,CH
2020-02-07,0,0,0,0,CH
2020-02-08,0,0,0,0,CH
2020-02-09,0,0,0,0,CH
2020-02-10,0,0,0,0,CH
2020-02-11,0,0,0,0,CH
2020-02-12,0,0,0,0,CH
2020-02-13,0,0,0,0,CH
2020-02-14,0,0,0,0,CH
2020-02-15,0,0,0,0,CH
2020-02-16,0,0,0,0,CH
2020-02-17,0,0,0,0,CH
2020-02-18,0,0,0,0,CH
2020-02-19,0,0,0,0,CH
2020-02-20,0,0,0,0,CH
2020-02-21,0,0,0,0,CH
2020-02-22,0,0,0,0,CH
2020-02-23,0,0,0,0,CH
2020-02-24,0,0,0,0,CH
2020-02-25,1,0,1,0,CH
2020-02-26,0,0,1,0,CH
2020-02-27,7,0,8,0,CH
2020-02-28,4,0,12,0,CH
2020-02-29,6,0,18,0,CH
2020-03-01,6,0,24,0,CH
2020-03-02,6,0,30,0,CH
2020-03-03,7,0,37,0,CH
2020-03-04,20,0,57,0,CH
2020-03-05,30,1,87,1,CH
2020-03-06,122,0,209,1,CH
2020-03-07,55,0,264,1,CH
2020-03-08,68,1,332,2,CH
2020-03-09,42,0,374,2,CH
2020-03-10,116,1,490,3,CH
2020-03-11,152,1,642,4,CH
2020-03-12,212,0,854,4,CH
2020-03-13,267,3,1121,7,CH
2020-03-14,238,4,1359,11,CH
2020-03-15,841,2,2200,13,CH
2020-03-16,0,1,2200,14,CH
2020-03-17,450,5,2650,19,CH
2020-03-18,360,2,3010,21,CH
2020-03-19,878,12,3888,33,CH
2020-03-20,952,10,4840,43,CH
2020-03-21,1237,13,6077,56,CH
2020-03-22,894,4,6971,60,CH
2020-03-23,1044,6,8015,66,CH
2020-03-24,774,20,8789,86,CH
2020-03-25,925,17,9714,103,CH
2020-03-26,1000,58,10714,161,CH
2020-03-27,1390,36,12104,197,CH
2020-03-28,1048,38,13152,235,CH
2020-03-29,1122,22,14274,257,CH
2020-03-30,1138,38,15412,295,CH
2020-03-31,696,78,16108,373,CH
2020-04-01,962,5,17070,378,CH
2020-04-02,1124,54,18194,432,CH
2020-04-03,1033,52,19227,484,CH
2020-04-04,974,56,20201,540,CH
2020-04-05,821,19,21022,559,CH
2020-04-06,552,25,21574,584,CH
2020-04-07,590,57,22164,641,CH
2020-04-08,546,64,22710,705,CH
2020-04-09,785,51,23495,756,CH
2020-04-10,733,49,24228,805,CH
2020-04-11,592,26,24820,831,CH
2020-04-12,400,27,25220,858,CH
2020-04-13,279,0,25499,858,CH
2020-04-14,254,42,25753,900,CH
2020-04-15,583,73,26336,973,CH
2020-04-16,315,43,26651,1016,CH
2020-04-17,346,42,26997,1058,CH
2020-04-18,325,52,27322,1110,CH
2020-04-19,336,24,27658,1134,CH
2020-04-20,168,7,27826,1141,CH
2020-04-21,155,45,27981,1186,CH
2020-04-22,205,30,28186,1216,CH
2020-04-23,228,51,28414,1267,CH
2020-04-24,181,41,28595,1308,CH
2020-04-25,216,20,28811,1328,CH
2020-04-26,167,8,28978,1336,CH
2020-04-27,103,16,29081,1352,CH
2020-04-28,100,27,29181,1379,CH
2020-04-29,143,28,29324,1407,CH
2020-04-30,179,15,29503,1422,CH
2020-05-01,119,12,29622,1434,CH
2020-05-02,112,32,29734,1466,CH
2020-05-03,88,6,29822,1472,CH
2020-05-04,76,4,29898,1476,CH
2020-05-05,28,6,29926,1482,CH
2020-05-06,51,22,29977,1504,CH
2020-05-07,66,13,30043,1517,CH
2020-05-08,81,8,30124,1525,CH
2020-05-09,44,6,30168,1531,CH
2020-05-10,54,6,30222,1537,CH
2020-05-11,39,5,30261,1542,CH
2020-05-12,36,18,30297,1560,CH
2020-05-13,33,3,30330,1563,CH
2020-05-14,50,25,30380,1588,CH
2020-05-15,51,6,30431,1594,CH
2020-05-16,58,7,30489,1601,CH
2020-05-17,15,1,30504,1602,CH
2020-05-18,10,0,30514,1602,CH
2020-05-19,21,11,30535,1613,CH
2020-05-20,40,16,30575,1629,CH
2020-05-21,36,8,30611,1637,CH
2020-05-22,13,0,30624,1637,CH
2020-05-23,18,4,30642,1641,CH
2020-05-24,11,0,30653,1641,CH
2020-05-25,10,0,30663,1641,CH
2020-05-26,15,6,30678,1647,CH
2020-05-27,0,0,30678,1647,CH
2020-05-28,35,7,30713,1654,CH
2020-05-29,32,2,30745,1656,CH
2020-05-30,17,0,30762,1656,CH
2020-05-31,17,0,30779,1656,CH
2020-06-01,9,0,30788,1656,CH
2020-06-02,3,0,30791,1656,CH
2020-06-03,19,3,30810,1659,CH
2020-06-04,20,0,30830,1659,CH
2020-06-05,23,0,30853,1659,CH
2020-06-06,20,1,30873,1660,CH
2020-06-07,9,0,30882,1660,CH
2020-06-08,7,0,30889,1660,CH
2020-06-09,16,2,30905,1662,CH
2020-06-10,23,12,30928,1674,CH
2020-06-11,33,0,30961,1674,CH
2020-06-12,19,2,30980,1676,CH
2020-06-13,31,0,31011,1676,CH
2020-06-14,23,0,31034,1676,CH
2020-06-15,14,0,31048,1676,CH
2020-06-16,15,1,31063,1677,CH
2020-06-17,37,0,31100,1677,CH
2020-06-18,17,0,31117,1677,CH
2020-06-19,92,0,31209,1677,CH
2020-06-20,0,0,31209,1677,CH
2020-06-21,0,2,31209,1679,CH
2020-06-22,18,0,31227,1679,CH
2020-06-23,22,0,31249,1679,CH
2020-06-24,44,2,31293,1681,CH
2020-06-25,52,0,31345,1681,CH
2020-06-26,58,0,31403,1681,CH
2020-03-11,1,0,1,0,CI
2020-03-14,3,0,4,0,CI
2020-03-15,0,0,4,0,CI
2020-03-16,1,0,5,0,CI
2020-03-17,0,0,5,0,CI
2020-03-18,1,0,6,0,CI
2020-03-19,3,0,9,0,CI
2020-03-20,5,0,14,0,CI
2020-03-21,3,0,17,0,CI
2020-03-22,8,0,25,0,CI
2020-03-23,0,0,25,0,CI
2020-03-24,48,0,73,0,CI
2020-03-25,7,0,80,0,CI
2020-03-26,16,0,96,0,CI
2020-03-27,5,0,101,0,CI
2020-03-28,39,0,140,0,CI
2020-03-29,25,1,165,1,CI
2020-03-30,3,0,168,1,CI
2020-03-31,0,0,168,1,CI
2020-04-01,22,0,190,1,CI
2020-04-02,4,0,194,1,CI
2020-04-03,24,0,218,1,CI
2020-04-04,27,1,245,2,CI
2020-04-05,16,1,261,3,CI
2020-04-06,62,0,323,3,CI
2020-04-07,26,0,349,3,CI
2020-04-08,35,0,384,3,CI
2020-04-09,60,0,444,3,CI
2020-04-10,36,0,480,3,CI
2020-04-11,53,1,533,4,CI
2020-04-12,41,1,574,5,CI
2020-04-13,52,1,626,6,CI
2020-04-14,0,0,626,6,CI
2020-04-15,28,0,654,6,CI
2020-04-16,34,0,688,6,CI
2020-04-17,54,0,742,6,CI
2020-04-18,59,2,801,8,CI
2020-04-19,46,1,847,9,CI
2020-04-20,32,1,879,10,CI
2020-04-21,37,3,916,13,CI
2020-04-22,36,1,952,14,CI
2020-04-23,52,0,1004,14,CI
2020-04-24,73,0,1077,14,CI
2020-04-25,34,0,1111,14,CI
2020-04-26,39,0,1150,14,CI
2020-04-27,14,0,1164,14,CI
2020-04-28,19,0,1183,14,CI
2020-04-29,55,0,1238,14,CI
2020-04-30,37,0,1275,14,CI
2020-05-01,58,1,1333,15,CI
2020-05-02,29,0,1362,15,CI
2020-05-03,36,2,1398,17,CI
2020-05-04,34,0,1432,17,CI
2020-05-05,32,1,1464,18,CI
2020-05-06,52,0,1516,18,CI
2020-05-07,55,2,1571,20,CI
2020-05-08,31,0,1602,20,CI
2020-05-09,65,1,1667,21,CI
2020-05-10,33,0,1700,21,CI
2020-05-11,30,0,1730,21,CI
2020-05-12,127,0,1857,21,CI
2020-05-13,55,3,1912,24,CI
2020-05-14,59,0,1971,24,CI
2020-05-15,46,0,2017,24,CI
2020-05-16,44,1,2061,25,CI
2020-05-17,48,2,2109,27,CI
2020-05-18,10,1,2119,28,CI
2020-05-19,34,0,2153,28,CI
2020-05-20,78,1,2231,29,CI
2020-05-21,0,0,2231,29,CI
2020-05-22,70,0,2301,29,CI
2020-05-23,65,1,2366,30,CI
2020-05-24,10,0,2376,30,CI
2020-05-25,47,0,2423,30,CI
2020-05-26,54,0,2477,30,CI
2020-05-27,79,1,2556,31,CI
2020-05-28,85,1,2641,32,CI
2020-05-29,109,0,2750,32,CI
2020-05-30,49,1,2799,33,CI
2020-05-31,34,0,2833,33,CI
2020-06-01,118,0,2951,33,CI
2020-06-02,73,0,3024,33,CI
2020-06-03,0,0,3024,33,CI
2020-06-04,238,2,3262,35,CI
2020-06-05,169,1,3431,36,CI
2020-06-06,126,0,3557,36,CI
2020-06-07,182,0,3739,36,CI
2020-06-08,142,2,3881,38,CI
2020-06-09,114,0,3995,38,CI
2020-06-10,186,3,4181,41,CI
2020-06-11,223,0,4404,41,CI
2020-06-12,280,4,4684,45,CI
2020-06-13,164,0,4848,45,CI
2020-06-14,236,0,5084,45,CI
2020-06-15,355,1,5439,46,CI
2020-06-16,240,0,5679,46,CI
2020-06-17,384,2,6063,48,CI
2020-06-18,0,0,6063,48,CI
2020-06-19,381,1,6444,49,CI
2020-06-20,430,0,6874,49,CI
2020-06-21,618,2,7492,51,CI
2020-06-22,0,3,7492,54,CI
2020-06-23,412,4,7904,58,CI
2020-06-24,0,0,7904,58,CI
2020-06-25,260,0,8164,58,CI
2020-06-26,170,2,8334,60,CI
2020-03-03,1,0,1,0,CL
2020-03-04,2,0,3,0,CL
2020-03-05,1,0,4,0,CL
2020-03-06,1,0,5,0,CL
2020-03-08,5,0,10,0,CL
2020-03-09,3,0,13,0,CL
2020-03-10,4,0,17,0,CL
2020-03-11,6,0,23,0,CL
2020-03-12,10,0,33,0,CL
2020-03-13,10,0,43,0,CL
2020-03-14,18,0,61,0,CL
2020-03-15,14,0,75,0,CL
2020-03-16,81,0,156,0,CL
2020-03-17,45,0,201,0,CL
2020-03-18,37,0,238,0,CL
2020-03-19,104,0,342,0,CL
2020-03-20,92,0,434,0,CL
2020-03-21,103,0,537,0,CL
2020-03-22,95,1,632,1,CL
2020-03-23,114,1,746,2,CL
2020-03-24,176,0,922,2,CL
2020-03-25,220,1,1142,3,CL
2020-03-26,164,1,1306,4,CL
2020-03-27,304,1,1610,5,CL
2020-03-28,299,1,1909,6,CL
2020-03-29,230,1,2139,7,CL
2020-03-30,310,1,2449,8,CL
2020-03-31,289,4,2738,12,CL
2020-04-01,293,4,3031,16,CL
2020-04-02,373,2,3404,18,CL
2020-04-03,333,4,3737,22,CL
2020-04-04,424,5,4161,27,CL
2020-04-05,310,7,4471,34,CL
2020-04-06,344,3,4815,37,CL
2020-04-07,301,6,5116,43,CL
2020-04-08,430,5,5546,48,CL
2020-04-09,426,9,5972,57,CL
2020-04-10,529,8,6501,65,CL
2020-04-11,426,8,6927,73,CL
2020-04-12,286,7,7213,80,CL
2020-04-13,312,2,7525,82,CL
2020-04-14,392,10,7917,92,CL
2020-04-15,356,2,8273,94,CL
2020-04-16,534,11,8807,105,CL
2020-04-17,445,11,9252,116,CL
2020-04-18,478,10,9730,126,CL
2020-04-19,358,7,10088,133,CL
2020-04-20,419,6,10507,139,CL
2020-04-21,325,8,10832,147,CL
2020-04-22,464,13,11296,160,CL
2020-04-23,516,8,11812,168,CL
2020-04-24,494,6,12306,174,CL
2020-04-25,552,7,12858,181,CL
2020-04-26,473,8,13331,189,CL
2020-04-27,482,9,13813,198,CL
2020-04-28,552,9,14365,207,CL
2020-04-29,520,9,14885,216,CL
2020-04-30,1138,11,16023,227,CL
2020-05-01,985,7,17008,234,CL
2020-05-02,1427,13,18435,247,CL
2020-05-03,1228,13,19663,260,CL
2020-05-04,980,10,20643,270,CL
2020-05-05,1373,5,22016,275,CL
2020-05-06,1032,6,23048,281,CL
2020-05-07,1533,4,24581,285,CL
2020-05-08,1391,9,25972,294,CL
2020-05-09,1247,10,27219,304,CL
2020-05-10,1647,8,28866,312,CL
2020-05-11,1197,11,30063,323,CL
2020-05-12,1658,12,31721,335,CL
2020-05-13,2660,11,34381,346,CL
2020-05-14,2659,12,37040,358,CL
2020-05-15,2502,36,39542,394,CL
2020-05-16,1886,27,41428,421,CL
2020-05-17,2353,29,43781,450,CL
2020-05-18,2278,28,46059,478,CL
2020-05-19,3520,31,49579,509,CL
2020-05-20,4038,35,53617,544,CL
2020-05-21,3964,45,57581,589,CL
2020-05-22,4276,41,61857,630,CL
2020-05-23,3536,43,65393,673,CL
2020-05-24,3709,45,69102,718,CL
2020-05-25,4895,43,73997,761,CL
2020-05-26,3964,45,77961,806,CL
2020-05-27,4328,35,82289,841,CL
2020-05-28,4654,49,86943,890,CL
2020-05-29,3695,54,90638,944,CL
2020-05-30,4220,53,94858,997,CL
2020-05-31,4830,57,99688,1054,CL
2020-06-01,5471,59,105159,1113,CL
2020-06-02,3527,75,108686,1188,CL
2020-06-03,4942,87,113628,1275,CL
2020-06-04,4664,81,118292,1356,CL
2020-06-05,4207,92,122499,1448,CL
2020-06-06,5246,93,127745,1541,CL
2020-06-07,6405,649,134150,2190,CL
2020-06-08,4696,74,138846,2264,CL
2020-06-09,3913,19,142759,2283,CL
2020-06-10,5737,192,148496,2475,CL
2020-06-11,5596,173,154092,2648,CL
2020-06-12,6754,222,160846,2870,CL
2020-06-13,6509,231,167355,3101,CL
2020-06-14,6938,222,174293,3323,CL
2020-06-15,5143,39,179436,3362,CL
2020-06-16,5013,21,184449,3383,CL
2020-06-17,36179,232,220628,3615,CL
2020-06-18,4475,226,225103,3841,CL
2020-06-19,6290,252,231393,4093,CL
2020-06-20,5355,202,236748,4295,CL
2020-06-21,5607,184,242355,4479,CL
2020-06-22,4608,23,246963,4502,CL
2020-06-23,3804,3,250767,4505,CL
2020-06-24,3649,226,254416,4731,CL
2020-06-25,4648,172,259064,4903,CL
2020-06-26,4296,165,263360,5068,CL
2020-03-06,1,0,1,0,CM
2020-03-08,1,0,2,0,CM
2020-03-14,1,0,3,0,CM
2020-03-15,1,0,4,0,CM
2020-03-16,0,0,4,0,CM
2020-03-17,6,0,10,0,CM
2020-03-18,0,0,10,0,CM
2020-03-19,4,0,14,0,CM
2020-03-20,13,0,27,0,CM
2020-03-21,0,0,27,0,CM
2020-03-22,0,0,27,0,CM
2020-03-23,29,0,56,0,CM
2020-03-24,16,1,72,1,CM
2020-03-25,0,0,72,1,CM
2020-03-26,16,0,88,1,CM
2020-03-27,0,0,88,1,CM
2020-03-28,11,1,99,2,CM
2020-03-29,0,0,99,2,CM
2020-03-30,43,0,142,2,CM
2020-03-31,51,4,193,6,CM
2020-04-01,40,0,233,6,CM
2020-04-02,38,1,271,7,CM
2020-04-03,238,1,509,8,CM
2020-04-04,46,1,555,9,CM
2020-04-05,95,0,650,9,CM
2020-04-06,8,0,658,9,CM
2020-04-07,27,0,685,9,CM
2020-04-08,45,1,730,10,CM
2020-04-09,0,0,730,10,CM
2020-04-10,73,0,803,10,CM
2020-04-11,17,1,820,11,CM
2020-04-12,0,1,820,12,CM
2020-04-13,0,0,820,12,CM
2020-04-14,35,5,855,17,CM
2020-04-15,0,0,855,17,CM
2020-04-16,0,4,855,21,CM
2020-04-17,161,0,1016,21,CM
2020-04-18,0,0,1016,21,CM
2020-04-19,0,21,1016,42,CM
2020-04-20,1,0,1017,42,CM
2020-04-21,146,0,1163,42,CM
2020-04-22,0,1,1163,43,CM
2020-04-23,238,6,1401,49,CM
2020-04-24,2,0,1403,49,CM
2020-04-25,115,4,1518,53,CM
2020-04-26,103,3,1621,56,CM
2020-04-27,0,2,1621,58,CM
2020-04-28,185,1,1806,59,CM
2020-04-29,26,2,1832,61,CM
2020-04-30,0,0,1832,61,CM
2020-05-01,237,0,2069,61,CM
2020-05-02,8,3,2077,64,CM
2020-05-03,0,0,2077,64,CM
2020-05-04,27,0,2104,64,CM
2020-05-05,0,0,2104,64,CM
2020-05-06,161,44,2265,108,CM
2020-05-07,0,0,2265,108,CM
2020-05-08,0,0,2265,108,CM
2020-05-09,9,0,2274,108,CM
2020-05-10,305,6,2579,114,CM
2020-05-11,110,11,2689,125,CM
2020-05-12,0,0,2689,125,CM
2020-05-13,111,11,2800,136,CM
2020-05-14,154,3,2954,139,CM
2020-05-15,151,1,3105,140,CM
2020-05-16,187,0,3292,140,CM
2020-05-17,0,0,3292,140,CM
2020-05-18,0,0,3292,140,CM
2020-05-19,237,0,3529,140,CM
2020-05-20,204,6,3733,146,CM
2020-05-21,555,10,4288,156,CM
2020-05-22,112,3,4400,159,CM
2020-05-23,197,0,4597,159,CM
2020-05-24,293,6,4890,165,CM
2020-05-25,154,6,5044,171,CM
2020-05-26,312,4,5356,175,CM
2020-05-27,0,2,5356,177,CM
2020-05-28,0,0,5356,177,CM
2020-05-29,80,0,5436,177,CM
2020-05-30,468,14,5904,191,CM
2020-05-31,0,0,5904,191,CM
2020-06-01,493,8,6397,199,CM
2020-06-02,188,1,6585,200,CM
2020-06-03,167,0,6752,200,CM
2020-06-04,37,3,6789,203,CM
2020-06-05,810,0,7599,203,CM
2020-06-06,0,0,7599,203,CM
2020-06-07,309,0,7908,203,CM
2020-06-08,404,5,8312,208,CM
2020-06-09,369,0,8681,208,CM
2020-06-10,248,6,8929,214,CM
2020-06-11,0,0,8929,214,CM
2020-06-12,267,59,9196,273,CM
2020-06-13,376,2,9572,275,CM
2020-06-14,292,1,9864,276,CM
2020-06-15,0,0,9864,276,CM
2020-06-16,0,0,9864,276,CM
2020-06-17,0,0,9864,276,CM
2020-06-18,774,6,10638,282,CM
2020-06-19,643,18,11281,300,CM
2020-06-20,0,0,11281,300,CM
2020-06-21,329,1,11610,301,CM
2020-06-22,282,2,11892,303,CM
2020-06-23,149,5,12041,308,CM
2020-06-24,229,5,12270,313,CM
2020-06-25,322,0,12592,313,CM
2020-06-26,0,0,12592,313,CM
2019-12-30,27,0,27,0,CN
2019-12-31,0,0,27,0,CN
2020-01-01,0,0,27,0,CN
2020-01-02,17,0,44,0,CN
2020-01-03,0,0,44,0,CN
2020-01-04,15,0,59,0,CN
2020-01-05,0,0,59,0,CN
2020-01-06,0,0,59,0,CN
2020-01-07,0,0,59,0,CN
2020-01-08,0,0,59,0,CN
2020-01-09,0,0,59,0,CN
2020-01-10,0,1,59,1,CN
2020-01-11,0,0,59,1,CN
2020-01-12,0,0,59,1,CN
2020-01-13,0,0,59,1,CN
2020-01-14,0,1,59,2,CN
2020-01-15,0,0,59,2,CN
2020-01-16,4,0,63,2,CN
2020-01-17,17,0,80,2,CN
2020-01-18,136,1,216,3,CN
2020-01-19,19,0,235,3,CN
2020-01-20,151,3,386,6,CN
2020-01-21,140,11,526,17,CN
2020-01-22,97,0,623,17,CN
2020-01-23,259,9,882,26,CN
2020-01-24,441,15,1323,41,CN
2020-01-25,665,15,1988,56,CN
2020-01-26,787,25,2775,81,CN
2020-01-27,1753,25,4528,106,CN
2020-01-28,1466,26,5994,132,CN
2020-01-29,1740,38,7734,170,CN
2020-01-30,1980,43,9714,213,CN
2020-01-31,2095,46,11809,259,CN
2020-02-01,2590,45,14399,304,CN
2020-02-02,2812,57,17211,361,CN
2020-02-03,3237,65,20448,426,CN
2020-02-04,3872,66,24320,492,CN
2020-02-05,3727,72,28047,564,CN
2020-02-06,3160,73,31207,637,CN
2020-02-07,3418,86,34625,723,CN
2020-02-08,2607,89,37232,812,CN
2020-02-09,2974,97,40206,909,CN
2020-02-10,2490,108,42696,1017,CN
2020-02-11,2028,97,44724,1114,CN
2020-02-12,15141,254,59865,1368,CN
2020-02-13,4156,13,64021,1381,CN
2020-02-14,2538,143,66559,1524,CN
2020-02-15,2007,142,68566,1666,CN
2020-02-16,2052,105,70618,1771,CN
2020-02-17,1890,98,72508,1869,CN
2020-02-18,1750,139,74258,2008,CN
2020-02-19,394,112,74652,2120,CN
2020-02-20,891,118,75543,2238,CN
2020-02-21,826,109,76369,2347,CN
2020-02-22,647,98,77016,2445,CN
2020-02-23,218,150,77234,2595,CN
2020-02-24,515,70,77749,2665,CN
2020-02-25,410,52,78159,2717,CN
2020-02-26,439,29,78598,2746,CN
2020-02-27,329,44,78927,2790,CN
2020-02-28,428,47,79355,2837,CN
2020-02-29,574,35,79929,2872,CN
2020-03-01,205,42,80134,2914,CN
2020-03-02,127,32,80261,2946,CN
2020-03-03,119,37,80380,2983,CN
2020-03-04,117,31,80497,3014,CN
2020-03-05,170,30,80667,3044,CN
2020-03-06,101,28,80768,3072,CN
2020-03-07,46,27,80814,3099,CN
2020-03-08,45,23,80859,3122,CN
2020-03-09,20,17,80879,3139,CN
2020-03-10,29,22,80908,3161,CN
2020-03-11,24,11,80932,3172,CN
2020-03-12,22,7,80954,3179,CN
2020-03-13,19,15,80973,3194,CN
2020-03-14,22,9,80995,3203,CN
2020-03-15,25,13,81020,3216,CN
2020-03-16,43,9,81063,3225,CN
2020-03-17,23,16,81086,3241,CN
2020-03-18,44,8,81130,3249,CN
2020-03-19,99,4,81229,3253,CN
2020-03-20,52,6,81281,3259,CN
2020-03-21,65,6,81346,3265,CN
2020-03-22,138,9,81484,3274,CN
2020-03-23,69,7,81553,3281,CN
2020-03-24,78,4,81631,3285,CN
2020-03-25,102,6,81733,3291,CN
2020-03-26,94,5,81827,3296,CN
2020-03-27,119,3,81946,3299,CN
2020-03-28,113,5,82059,3304,CN
2020-03-29,98,2,82157,3306,CN
2020-03-30,84,3,82241,3309,CN
2020-03-31,54,1,82295,3310,CN
2020-04-01,100,6,82395,3316,CN
2020-04-02,70,10,82465,3326,CN
2020-04-03,62,4,82527,3330,CN
2020-04-04,48,3,82575,3333,CN
2020-04-05,67,2,82642,3335,CN
2020-04-06,56,0,82698,3335,CN
2020-04-07,86,2,82784,3337,CN
2020-04-08,86,2,82870,3339,CN
2020-04-09,55,1,82925,3340,CN
2020-04-10,79,3,83004,3343,CN
2020-04-11,93,0,83097,3343,CN
2020-04-12,112,2,83209,3345,CN
2020-04-13,94,0,83303,3345,CN
2020-04-14,49,1,83352,3346,CN
2020-04-15,50,0,83402,3346,CN
2020-04-16,352,1290,83754,4636,CN
2020-04-17,31,0,83785,4636,CN
2020-04-18,18,0,83803,4636,CN
2020-04-19,14,0,83817,4636,CN
2020-04-20,32,0,83849,4636,CN
2020-04-21,15,0,83864,4636,CN
2020-04-22,12,0,83876,4636,CN
2020-04-23,8,0,83884,4636,CN
2020-04-24,15,0,83899,4636,CN
2020-04-25,10,0,83909,4636,CN
2020-04-26,3,1,83912,4637,CN
2020-04-27,26,0,83938,4637,CN
2020-04-28,2,0,83940,4637,CN
2020-04-29,4,0,83944,4637,CN
2020-04-30,12,0,83956,4637,CN
2020-05-01,3,0,83959,4637,CN
2020-05-02,2,0,83961,4637,CN
2020-05-03,3,0,83964,4637,CN
2020-05-04,2,0,83966,4637,CN
2020-05-05,2,0,83968,4637,CN
2020-05-06,2,0,83970,4637,CN
2020-05-07,6,0,83976,4637,CN
2020-05-08,0,0,83976,4637,CN
2020-05-09,15,0,83991,4637,CN
2020-05-10,19,0,84010,4637,CN
2020-05-11,1,0,84011,4637,CN
2020-05-12,7,0,84018,4637,CN
2020-05-13,6,0,84024,4637,CN
2020-05-14,5,0,84029,4637,CN
2020-05-15,9,0,84038,4637,CN
2020-05-16,6,1,84044,4638,CN
2020-05-17,10,0,84054,4638,CN
2020-05-18,9,0,84063,4638,CN
2020-05-19,2,0,84065,4638,CN
2020-05-20,2,0,84067,4638,CN
2020-05-21,12,0,84079,4638,CN
2020-05-22,2,0,84081,4638,CN
2020-05-23,3,0,84084,4638,CN
2020-05-24,11,0,84095,4638,CN
2020-05-25,7,0,84102,4638,CN
2020-05-26,1,0,84103,4638,CN
2020-05-27,3,0,84106,4638,CN
2020-05-28,0,0,84106,4638,CN
2020-05-29,17,0,84123,4638,CN
2020-05-30,5,0,84128,4638,CN
2020-05-31,19,0,84147,4638,CN
2020-06-01,7,0,84154,4638,CN
2020-06-02,5,0,84159,4638,CN
2020-06-03,1,0,84160,4638,CN
2020-06-04,11,0,84171,4638,CN
2020-06-05,6,0,84177,4638,CN
2020-06-06,9,0,84186,4638,CN
2020-06-07,5,0,84191,4638,CN
2020-06-08,3,0,84194,4638,CN
2020-06-09,4,0,84198,4638,CN
2020-06-10,11,0,84209,4638,CN
2020-06-11,7,0,84216,4638,CN
2020-06-12,12,0,84228,4638,CN
2020-06-13,60,0,84288,4638,CN
2020-06-14,47,0,84335,4638,CN
2020-06-15,43,0,84378,4638,CN
2020-06-16,44,0,84422,4638,CN
2020-06-17,36,0,84458,4638,CN
2020-06-18,36,0,84494,4638,CN
2020-06-19,30,0,84524,4638,CN
2020-06-20,29,1,84553,4639,CN
2020-06-21,19,0,84572,4639,CN
2020-06-22,52,0,84624,4639,CN
2020-06-23,29,1,84653,4640,CN
2020-06-24,20,0,84673,4640,CN
2020-06-25,28,1,84701,4641,CN
2020-06-26,24,0,84725,4641,CN
2020-03-06,1,0,1,0,CO
2020-03-09,2,0,3,0,CO
2020-03-11,6,0,9,0,CO
2020-03-13,7,0,16,0,CO
2020-03-14,18,0,34,0,CO
2020-03-15,11,0,45,0,CO
2020-03-16,12,0,57,0,CO
2020-03-17,8,0,65,0,CO
2020-03-18,37,0,102,0,CO
2020-03-19,26,0,128,0,CO
2020-03-20,30,0,158,0,CO
2020-03-21,52,1,210,1,CO
2020-03-22,25,1,235,2,CO
2020-03-23,71,1,306,3,CO
2020-03-24,72,0,378,3,CO
2020-03-25,92,1,470,4,CO
2020-03-26,21,2,491,6,CO
2020-03-27,48,0,539,6,CO
2020-03-28,69,0,608,6,CO
2020-03-29,94,4,702,10,CO
2020-03-30,96,4,798,14,CO
2020-03-31,108,2,906,16,CO
2020-04-01,159,1,1065,17,CO
2020-04-02,96,2,1161,19,CO
2020-04-03,106,6,1267,25,CO
2020-04-04,139,7,1406,32,CO
2020-04-05,79,3,1485,35,CO
2020-04-06,94,11,1579,46,CO
2020-04-07,201,4,1780,50,CO
2020-04-08,274,5,2054,55,CO
2020-04-09,169,14,2223,69,CO
2020-04-10,250,11,2473,80,CO
2020-04-11,236,20,2709,100,CO
2020-04-12,67,9,2776,109,CO
2020-04-13,76,3,2852,112,CO
2020-04-14,127,15,2979,127,CO
2020-04-15,126,4,3105,131,CO
2020-04-16,128,13,3233,144,CO
2020-04-17,206,9,3439,153,CO
2020-04-18,182,13,3621,166,CO
2020-04-19,171,13,3792,179,CO
2020-04-20,185,10,3977,189,CO
2020-04-21,172,7,4149,196,CO
2020-04-22,207,10,4356,206,CO
2020-04-23,205,9,4561,215,CO
2020-04-24,320,10,4881,225,CO
2020-04-25,261,8,5142,233,CO
2020-04-26,237,10,5379,243,CO
2020-04-27,218,10,5597,253,CO
2020-04-28,352,16,5949,269,CO
2020-04-29,262,9,6211,278,CO
2020-04-30,296,15,6507,293,CO
2020-05-01,499,21,7006,314,CO
2020-05-02,279,10,7285,324,CO
2020-05-03,383,16,7668,340,CO
2020-05-04,305,18,7973,358,CO
2020-05-05,640,20,8613,378,CO
2020-05-06,346,19,8959,397,CO
2020-05-07,497,10,9456,407,CO
2020-05-08,595,21,10051,428,CO
2020-05-09,444,17,10495,445,CO
2020-05-10,568,18,11063,463,CO
2020-05-11,550,16,11613,479,CO
2020-05-12,659,14,12272,493,CO
2020-05-13,658,16,12930,509,CO
2020-05-14,680,16,13610,525,CO
2020-05-15,606,21,14216,546,CO
2020-05-16,723,16,14939,562,CO
2020-05-17,635,12,15574,574,CO
2020-05-18,721,18,16295,592,CO
2020-05-19,640,21,16935,613,CO
2020-05-20,752,17,17687,630,CO
2020-05-21,643,22,18330,652,CO
2020-05-22,801,30,19131,682,CO
2020-05-23,1046,23,20177,705,CO
2020-05-24,998,22,21175,727,CO
2020-05-25,806,23,21981,750,CO
2020-05-26,1022,26,23003,776,CO
2020-05-27,1101,27,24104,803,CO
2020-05-28,1262,19,25366,822,CO
2020-05-29,1322,31,26688,853,CO
2020-05-30,1548,37,28236,890,CO
2020-05-31,1147,49,29383,939,CO
2020-06-01,1110,30,30493,969,CO
2020-06-02,1340,40,31833,1009,CO
2020-06-03,1521,36,33354,1045,CO
2020-06-04,1766,42,35120,1087,CO
2020-06-05,1515,58,36635,1145,CO
2020-06-06,1392,60,38027,1205,CO
2020-06-07,1209,54,39236,1259,CO
2020-06-08,1483,49,40719,1308,CO
2020-06-09,1359,64,42078,1372,CO
2020-06-10,1604,61,43682,1433,CO
2020-06-11,0,0,43682,1433,CO
2020-06-12,3176,112,46858,1545,CO
2020-06-13,1888,47,48746,1592,CO
2020-06-14,2193,75,50939,1667,CO
2020-06-15,2124,59,53063,1726,CO
2020-06-16,1868,75,54931,1801,CO
2020-06-17,2115,63,57046,1864,CO
2020-06-18,3171,86,60217,1950,CO
2020-06-19,3059,95,63276,2045,CO
2020-06-20,2357,81,65633,2126,CO
2020-06-21,3019,111,68652,2237,CO
2020-06-22,2531,73,71183,2310,CO
2020-06-23,2389,94,73572,2404,CO
2020-06-24,3541,87,77113,2491,CO
2020-06-25,3486,163,80599,2654,CO
2020-06-26,3843,157,84442,2811,CO
2020-03-06,1,0,1,0,CR
2020-03-08,4,0,5,0,CR
2020-03-09,4,0,9,0,CR
2020-03-10,4,0,13,0,CR
2020-03-11,9,0,22,0,CR
2020-03-12,1,0,23,0,CR
2020-03-13,3,0,26,0,CR
2020-03-14,1,0,27,0,CR
2020-03-15,8,0,35,0,CR
2020-03-16,6,0,41,0,CR
2020-03-17,9,0,50,0,CR
2020-03-18,19,1,69,1,CR
2020-03-19,18,0,87,1,CR
2020-03-20,26,1,113,2,CR
2020-03-21,4,0,117,2,CR
2020-03-22,17,0,134,2,CR
2020-03-23,24,0,158,2,CR
2020-03-24,19,0,177,2,CR
2020-03-25,24,0,201,2,CR
2020-03-26,30,0,231,2,CR
2020-03-27,32,0,263,2,CR
2020-03-28,32,0,295,2,CR
2020-03-29,19,0,314,2,CR
2020-03-30,16,0,330,2,CR
2020-03-31,17,0,347,2,CR
2020-04-01,28,0,375,2,CR
2020-04-02,21,0,396,2,CR
2020-04-03,20,0,416,2,CR
2020-04-04,19,0,435,2,CR
2020-04-05,19,0,454,2,CR
2020-04-06,13,0,467,2,CR
2020-04-07,16,0,483,2,CR
2020-04-08,19,0,502,2,CR
2020-04-09,37,1,539,3,CR
2020-04-10,19,0,558,3,CR
2020-04-11,19,0,577,3,CR
2020-04-12,18,0,595,3,CR
2020-04-13,17,0,612,3,CR
2020-04-14,6,0,618,3,CR
2020-04-15,8,1,626,4,CR
2020-04-16,16,0,642,4,CR
2020-04-17,7,0,649,4,CR
2020-04-18,6,0,655,4,CR
2020-04-19,5,0,660,4,CR
2020-04-20,2,2,662,6,CR
2020-04-21,7,0,669,6,CR
2020-04-22,12,0,681,6,CR
2020-04-23,6,0,687,6,CR
2020-04-24,0,0,687,6,CR
2020-04-25,6,0,693,6,CR
2020-04-26,2,0,695,6,CR
2020-04-27,2,0,697,6,CR
2020-04-28,8,0,705,6,CR
2020-04-29,8,0,713,6,CR
2020-04-30,6,0,719,6,CR
2020-05-01,6,0,725,6,CR
2020-05-02,8,0,733,6,CR
2020-05-03,6,0,739,6,CR
2020-05-04,3,0,742,6,CR
2020-05-05,13,0,755,6,CR
2020-05-06,6,0,761,6,CR
2020-05-07,4,0,765,6,CR
2020-05-08,8,0,773,6,CR
2020-05-09,7,0,780,6,CR
2020-05-10,12,0,792,6,CR
2020-05-11,9,1,801,7,CR
2020-05-12,3,0,804,7,CR
2020-05-13,11,0,815,7,CR
2020-05-14,15,1,830,8,CR
2020-05-15,13,0,843,8,CR
2020-05-16,10,2,853,10,CR
2020-05-17,10,0,863,10,CR
2020-05-18,3,0,866,10,CR
2020-05-19,16,0,882,10,CR
2020-05-20,15,0,897,10,CR
2020-05-21,6,0,903,10,CR
2020-05-22,8,0,911,10,CR
2020-05-23,7,0,918,10,CR
2020-05-24,12,0,930,10,CR
2020-05-25,21,0,951,10,CR
2020-05-26,5,0,956,10,CR
2020-05-27,28,0,984,10,CR
2020-05-28,16,0,1000,10,CR
2020-05-29,22,0,1022,10,CR
2020-05-30,25,0,1047,10,CR
2020-05-31,9,0,1056,10,CR
2020-06-01,28,0,1084,10,CR
2020-06-02,21,0,1105,10,CR
2020-06-03,52,0,1157,10,CR
2020-06-04,37,0,1194,10,CR
2020-06-05,34,0,1228,10,CR
2020-06-06,35,0,1263,10,CR
2020-06-07,55,0,1318,10,CR
2020-06-08,24,0,1342,10,CR
2020-06-09,33,1,1375,11,CR
2020-06-10,86,1,1461,12,CR
2020-06-11,77,0,1538,12,CR
2020-06-12,74,0,1612,12,CR
2020-06-13,50,0,1662,12,CR
2020-06-14,53,0,1715,12,CR
2020-06-15,29,0,1744,12,CR
2020-06-16,25,0,1769,12,CR
2020-06-17,102,0,1871,12,CR
2020-06-18,0,0,1871,12,CR
2020-06-19,187,0,2058,12,CR
2020-06-20,69,0,2127,12,CR
2020-06-21,86,0,2213,12,CR
2020-06-22,64,0,2277,12,CR
2020-06-23,91,0,2368,12,CR
2020-06-24,147,0,2515,12,CR
2020-06-25,169,0,2684,12,CR
2020-06-26,152,0,2836,12,CR
2020-03-11,3,0,3,0,CU
2020-03-13,1,0,4,0,CU
2020-03-14,0,0,4,0,CU
2020-03-17,3,0,7,0,CU
2020-03-18,4,1,11,1,CU
2020-03-19,5,0,16,1,CU
2020-03-20,5,0,21,1,CU
2020-03-21,4,0,25,1,CU
2020-03-22,10,0,35,1,CU
2020-03-23,5,0,40,1,CU
2020-03-24,8,0,48,1,CU
2020-03-25,9,0,57,1,CU
2020-03-26,10,1,67,2,CU
2020-03-27,13,0,80,2,CU
2020-03-28,39,1,119,3,CU
2020-03-29,20,0,139,3,CU
2020-03-30,31,1,170,4,CU
2020-03-31,16,2,186,6,CU
2020-04-01,26,0,212,6,CU
2020-04-02,21,0,233,6,CU
2020-04-03,36,0,269,6,CU
2020-04-04,19,0,288,6,CU
2020-04-05,32,2,320,8,CU
2020-04-06,30,1,350,9,CU
2020-04-07,46,2,396,11,CU
2020-04-08,61,1,457,12,CU
2020-04-09,58,3,515,15,CU
2020-04-10,49,0,564,15,CU
2020-04-11,56,1,620,16,CU
2020-04-12,49,2,669,18,CU
2020-04-13,57,3,726,21,CU
2020-04-14,40,0,766,21,CU
2020-04-15,48,3,814,24,CU
2020-04-16,48,3,862,27,CU
2020-04-17,61,4,923,31,CU
2020-04-18,63,1,986,32,CU
2020-04-19,49,2,1035,34,CU
2020-04-20,52,2,1087,36,CU
2020-04-21,50,2,1137,38,CU
2020-04-22,52,2,1189,40,CU
2020-04-23,46,3,1235,43,CU
2020-04-24,50,6,1285,49,CU
2020-04-25,52,2,1337,51,CU
2020-04-26,32,3,1369,54,CU
2020-04-27,20,2,1389,56,CU
2020-04-28,48,2,1437,58,CU
2020-04-29,30,0,1467,58,CU
2020-04-30,34,3,1501,61,CU
2020-05-01,36,3,1537,64,CU
2020-05-02,74,2,1611,66,CU
2020-05-03,38,1,1649,67,CU
2020-05-04,19,2,1668,69,CU
2020-05-05,17,0,1685,69,CU
2020-05-06,18,0,1703,69,CU
2020-05-07,26,4,1729,73,CU
2020-05-08,12,1,1741,74,CU
2020-05-09,13,0,1754,74,CU
2020-05-10,12,3,1766,77,CU
2020-05-11,17,0,1783,77,CU
2020-05-12,21,1,1804,78,CU
2020-05-13,6,1,1810,79,CU
2020-05-14,20,0,1830,79,CU
2020-05-15,10,0,1840,79,CU
2020-05-16,22,0,1862,79,CU
2020-05-17,10,0,1872,79,CU
2020-05-18,9,0,1881,79,CU
2020-05-19,6,0,1887,79,CU
2020-05-20,13,0,1900,79,CU
2020-05-21,8,1,1908,80,CU
2020-05-22,8,1,1916,81,CU
2020-05-23,15,0,1931,81,CU
2020-05-24,10,1,1941,82,CU
2020-05-25,6,0,1947,82,CU
2020-05-26,16,0,1963,82,CU
2020-05-27,11,0,1974,82,CU
2020-05-28,9,0,1983,82,CU
2020-05-29,22,0,2005,82,CU
2020-05-30,20,1,2025,83,CU
2020-05-31,20,0,2045,83,CU
2020-06-01,38,0,2083,83,CU
2020-06-02,9,0,2092,83,CU
2020-06-03,15,0,2107,83,CU
2020-06-04,12,0,2119,83,CU
2020-06-05,14,0,2133,83,CU
2020-06-06,40,0,2173,83,CU
2020-06-07,18,0,2191,83,CU
2020-06-08,9,0,2200,83,CU
2020-06-09,5,0,2205,83,CU
2020-06-10,6,0,2211,83,CU
2020-06-11,8,1,2219,84,CU
2020-06-12,14,0,2233,84,CU
2020-06-13,5,0,2238,84,CU
2020-06-14,10,0,2248,84,CU
2020-06-15,14,0,2262,84,CU
2020-06-16,11,0,2273,84,CU
2020-06-17,7,0,2280,84,CU
2020-06-18,15,1,2295,85,CU
2020-06-19,10,0,2305,85,CU
2020-06-20,4,0,2309,85,CU
2020-06-21,3,0,2312,85,CU
2020-06-22,3,0,2315,85,CU
2020-06-23,3,0,2318,85,CU
2020-06-24,1,0,2319,85,CU
2020-06-25,2,0,2321,85,CU
2020-06-26,4,0,2325,85,CU
2020-03-20,2,0,2,0,CV
2020-03-21,1,0,3,0,CV
2020-03-22,0,0,3,0,CV
2020-03-23,0,0,3,0,CV
2020-03-24,0,1,3,1,CV
2020-03-25,1,0,4,1,CV
2020-03-26,1,0,5,1,CV
2020-03-27,0,0,5,1,CV
2020-03-28,0,0,5,1,CV
2020-03-29,0,0,5,1,CV
2020-03-30,0,0,5,1,CV
2020-03-31,1,0,6,1,CV
2020-04-01,0,0,6,1,CV
2020-04-02,0,0,6,1,CV
2020-04-03,0,0,6,1,CV
2020-04-04,1,0,7,1,CV
2020-04-05,0,0,7,1,CV
2020-04-06,0,0,7,1,CV
2020-04-07,0,0,7,1,CV
2020-04-08,0,0,7,1,CV
2020-04-09,0,0,7,1,CV
2020-04-10,0,0,7,1,CV
2020-04-11,1,0,8,1,CV
2020-04-12,2,0,10,1,CV
2020-04-13,0,0,10,1,CV
2020-04-14,1,0,11,1,CV
2020-04-15,44,0,55,1,CV
2020-04-16,0,0,55,1,CV
2020-04-17,1,0,56,1,CV
2020-04-18,2,0,58,1,CV
2020-04-19,3,0,61,1,CV
2020-04-20,6,0,67,1,CV
2020-04-21,0,0,67,1,CV
2020-04-22,6,0,73,1,CV
2020-04-23,9,0,82,1,CV
2020-04-24,6,0,88,1,CV
2020-04-25,2,0,90,1,CV
2020-04-26,16,0,106,1,CV
2020-04-27,3,0,109,1,CV
2020-04-28,4,0,113,1,CV
2020-04-29,0,0,113,1,CV
2020-04-30,8,0,121,1,CV
2020-05-01,2,1,123,2,CV
2020-05-02,29,0,152,2,CV
2020-05-03,13,0,165,2,CV
2020-05-04,10,0,175,2,CV
2020-05-05,11,0,186,2,CV
2020-05-06,5,0,191,2,CV
2020-05-07,27,0,218,2,CV
2020-05-08,12,0,230,2,CV
2020-05-09,6,0,236,2,CV
2020-05-10,10,0,246,2,CV
2020-05-11,14,0,260,2,CV
2020-05-12,10,0,270,2,CV
2020-05-13,19,0,289,2,CV
2020-05-14,26,0,315,2,CV
2020-05-15,11,0,326,2,CV
2020-05-16,2,1,328,3,CV
2020-05-17,0,0,328,3,CV
2020-05-18,0,0,328,3,CV
2020-05-19,7,0,335,3,CV
2020-05-20,14,0,349,3,CV
2020-05-21,7,0,356,3,CV
2020-05-22,6,0,362,3,CV
2020-05-23,9,0,371,3,CV
2020-05-24,9,0,380,3,CV
2020-05-25,10,0,390,3,CV
2020-05-26,0,1,390,4,CV
2020-05-27,0,0,390,4,CV
2020-05-28,0,0,390,4,CV
2020-05-29,15,0,405,4,CV
2020-05-30,16,0,421,4,CV
2020-05-31,14,0,435,4,CV
2020-06-01,23,0,458,4,CV
2020-06-02,8,1,466,5,CV
2020-06-03,11,0,477,5,CV
2020-06-04,25,0,502,5,CV
2020-06-05,34,0,536,5,CV
2020-06-06,6,0,542,5,CV
2020-06-07,12,0,554,5,CV
2020-06-08,13,0,567,5,CV
2020-06-09,18,0,585,5,CV
2020-06-10,30,0,615,5,CV
2020-06-11,42,1,657,6,CV
2020-06-12,40,0,697,6,CV
2020-06-13,29,0,726,6,CV
2020-06-14,24,0,750,6,CV
2020-06-15,10,1,760,7,CV
2020-06-16,21,0,781,7,CV
2020-06-17,11,0,792,7,CV
2020-06-18,31,0,823,7,CV
2020-06-19,25,1,848,8,CV
2020-06-20,15,0,863,8,CV
2020-06-21,27,0,890,8,CV
2020-06-22,54,0,944,8,CV
2020-06-23,38,0,982,8,CV
2020-06-24,17,0,999,8,CV
2020-06-25,4,0,1003,8,CV
2020-06-26,24,2,1027,10,CV
2020-03-12,1,0,1,0,CW
2020-03-19,2,0,3,0,CW
2020-03-23,3,0,6,0,CW
2020-03-25,0,1,6,1,CW
2020-03-26,1,0,7,1,CW
2020-03-27,1,0,8,1,CW
2020-03-28,0,0,8,1,CW
2020-03-29,1,0,9,1,CW
2020-03-31,2,0,11,1,CW
2020-04-01,0,0,11,1,CW
2020-04-02,0,0,11,1,CW
2020-04-03,0,0,11,1,CW
2020-04-04,0,0,11,1,CW
2020-04-05,0,0,11,1,CW
2020-04-06,2,0,13,1,CW
2020-04-07,0,0,13,1,CW
2020-04-08,1,0,14,1,CW
2020-04-09,0,0,14,1,CW
2020-04-10,0,0,14,1,CW
2020-04-11,0,0,14,1,CW
2020-04-12,0,0,14,1,CW
2020-04-13,0,0,14,1,CW
2020-04-14,0,0,14,1,CW
2020-04-15,0,0,14,1,CW
2020-04-16,0,0,14,1,CW
2020-04-17,0,0,14,1,CW
2020-04-18,0,0,14,1,CW
2020-04-19,0,0,14,1,CW
2020-04-20,0,0,14,1,CW
2020-04-21,0,0,14,1,CW
2020-04-22,0,0,14,1,CW
2020-04-23,0,0,14,1,CW
2020-04-24,2,0,16,1,CW
2020-04-25,0,0,16,1,CW
2020-04-26,0,0,16,1,CW
2020-04-27,0,0,16,1,CW
2020-04-28,0,0,16,1,CW
2020-04-29,0,0,16,1,CW
2020-04-30,0,0,16,1,CW
2020-05-01,0,0,16,1,CW
2020-05-02,0,0,16,1,CW
2020-05-03,0,0,16,1,CW
2020-05-04,0,0,16,1,CW
2020-05-05,0,0,16,1,CW
2020-05-06,0,0,16,1,CW
2020-05-07,0,0,16,1,CW
2020-05-08,0,0,16,1,CW
2020-05-09,0,0,16,1,CW
2020-05-10,0,0,16,1,CW
2020-05-11,0,0,16,1,CW
2020-05-12,0,0,16,1,CW
2020-05-13,0,0,16,1,CW
2020-05-14,0,0,16,1,CW
2020-05-15,0,0,16,1,CW
2020-05-16,0,0,16,1,CW
2020-05-17,0,0,16,1,CW
2020-05-18,0,0,16,1,CW
2020-05-19,0,0,16,1,CW
2020-05-20,0,0,16,1,CW
2020-05-21,0,0,16,1,CW
2020-05-22,0,0,16,1,CW
2020-05-23,0,0,16,1,CW
2020-05-24,1,0,17,1,CW
2020-05-25,1,0,18,1,CW
2020-05-26,0,0,18,1,CW
2020-05-27,0,0,18,1,CW
2020-05-28,1,0,19,1,CW
2020-05-29,0,0,19,1,CW
2020-05-30,0,0,19,1,CW
2020-05-31,0,0,19,1,CW
2020-06-01,1,0,20,1,CW
2020-06-02,0,0,20,1,CW
2020-06-03,0,0,20,1,CW
2020-06-04,1,0,21,1,CW
2020-06-05,0,0,21,1,CW
2020-06-06,0,0,21,1,CW
2020-06-07,0,0,21,1,CW
2020-06-08,0,0,21,1,CW
2020-06-09,0,0,21,1,CW
2020-06-10,0,0,21,1,CW
2020-06-11,1,0,22,1,CW
2020-06-12,0,0,22,1,CW
2020-06-13,0,0,22,1,CW
2020-06-14,0,0,22,1,CW
2020-06-15,0,0,22,1,CW
2020-06-16,0,0,22,1,CW
2020-06-17,1,0,23,1,CW
2020-06-18,0,0,23,1,CW
2020-06-19,0,0,23,1,CW
2020-06-20,0,0,23,1,CW
2020-06-21,0,0,23,1,CW
2020-06-22,0,0,23,1,CW
2020-06-23,1,0,24,1,CW
2020-06-24,0,0,24,1,CW
2020-06-25,0,0,24,1,CW
2020-06-26,0,0,24,1,CW
2020-03-09,2,0,2,0,CY
2020-03-11,4,0,6,0,CY
2020-03-13,8,0,14,0,CY
2020-03-14,7,0,21,0,CY
2020-03-15,9,0,30,0,CY
2020-03-16,10,0,40,0,CY
2020-03-17,0,0,40,0,CY
2020-03-18,18,0,58,0,CY
2020-03-19,0,0,58,0,CY
2020-03-20,9,0,67,0,CY
2020-03-21,17,0,84,0,CY
2020-03-22,11,0,95,0,CY
2020-03-23,21,0,116,0,CY
2020-03-24,8,3,124,3,CY
2020-03-25,8,0,132,3,CY
2020-03-26,14,0,146,3,CY
2020-03-27,16,2,162,5,CY
2020-03-28,17,0,179,5,CY
2020-03-29,35,1,214,6,CY
2020-03-30,16,1,230,7,CY
2020-03-31,32,1,262,8,CY
2020-04-01,58,1,320,9,CY
2020-04-02,36,0,356,9,CY
2020-04-03,40,0,396,9,CY
2020-04-04,30,0,426,9,CY
2020-04-05,20,0,446,9,CY
2020-04-06,19,0,465,9,CY
2020-04-07,29,0,494,9,CY
2020-04-08,32,0,526,9,CY
2020-04-09,38,1,564,10,CY
2020-04-10,31,0,595,10,CY
2020-04-11,21,0,616,10,CY
2020-04-12,17,1,633,11,CY
2020-04-13,29,1,662,12,CY
2020-04-14,33,0,695,12,CY
2020-04-15,20,0,715,12,CY
2020-04-16,20,0,735,12,CY
2020-04-17,0,0,735,12,CY
2020-04-18,26,0,761,12,CY
2020-04-19,6,0,767,12,CY
2020-04-20,5,0,772,12,CY
2020-04-21,12,0,784,12,CY
2020-04-22,6,2,790,14,CY
2020-04-23,5,0,795,14,CY
2020-04-24,9,0,804,14,CY
2020-04-25,6,0,810,14,CY
2020-04-26,7,0,817,14,CY
2020-04-27,5,1,822,15,CY
2020-04-28,15,0,837,15,CY
2020-04-29,6,0,843,15,CY
2020-04-30,7,0,850,15,CY
2020-05-01,7,0,857,15,CY
2020-05-02,7,0,864,15,CY
2020-05-03,8,0,872,15,CY
2020-05-04,2,0,874,15,CY
2020-05-05,4,0,878,15,CY
2020-05-06,5,0,883,15,CY
2020-05-07,6,0,889,15,CY
2020-05-08,2,0,891,15,CY
2020-05-09,1,0,892,15,CY
2020-05-10,6,1,898,16,CY
2020-05-11,3,0,901,16,CY
2020-05-12,2,0,903,16,CY
2020-05-13,2,1,905,17,CY
2020-05-14,2,0,907,17,CY
2020-05-15,3,0,910,17,CY
2020-05-16,4,0,914,17,CY
2020-05-17,2,0,916,17,CY
2020-05-18,1,0,917,17,CY
2020-05-19,1,0,918,17,CY
2020-05-20,4,0,922,17,CY
2020-05-21,1,0,923,17,CY
2020-05-22,4,0,927,17,CY
2020-05-23,0,0,927,17,CY
2020-05-24,8,0,935,17,CY
2020-05-25,2,0,937,17,CY
2020-05-26,2,0,939,17,CY
2020-05-27,0,0,939,17,CY
2020-05-28,2,0,941,17,CY
2020-05-29,0,0,941,17,CY
2020-05-30,2,0,943,17,CY
2020-05-31,1,0,944,17,CY
2020-06-01,5,0,949,17,CY
2020-06-02,3,0,952,17,CY
2020-06-03,6,0,958,17,CY
2020-06-04,0,0,958,17,CY
2020-06-05,2,0,960,17,CY
2020-06-06,0,1,960,18,CY
2020-06-07,4,0,964,18,CY
2020-06-08,6,0,970,18,CY
2020-06-09,2,0,972,18,CY
2020-06-10,2,0,974,18,CY
2020-06-11,1,0,975,18,CY
2020-06-12,5,0,980,18,CY
2020-06-13,0,0,980,18,CY
2020-06-14,3,0,983,18,CY
2020-06-15,2,0,985,18,CY
2020-06-16,0,0,985,18,CY
2020-06-17,0,0,985,18,CY
2020-06-18,0,1,985,19,CY
2020-06-19,0,0,985,19,CY
2020-06-20,0,0,985,19,CY
2020-06-21,1,0,986,19,CY
2020-06-22,2,0,988,19,CY
2020-06-23,2,0,990,19,CY
2020-06-24,1,0,991,19,CY
2020-06-25,1,0,992,19,CY
2020-06-26,0,0,992,19,CY
2019-12-30,0,0,0,0,CZ
2019-12-31,0,0,0,0,CZ
2020-01-01,0,0,0,0,CZ
2020-01-02,0,0,0,0,CZ
2020-01-03,0,0,0,0,CZ
2020-01-04,0,0,0,0,CZ
2020-01-05,0,0,0,0,CZ
2020-01-06,0,0,0,0,CZ
2020-01-07,0,0,0,0,CZ
2020-01-08,0,0,0,0,CZ
2020-01-09,0,0,0,0,CZ
2020-01-10,0,0,0,0,CZ
2020-01-11,0,0,0,0,CZ
2020-01-12,0,0,0,0,CZ
2020-01-13,0,0,0,0,CZ
2020-01-14,0,0,0,0,CZ
2020-01-15,0,0,0,0,CZ
2020-01-16,0,0,0,0,CZ
2020-01-17,0,0,0,0,CZ
2020-01-18,0,0,0,0,CZ
2020-01-19,0,0,0,0,CZ
2020-01-20,0,0,0,0,CZ
2020-01-21,0,0,0,0,CZ
2020-01-22,0,0,0,0,CZ
2020-01-23,0,0,0,0,CZ
2020-01-24,0,0,0,0,CZ
2020-01-25,0,0,0,0,CZ
2020-01-26,0,0,0,0,CZ
2020-01-27,0,0,0,0,CZ
2020-01-28,0,0,0,0,CZ
2020-01-29,0,0,0,0,CZ
2020-01-30,0,0,0,0,CZ
2020-01-31,0,0,0,0,CZ
2020-02-01,0,0,0,0,CZ
2020-02-02,0,0,0,0,CZ
2020-02-03,0,0,0,0,CZ
2020-02-04,0,0,0,0,CZ
2020-02-05,0,0,0,0,CZ
2020-02-06,0,0,0,0,CZ
2020-02-07,0,0,0,0,CZ
2020-02-08,0,0,0,0,CZ
2020-02-09,0,0,0,0,CZ
2020-02-10,0,0,0,0,CZ
2020-02-11,0,0,0,0,CZ
2020-02-12,0,0,0,0,CZ
2020-02-13,0,0,0,0,CZ
2020-02-14,0,0,0,0,CZ
2020-02-15,0,0,0,0,CZ
2020-02-16,0,0,0,0,CZ
2020-02-17,0,0,0,0,CZ
2020-02-18,0,0,0,0,CZ
2020-02-19,0,0,0,0,CZ
2020-02-20,0,0,0,0,CZ
2020-02-21,0,0,0,0,CZ
2020-02-22,0,0,0,0,CZ
2020-02-23,0,0,0,0,CZ
2020-02-24,0,0,0,0,CZ
2020-02-25,0,0,0,0,CZ
2020-02-26,0,0,0,0,CZ
2020-02-27,0,0,0,0,CZ
2020-02-28,0,0,0,0,CZ
2020-02-29,0,0,0,0,CZ
2020-03-01,3,0,3,0,CZ
2020-03-02,2,0,5,0,CZ
2020-03-03,0,0,5,0,CZ
2020-03-04,3,0,8,0,CZ
2020-03-05,4,0,12,0,CZ
2020-03-06,7,0,19,0,CZ
2020-03-07,7,0,26,0,CZ
2020-03-08,6,0,32,0,CZ
2020-03-09,8,0,40,0,CZ
2020-03-10,23,0,63,0,CZ
2020-03-11,31,0,94,0,CZ
2020-03-12,22,0,116,0,CZ
2020-03-13,34,0,150,0,CZ
2020-03-14,64,0,214,0,CZ
2020-03-15,84,0,298,0,CZ
2020-03-16,46,0,344,0,CZ
2020-03-17,90,0,434,0,CZ
2020-03-18,88,0,522,0,CZ
2020-03-19,172,0,694,0,CZ
2020-03-20,210,0,904,0,CZ
2020-03-21,91,0,995,0,CZ
2020-03-22,170,1,1165,1,CZ
2020-03-23,71,0,1236,1,CZ
2020-03-24,158,2,1394,3,CZ
2020-03-25,260,3,1654,6,CZ
2020-03-26,408,3,2062,9,CZ
2020-03-27,217,0,2279,9,CZ
2020-03-28,384,2,2663,11,CZ
2020-03-29,166,5,2829,16,CZ
2020-03-30,173,8,3002,24,CZ
2020-03-31,306,7,3308,31,CZ
2020-04-01,281,8,3589,39,CZ
2020-04-02,269,5,3858,44,CZ
2020-04-03,332,9,4190,53,CZ
2020-04-04,282,6,4472,59,CZ
2020-04-05,115,8,4587,67,CZ
2020-04-06,235,11,4822,78,CZ
2020-04-07,195,10,5017,88,CZ
2020-04-08,295,11,5312,99,CZ
2020-04-09,257,13,5569,112,CZ
2020-04-10,163,7,5732,119,CZ
2020-04-11,170,10,5902,129,CZ
2020-04-12,89,9,5991,138,CZ
2020-04-13,68,5,6059,143,CZ
2020-04-14,82,18,6141,161,CZ
2020-04-15,162,5,6303,166,CZ
2020-04-16,130,3,6433,169,CZ
2020-04-17,116,4,6549,173,CZ
2020-04-18,105,8,6654,181,CZ
2020-04-19,133,7,6787,188,CZ
2020-04-20,127,8,6914,196,CZ
2020-04-21,127,5,7041,201,CZ
2020-04-22,95,9,7136,210,CZ
2020-04-23,52,3,7188,213,CZ
2020-04-24,85,2,7273,215,CZ
2020-04-25,79,3,7352,218,CZ
2020-04-26,52,3,7404,221,CZ
2020-04-27,45,2,7449,223,CZ
2020-04-28,55,4,7504,227,CZ
2020-04-29,75,0,7579,227,CZ
2020-04-30,103,9,7682,236,CZ
2020-05-01,55,4,7737,240,CZ
2020-05-02,18,5,7755,245,CZ
2020-05-03,26,3,7781,248,CZ
2020-05-04,38,4,7819,252,CZ
2020-05-05,77,5,7896,257,CZ
2020-05-06,78,5,7974,262,CZ
2020-05-07,57,8,8031,270,CZ
2020-05-08,46,3,8077,273,CZ
2020-05-09,18,3,8095,276,CZ
2020-05-10,28,4,8123,280,CZ
2020-05-11,53,2,8176,282,CZ
2020-05-12,45,1,8221,283,CZ
2020-05-13,48,7,8269,290,CZ
2020-05-14,82,3,8351,293,CZ
2020-05-15,55,2,8406,295,CZ
2020-05-16,49,1,8455,296,CZ
2020-05-17,20,1,8475,297,CZ
2020-05-18,111,0,8586,297,CZ
2020-05-19,61,5,8647,302,CZ
2020-05-20,74,2,8721,304,CZ
2020-05-21,33,2,8754,306,CZ
2020-05-22,59,6,8813,312,CZ
2020-05-23,77,2,8890,314,CZ
2020-05-24,67,1,8957,315,CZ
2020-05-25,47,2,9004,317,CZ
2020-05-26,46,0,9050,317,CZ
2020-05-27,36,0,9086,317,CZ
2020-05-28,54,2,9140,319,CZ
2020-05-29,56,0,9196,319,CZ
2020-05-30,34,0,9230,319,CZ
2020-05-31,43,1,9273,320,CZ
2020-06-01,29,1,9302,321,CZ
2020-06-02,62,2,9364,323,CZ
2020-06-03,74,1,9438,324,CZ
2020-06-04,56,2,9494,326,CZ
2020-06-05,35,1,9529,327,CZ
2020-06-06,38,0,9567,327,CZ
2020-06-07,61,0,9628,327,CZ
2020-06-08,69,1,9697,328,CZ
2020-06-09,54,0,9751,328,CZ
2020-06-10,73,0,9824,328,CZ
2020-06-11,62,1,9886,329,CZ
2020-06-12,52,0,9938,329,CZ
2020-06-13,53,0,9991,329,CZ
2020-06-14,33,0,10024,329,CZ
2020-06-15,40,1,10064,330,CZ
2020-06-16,47,1,10111,331,CZ
2020-06-17,51,2,10162,333,CZ
2020-06-18,68,1,10230,334,CZ
2020-06-19,176,1,10406,335,CZ
2020-06-20,42,1,10448,336,CZ
2020-06-21,50,0,10498,336,CZ
2020-06-22,63,0,10561,336,CZ
2020-06-23,89,3,10650,339,CZ
2020-06-24,127,4,10777,343,CZ
2020-06-25,93,2,10870,345,CZ
2020-06-26,168,4,11038,349,CZ
2019-12-30,0,0,0,0,DE
2019-12-31,0,0,0,0,DE
2020-01-01,0,0,0,0,DE
2020-01-02,0,0,0,0,DE
2020-01-03,0,0,0,0,DE
2020-01-04,0,0,0,0,DE
2020-01-05,0,0,0,0,DE
2020-01-06,0,0,0,0,DE
2020-01-07,0,0,0,0,DE
2020-01-08,0,0,0,0,DE
2020-01-09,0,0,0,0,DE
2020-01-10,0,0,0,0,DE
2020-01-11,0,0,0,0,DE
2020-01-12,0,0,0,0,DE
2020-01-13,0,0,0,0,DE
2020-01-14,0,0,0,0,DE
2020-01-15,0,0,0,0,DE
2020-01-16,0,0,0,0,DE
2020-01-17,0,0,0,0,DE
2020-01-18,0,0,0,0,DE
2020-01-19,0,0,0,0,DE
2020-01-20,0,0,0,0,DE
2020-01-21,0,0,0,0,DE
2020-01-22,0,0,0,0,DE
2020-01-23,0,0,0,0,DE
2020-01-24,0,0,0,0,DE
2020-01-25,0,0,0,0,DE
2020-01-26,0,0,0,0,DE
2020-01-27,1,0,1,0,DE
2020-01-28,3,0,4,0,DE
2020-01-29,0,0,4,0,DE
2020-01-30,1,0,5,0,DE
2020-01-31,2,0,7,0,DE
2020-02-01,1,0,8,0,DE
2020-02-02,1,0,9,0,DE
2020-02-03,2,0,11,0,DE
2020-02-04,0,0,11,0,DE
2020-02-05,0,0,11,0,DE
2020-02-06,1,0,12,0,DE
2020-02-07,1,0,13,0,DE
2020-02-08,0,0,13,0,DE
2020-02-09,0,0,13,0,DE
2020-02-10,0,0,13,0,DE
2020-02-11,2,0,15,0,DE
2020-02-12,0,0,15,0,DE
2020-02-13,0,0,15,0,DE
2020-02-14,0,0,15,0,DE
2020-02-15,0,0,15,0,DE
2020-02-16,0,0,15,0,DE
2020-02-17,0,0,15,0,DE
2020-02-18,0,0,15,0,DE
2020-02-19,0,0,15,0,DE
2020-02-20,0,0,15,0,DE
2020-02-21,0,0,15,0,DE
2020-02-22,0,0,15,0,DE
2020-02-23,0,0,15,0,DE
2020-02-24,0,0,15,0,DE
2020-02-25,2,0,17,0,DE
2020-02-26,4,0,21,0,DE
2020-02-27,26,0,47,0,DE
2020-02-28,10,0,57,0,DE
2020-02-29,54,0,111,0,DE
2020-03-01,18,0,129,0,DE
2020-03-02,28,0,157,0,DE
2020-03-03,39,0,196,0,DE
2020-03-04,66,0,262,0,DE
2020-03-05,138,0,400,0,DE
2020-03-06,284,0,684,0,DE
2020-03-07,163,0,847,0,DE
2020-03-08,55,0,902,0,DE
2020-03-09,237,2,1139,2,DE
2020-03-10,157,0,1296,2,DE
2020-03-11,271,1,1567,3,DE
2020-03-12,802,2,2369,5,DE
2020-03-13,693,0,3062,5,DE
2020-03-14,733,3,3795,8,DE
2020-03-15,1043,4,4838,12,DE
2020-03-16,1174,1,6012,13,DE
2020-03-17,1144,0,7156,13,DE
2020-03-18,1042,0,8198,13,DE
2020-03-19,5940,30,14138,43,DE
2020-03-20,4049,2,18187,45,DE
2020-03-21,3276,22,21463,67,DE
2020-03-22,3311,27,24774,94,DE
2020-03-23,4438,32,29212,126,DE
2020-03-24,2342,23,31554,149,DE
2020-03-25,4954,49,36508,198,DE
2020-03-26,5780,55,42288,253,DE
2020-03-27,6294,72,48582,325,DE
2020-03-28,3965,64,52547,389,DE
2020-03-29,4751,66,57298,455,DE
2020-03-30,4615,128,61913,583,DE
2020-03-31,5453,149,67366,732,DE
2020-04-01,6156,140,73522,872,DE
2020-04-02,6174,145,79696,1017,DE
2020-04-03,6082,141,85778,1158,DE
2020-04-04,5936,184,91714,1342,DE
2020-04-05,3677,92,95391,1434,DE
2020-04-06,3834,173,99225,1607,DE
2020-04-07,4003,254,103228,1861,DE
2020-04-08,4974,246,108202,2107,DE
2020-04-09,5323,266,113525,2373,DE
2020-04-10,4133,171,117658,2544,DE
2020-04-11,2821,129,120479,2673,DE
2020-04-12,2537,126,123016,2799,DE
2020-04-13,2082,170,125098,2969,DE
2020-04-14,2486,285,127584,3254,DE
2020-04-15,2866,315,130450,3569,DE
2020-04-16,3380,299,133830,3868,DE
2020-04-17,3609,242,137439,4110,DE
2020-04-18,2458,184,139897,4294,DE
2020-04-19,1775,110,141672,4404,DE
2020-04-20,1785,194,143457,4598,DE
2020-04-21,2237,281,145694,4879,DE
2020-04-22,2352,215,148046,5094,DE
2020-04-23,2337,227,150383,5321,DE
2020-04-24,2055,179,152438,5500,DE
2020-04-25,1737,140,154175,5640,DE
2020-04-26,1018,110,155193,5750,DE
2020-04-27,1144,163,156337,5913,DE
2020-04-28,1304,202,157641,6115,DE
2020-04-29,1478,173,159119,6288,DE
2020-04-30,0,0,159119,6288,DE
2020-05-01,2584,287,161703,6575,DE
2020-05-02,793,74,162496,6649,DE
2020-05-03,679,43,163175,6692,DE
2020-05-04,685,139,163860,6831,DE
2020-05-05,1037,165,164897,6996,DE
2020-05-06,1194,123,166091,7119,DE
2020-05-07,1209,147,167300,7266,DE
2020-05-08,1251,103,168551,7369,DE
2020-05-09,667,26,169218,7395,DE
2020-05-10,357,22,169575,7417,DE
2020-05-11,933,116,170508,7533,DE
2020-05-12,798,101,171306,7634,DE
2020-05-13,933,89,172239,7723,DE
2020-05-14,913,101,173152,7824,DE
2020-05-15,620,57,173772,7881,DE
2020-05-16,583,33,174355,7914,DE
2020-05-17,342,21,174697,7935,DE
2020-05-18,513,72,175210,8007,DE
2020-05-19,797,83,176007,8090,DE
2020-05-20,745,57,176752,8147,DE
2020-05-21,460,27,177212,8174,DE
2020-05-22,638,42,177850,8216,DE
2020-05-23,431,31,178281,8247,DE
2020-05-24,289,10,178570,8257,DE
2020-05-25,432,45,179002,8302,DE
2020-05-26,362,47,179364,8349,DE
2020-05-27,353,62,179717,8411,DE
2020-05-28,741,39,180458,8450,DE
2020-05-29,738,39,181196,8489,DE
2020-05-30,286,11,181482,8500,DE
2020-05-31,333,11,181815,8511,DE
2020-06-01,213,11,182028,8522,DE
2020-06-02,342,29,182370,8551,DE
2020-06-03,394,30,182764,8581,DE
2020-06-04,507,32,183271,8613,DE
2020-06-05,407,33,183678,8646,DE
2020-06-06,301,22,183979,8668,DE
2020-06-07,214,6,184193,8674,DE
2020-06-08,350,37,184543,8711,DE
2020-06-09,318,18,184861,8729,DE
2020-06-10,555,26,185416,8755,DE
2020-06-11,258,8,185674,8763,DE
2020-06-12,348,18,186022,8781,DE
2020-06-13,247,6,186269,8787,DE
2020-06-14,192,4,186461,8791,DE
2020-06-15,378,9,186839,8800,DE
2020-06-16,345,30,187184,8830,DE
2020-06-17,580,26,187764,8856,DE
2020-06-18,770,16,188534,8872,DE
2020-06-19,601,10,189135,8882,DE
2020-06-20,687,0,189822,8882,DE
2020-06-21,537,3,190359,8885,DE
2020-06-22,503,10,190862,8895,DE
2020-06-23,587,19,191449,8914,DE
2020-06-24,630,13,192079,8927,DE
2020-06-25,477,21,192556,8948,DE
2020-06-26,687,6,193243,8954,DE
2020-03-18,1,0,1,0,DJ
2020-03-19,0,0,1,0,DJ
2020-03-20,0,0,1,0,DJ
2020-03-21,0,0,1,0,DJ
2020-03-22,0,0,1,0,DJ
2020-03-23,2,0,3,0,DJ
2020-03-24,0,0,3,0,DJ
2020-03-25,9,0,12,0,DJ
2020-03-26,0,0,12,0,DJ
2020-03-27,1,0,13,0,DJ
2020-03-28,2,0,15,0,DJ
2020-03-29,4,0,19,0,DJ
2020-03-30,7,0,26,0,DJ
2020-03-31,5,0,31,0,DJ
2020-04-01,3,0,34,0,DJ
2020-04-02,7,0,41,0,DJ
2020-04-03,0,0,41,0,DJ
2020-04-04,10,0,51,0,DJ
2020-04-05,8,0,59,0,DJ
2020-04-06,31,0,90,0,DJ
2020-04-07,31,0,121,0,DJ
2020-04-08,14,0,135,0,DJ
2020-04-09,5,1,140,1,DJ
2020-04-10,10,0,150,1,DJ
2020-04-11,37,1,187,2,DJ
2020-04-12,27,0,214,2,DJ
2020-04-13,84,0,298,2,DJ
2020-04-14,65,0,363,2,DJ
2020-04-15,72,0,435,2,DJ
2020-04-16,156,0,591,2,DJ
2020-04-17,141,0,732,2,DJ
2020-04-18,0,0,732,2,DJ
2020-04-19,114,0,846,2,DJ
2020-04-20,0,0,846,2,DJ
2020-04-21,99,0,945,2,DJ
2020-04-22,29,0,974,2,DJ
2020-04-23,12,0,986,2,DJ
2020-04-24,13,0,999,2,DJ
2020-04-25,9,0,1008,2,DJ
2020-04-26,15,0,1023,2,DJ
2020-04-27,12,0,1035,2,DJ
2020-04-28,37,0,1072,2,DJ
2020-04-29,5,0,1077,2,DJ
2020-04-30,12,0,1089,2,DJ
2020-05-01,8,0,1097,2,DJ
2020-05-02,15,0,1112,2,DJ
2020-05-03,0,0,1112,2,DJ
2020-05-04,4,0,1116,2,DJ
2020-05-05,4,0,1120,2,DJ
2020-05-06,0,1,1120,3,DJ
2020-05-07,13,0,1133,3,DJ
2020-05-08,2,0,1135,3,DJ
2020-05-09,54,0,1189,3,DJ
2020-05-10,21,0,1210,3,DJ
2020-05-11,17,0,1227,3,DJ
2020-05-12,29,0,1256,3,DJ
2020-05-13,12,0,1268,3,DJ
2020-05-14,16,0,1284,3,DJ
2020-05-15,25,1,1309,4,DJ
2020-05-16,22,0,1331,4,DJ
2020-05-17,70,0,1401,4,DJ
2020-05-18,117,3,1518,7,DJ
2020-05-19,0,0,1518,7,DJ
2020-05-20,310,2,1828,9,DJ
2020-05-21,219,1,2047,10,DJ
2020-05-22,223,0,2270,10,DJ
2020-05-23,0,0,2270,10,DJ
2020-05-24,0,0,2270,10,DJ
2020-05-25,198,4,2468,14,DJ
2020-05-26,0,0,2468,14,DJ
2020-05-27,229,4,2697,18,DJ
2020-05-28,217,2,2914,20,DJ
2020-05-29,0,0,2914,20,DJ
2020-05-30,280,2,3194,22,DJ
2020-05-31,160,2,3354,24,DJ
2020-06-01,215,0,3569,24,DJ
2020-06-02,210,1,3779,25,DJ
2020-06-03,156,1,3935,26,DJ
2020-06-04,119,0,4054,26,DJ
2020-06-05,69,0,4123,26,DJ
2020-06-06,46,0,4169,26,DJ
2020-06-07,38,2,4207,28,DJ
2020-06-08,71,3,4278,31,DJ
2020-06-09,53,3,4331,34,DJ
2020-06-10,42,0,4373,34,DJ
2020-06-11,25,3,4398,37,DJ
2020-06-12,43,1,4441,38,DJ
2020-06-13,8,3,4449,41,DJ
2020-06-14,16,2,4465,43,DJ
2020-06-15,36,0,4501,43,DJ
2020-06-16,38,0,4539,43,DJ
2020-06-17,6,0,4545,43,DJ
2020-06-18,12,0,4557,43,DJ
2020-06-19,8,2,4565,45,DJ
2020-06-20,0,0,4565,45,DJ
2020-06-21,17,0,4582,45,DJ
2020-06-22,17,3,4599,48,DJ
2020-06-23,18,1,4617,49,DJ
2020-06-24,13,3,4630,52,DJ
2020-06-25,5,0,4635,52,DJ
2020-06-26,8,0,4643,52,DJ
2019-12-30,0,0,0,0,DK
2019-12-31,0,0,0,0,DK
2020-01-01,0,0,0,0,DK
2020-01-02,0,0,0,0,DK
2020-01-03,0,0,0,0,DK
2020-01-04,0,0,0,0,DK
2020-01-05,0,0,0,0,DK
2020-01-06,0,0,0,0,DK
2020-01-07,0,0,0,0,DK
2020-01-08,0,0,0,0,DK
2020-01-09,0,0,0,0,DK
2020-01-10,0,0,0,0,DK
2020-01-11,0,0,0,0,DK
2020-01-12,0,0,0,0,DK
2020-01-13,0,0,0,0,DK
2020-01-14,0,0,0,0,DK
2020-01-15,0,0,0,0,DK
2020-01-16,0,0,0,0,DK
2020-01-17,0,0,0,0,DK
2020-01-18,0,0,0,0,DK
2020-01-19,0,0,0,0,DK
2020-01-20,0,0,0,0,DK
2020-01-21,0,0,0,0,DK
2020-01-22,0,0,0,0,DK
2020-01-23,0,0,0,0,DK
2020-01-24,0,0,0,0,DK
2020-01-25,0,0,0,0,DK
2020-01-26,0,0,0,0,DK
2020-01-27,0,0,0,0,DK
2020-01-28,0,0,0,0,DK
2020-01-29,0,0,0,0,DK
2020-01-30,0,0,0,0,DK
2020-01-31,0,0,0,0,DK
2020-02-01,0,0,0,0,DK
2020-02-02,0,0,0,0,DK
2020-02-03,0,0,0,0,DK
2020-02-04,0,0,0,0,DK
2020-02-05,0,0,0,0,DK
2020-02-06,0,0,0,0,DK
2020-02-07,0,0,0,0,DK
2020-02-08,0,0,0,0,DK
2020-02-09,0,0,0,0,DK
2020-02-10,0,0,0,0,DK
2020-02-11,0,0,0,0,DK
2020-02-12,0,0,0,0,DK
2020-02-13,0,0,0,0,DK
2020-02-14,0,0,0,0,DK
2020-02-15,0,0,0,0,DK
2020-02-16,0,0,0,0,DK
2020-02-17,0,0,0,0,DK
2020-02-18,0,0,0,0,DK
2020-02-19,0,0,0,0,DK
2020-02-20,0,0,0,0,DK
2020-02-21,0,0,0,0,DK
2020-02-22,0,0,0,0,DK
2020-02-23,0,0,0,0,DK
2020-02-24,0,0,0,0,DK
2020-02-25,0,0,0,0,DK
2020-02-26,1,0,1,0,DK
2020-02-27,0,0,1,0,DK
2020-02-28,1,0,2,0,DK
2020-02-29,1,0,3,0,DK
2020-03-01,1,0,4,0,DK
2020-03-02,1,0,5,0,DK
2020-03-03,3,0,8,0,DK
2020-03-04,2,0,10,0,DK
2020-03-05,10,0,20,0,DK
2020-03-06,3,0,23,0,DK
2020-03-07,8,0,31,0,DK
2020-03-08,7,0,38,0,DK
2020-03-09,75,0,113,0,DK
2020-03-10,151,0,264,0,DK
2020-03-11,252,0,516,0,DK
2020-03-12,160,0,676,0,DK
2020-03-13,128,0,804,0,DK
2020-03-14,23,0,827,0,DK
2020-03-15,48,1,875,1,DK
2020-03-16,57,0,932,1,DK
2020-03-17,92,3,1024,4,DK
2020-03-18,91,0,1115,4,DK
2020-03-19,36,2,1151,6,DK
2020-03-20,104,3,1255,9,DK
2020-03-21,71,4,1326,13,DK
2020-03-22,69,0,1395,13,DK
2020-03-23,65,11,1460,24,DK
2020-03-24,131,8,1591,32,DK
2020-03-25,133,2,1724,34,DK
2020-03-26,153,7,1877,41,DK
2020-03-27,169,11,2046,52,DK
2020-03-28,155,13,2201,65,DK
2020-03-29,194,7,2395,72,DK
2020-03-30,182,5,2577,77,DK
2020-03-31,283,13,2860,90,DK
2020-04-01,247,14,3107,104,DK
2020-04-02,279,19,3386,123,DK
2020-04-03,371,16,3757,139,DK
2020-04-04,320,22,4077,161,DK
2020-04-05,292,18,4369,179,DK
2020-04-06,312,8,4681,187,DK
2020-04-07,390,16,5071,203,DK
2020-04-08,331,15,5402,218,DK
2020-04-09,233,19,5635,237,DK
2020-04-10,184,10,5819,247,DK
2020-04-11,177,13,5996,260,DK
2020-04-12,178,13,6174,273,DK
2020-04-13,144,12,6318,285,DK
2020-04-14,193,14,6511,299,DK
2020-04-15,170,10,6681,309,DK
2020-04-16,198,12,6879,321,DK
2020-04-17,194,15,7073,336,DK
2020-04-18,169,10,7242,346,DK
2020-04-19,142,9,7384,355,DK
2020-04-20,131,9,7515,364,DK
2020-04-21,180,6,7695,370,DK
2020-04-22,217,14,7912,384,DK
2020-04-23,161,10,8073,394,DK
2020-04-24,137,9,8210,403,DK
2020-04-25,235,15,8445,418,DK
2020-04-26,130,4,8575,422,DK
2020-04-27,123,5,8698,427,DK
2020-04-28,153,7,8851,434,DK
2020-04-29,157,9,9008,443,DK
2020-04-30,150,9,9158,452,DK
2020-05-01,153,10,9311,462,DK
2020-05-02,96,11,9407,473,DK
2020-05-03,116,8,9523,481,DK
2020-05-04,147,9,9670,490,DK
2020-05-05,151,7,9821,497,DK
2020-05-06,162,3,9983,500,DK
2020-05-07,100,6,10083,506,DK
2020-05-08,135,6,10218,512,DK
2020-05-09,101,4,10319,516,DK
2020-05-10,110,3,10429,519,DK
2020-05-11,84,5,10513,524,DK
2020-05-12,78,4,10591,528,DK
2020-05-13,76,6,10667,534,DK
2020-05-14,46,4,10713,538,DK
2020-05-15,78,0,10791,538,DK
2020-05-16,67,5,10858,543,DK
2020-05-17,69,4,10927,547,DK
2020-05-18,41,1,10968,548,DK
2020-05-19,76,3,11044,551,DK
2020-05-20,73,3,11117,554,DK
2020-05-21,65,7,11182,561,DK
2020-05-22,48,0,11230,561,DK
2020-05-23,59,0,11289,561,DK
2020-05-24,71,1,11360,562,DK
2020-05-25,27,1,11387,563,DK
2020-05-26,41,0,11428,563,DK
2020-05-27,52,2,11480,565,DK
2020-05-28,32,3,11512,568,DK
2020-05-29,81,0,11593,568,DK
2020-05-30,40,3,11633,571,DK
2020-05-31,36,3,11669,574,DK
2020-06-01,30,2,11699,576,DK
2020-06-02,35,4,11734,580,DK
2020-06-03,37,0,11771,580,DK
2020-06-04,40,2,11811,582,DK
2020-06-05,64,4,11875,586,DK
2020-06-06,49,1,11924,587,DK
2020-06-07,24,2,11948,589,DK
2020-06-08,14,4,11962,593,DK
2020-06-09,39,0,12001,593,DK
2020-06-10,15,0,12016,593,DK
2020-06-11,19,0,12035,593,DK
2020-06-12,64,1,12099,594,DK
2020-06-13,40,3,12139,597,DK
2020-06-14,54,0,12193,597,DK
2020-06-15,24,1,12217,598,DK
2020-06-16,33,0,12250,598,DK
2020-06-17,44,0,12294,598,DK
2020-06-18,50,2,12344,600,DK
2020-06-19,47,0,12391,600,DK
2020-06-20,0,0,12391,600,DK
2020-06-21,0,0,12391,600,DK
2020-06-22,136,2,12527,602,DK
2020-06-23,34,1,12561,603,DK
2020-06-24,54,0,12615,603,DK
2020-06-25,21,0,12636,603,DK
2020-06-26,39,1,12675,604,DK
2020-03-22,1,0,1,0,DM
2020-03-23,0,0,1,0,DM
2020-03-24,1,0,2,0,DM
2020-03-25,5,0,7,0,DM
2020-03-26,4,0,11,0,DM
2020-03-27,0,0,11,0,DM
2020-03-28,0,0,11,0,DM
2020-03-29,0,0,11,0,DM
2020-03-30,0,0,11,0,DM
2020-03-31,0,0,11,0,DM
2020-04-01,1,0,12,0,DM
2020-04-02,0,0,12,0,DM
2020-04-03,2,0,14,0,DM
2020-04-04,0,0,14,0,DM
2020-04-05,0,0,14,0,DM
2020-04-06,1,0,15,0,DM
2020-04-07,0,0,15,0,DM
2020-04-08,0,0,15,0,DM
2020-04-09,1,0,16,0,DM
2020-04-10,0,0,16,0,DM
2020-04-11,0,0,16,0,DM
2020-04-12,0,0,16,0,DM
2020-04-13,0,0,16,0,DM
2020-04-14,0,0,16,0,DM
2020-04-15,0,0,16,0,DM
2020-04-16,0,0,16,0,DM
2020-04-17,0,0,16,0,DM
2020-04-18,0,0,16,0,DM
2020-04-19,0,0,16,0,DM
2020-04-20,0,0,16,0,DM
2020-04-21,0,0,16,0,DM
2020-04-22,0,0,16,0,DM
2020-04-23,0,0,16,0,DM
2020-04-24,0,0,16,0,DM
2020-04-25,0,0,16,0,DM
2020-04-26,0,0,16,0,DM
2020-04-27,0,0,16,0,DM
2020-04-28,0,0,16,0,DM
2020-04-29,0,0,16,0,DM
2020-04-30,0,0,16,0,DM
2020-05-01,0,0,16,0,DM
2020-05-02,0,0,16,0,DM
2020-05-03,0,0,16,0,DM
2020-05-04,0,0,16,0,DM
2020-05-05,0,0,16,0,DM
2020-05-06,0,0,16,0,DM
2020-05-07,0,0,16,0,DM
2020-05-08,0,0,16,0,DM
2020-05-09,0,0,16,0,DM
2020-05-10,0,0,16,0,DM
2020-05-11,0,0,16,0,DM
2020-05-12,0,0,16,0,DM
2020-05-13,0,0,16,0,DM
2020-05-14,0,0,16,0,DM
2020-05-15,0,0,16,0,DM
2020-05-16,0,0,16,0,DM
2020-05-17,0,0,16,0,DM
2020-05-18,0,0,16,0,DM
2020-05-19,0,0,16,0,DM
2020-05-20,0,0,16,0,DM
2020-05-21,0,0,16,0,DM
2020-05-22,0,0,16,0,DM
2020-05-23,0,0,16,0,DM
2020-05-24,0,0,16,0,DM
2020-05-25,0,0,16,0,DM
2020-05-26,0,0,16,0,DM
2020-05-27,0,0,16,0,DM
2020-05-28,0,0,16,0,DM
2020-05-29,0,0,16,0,DM
2020-05-30,0,0,16,0,DM
2020-05-31,0,0,16,0,DM
2020-06-01,2,0,18,0,DM
2020-06-02,0,0,18,0,DM
2020-06-03,0,0,18,0,DM
2020-06-04,0,0,18,0,DM
2020-06-05,0,0,18,0,DM
2020-06-06,0,0,18,0,DM
2020-06-07,0,0,18,0,DM
2020-06-08,0,0,18,0,DM
2020-06-09,0,0,18,0,DM
2020-06-10,0,0,18,0,DM
2020-06-11,0,0,18,0,DM
2020-06-12,0,0,18,0,DM
2020-06-13,0,0,18,0,DM
2020-06-14,0,0,18,0,DM
2020-06-15,0,0,18,0,DM
2020-06-16,0,0,18,0,DM
2020-06-17,0,0,18,0,DM
2020-06-18,0,0,18,0,DM
2020-06-19,0,0,18,0,DM
2020-06-20,0,0,18,0,DM
2020-06-21,0,0,18,0,DM
2020-06-22,0,0,18,0,DM
2020-06-23,0,0,18,0,DM
2020-06-24,0,0,18,0,DM
2020-06-25,0,0,18,0,DM
2020-06-26,0,0,18,0,DM
2019-12-30,0,0,0,0,DO
2019-12-31,0,0,0,0,DO
2020-01-01,0,0,0,0,DO
2020-01-02,0,0,0,0,DO
2020-01-03,0,0,0,0,DO
2020-01-04,0,0,0,0,DO
2020-01-05,0,0,0,0,DO
2020-01-06,0,0,0,0,DO
2020-01-07,0,0,0,0,DO
2020-01-08,0,0,0,0,DO
2020-01-09,0,0,0,0,DO
2020-01-10,0,0,0,0,DO
2020-01-11,0,0,0,0,DO
2020-01-12,0,0,0,0,DO
2020-01-13,0,0,0,0,DO
2020-01-14,0,0,0,0,DO
2020-01-15,0,0,0,0,DO
2020-01-16,0,0,0,0,DO
2020-01-17,0,0,0,0,DO
2020-01-18,0,0,0,0,DO
2020-01-19,0,0,0,0,DO
2020-01-20,0,0,0,0,DO
2020-01-21,0,0,0,0,DO
2020-01-22,0,0,0,0,DO
2020-01-23,0,0,0,0,DO
2020-01-24,0,0,0,0,DO
2020-01-25,0,0,0,0,DO
2020-01-26,0,0,0,0,DO
2020-01-27,0,0,0,0,DO
2020-01-28,0,0,0,0,DO
2020-01-29,0,0,0,0,DO
2020-01-30,0,0,0,0,DO
2020-01-31,0,0,0,0,DO
2020-02-01,0,0,0,0,DO
2020-02-02,0,0,0,0,DO
2020-02-03,0,0,0,0,DO
2020-02-04,0,0,0,0,DO
2020-02-05,0,0,0,0,DO
2020-02-06,0,0,0,0,DO
2020-02-07,0,0,0,0,DO
2020-02-08,0,0,0,0,DO
2020-02-09,0,0,0,0,DO
2020-02-10,0,0,0,0,DO
2020-02-11,0,0,0,0,DO
2020-02-12,0,0,0,0,DO
2020-02-13,0,0,0,0,DO
2020-02-14,0,0,0,0,DO
2020-02-15,0,0,0,0,DO
2020-02-16,0,0,0,0,DO
2020-02-17,0,0,0,0,DO
2020-02-18,0,0,0,0,DO
2020-02-19,0,0,0,0,DO
2020-02-20,0,0,0,0,DO
2020-02-21,0,0,0,0,DO
2020-02-22,0,0,0,0,DO
2020-02-23,0,0,0,0,DO
2020-02-24,0,0,0,0,DO
2020-02-25,0,0,0,0,DO
2020-02-26,0,0,0,0,DO
2020-02-27,0,0,0,0,DO
2020-02-28,0,0,0,0,DO
2020-02-29,0,0,0,0,DO
2020-03-01,1,0,1,0,DO
2020-03-06,1,0,2,0,DO
2020-03-09,3,0,5,0,DO
2020-03-13,6,0,11,0,DO
2020-03-14,0,0,11,0,DO
2020-03-15,0,0,11,0,DO
2020-03-16,0,0,11,0,DO
2020-03-17,0,0,11,0,DO
2020-03-18,10,0,21,0,DO
2020-03-19,0,0,21,0,DO
2020-03-20,13,2,34,2,DO
2020-03-21,78,1,112,3,DO
2020-03-22,90,0,202,3,DO
2020-03-23,43,0,245,3,DO
2020-03-24,67,3,312,6,DO
2020-03-25,80,4,392,10,DO
2020-03-26,96,0,488,10,DO
2020-03-27,93,10,581,20,DO
2020-03-28,138,8,719,28,DO
2020-03-29,140,11,859,39,DO
2020-03-30,42,3,901,42,DO
2020-03-31,208,9,1109,51,DO
2020-04-01,175,6,1284,57,DO
2020-04-02,96,3,1380,60,DO
2020-04-03,108,8,1488,68,DO
2020-04-04,90,9,1578,77,DO
2020-04-05,167,5,1745,82,DO
2020-04-06,83,4,1828,86,DO
2020-04-07,128,12,1956,98,DO
2020-04-08,155,10,2111,108,DO
2020-04-09,238,10,2349,118,DO
2020-04-10,271,8,2620,126,DO
2020-04-11,139,9,2759,135,DO
2020-04-12,208,38,2967,173,DO
2020-04-13,200,4,3167,177,DO
2020-04-14,119,6,3286,183,DO
2020-04-15,328,6,3614,189,DO
2020-04-16,141,7,3755,196,DO
2020-04-17,371,4,4126,200,DO
2020-04-18,209,17,4335,217,DO
2020-04-19,345,9,4680,226,DO
2020-04-20,284,9,4964,235,DO
2020-04-21,80,10,5044,245,DO
2020-04-22,256,15,5300,260,DO
2020-04-23,243,5,5543,265,DO
2020-04-24,206,2,5749,267,DO
2020-04-25,177,6,5926,273,DO
2020-04-26,209,5,6135,278,DO
2020-04-27,0,0,6135,278,DO
2020-04-28,281,8,6416,286,DO
2020-04-29,236,7,6652,293,DO
2020-04-30,320,8,6972,301,DO
2020-05-01,316,12,7288,313,DO
2020-05-02,290,13,7578,326,DO
2020-05-03,376,7,7954,333,DO
2020-05-04,281,13,8235,346,DO
2020-05-05,245,8,8480,354,DO
2020-05-06,327,8,8807,362,DO
2020-05-07,288,11,9095,373,DO
2020-05-08,281,7,9376,380,DO
2020-05-09,506,5,9882,385,DO
2020-05-10,465,3,10347,388,DO
2020-05-11,287,5,10634,393,DO
2020-05-12,266,9,10900,402,DO
2020-05-13,296,7,11196,409,DO
2020-05-14,124,13,11320,422,DO
2020-05-15,419,2,11739,424,DO
2020-05-16,154,0,11893,424,DO
2020-05-17,421,4,12314,428,DO
2020-05-18,411,6,12725,434,DO
2020-05-19,498,7,13223,441,DO
2020-05-20,254,5,13477,446,DO
2020-05-21,180,2,13657,448,DO
2020-05-22,332,8,13989,456,DO
2020-05-23,433,2,14422,458,DO
2020-05-24,0,0,14422,458,DO
2020-05-25,651,2,15073,460,DO
2020-05-26,191,8,15264,468,DO
2020-05-27,459,6,15723,474,DO
2020-05-28,345,11,16068,485,DO
2020-05-29,463,3,16531,488,DO
2020-05-30,377,10,16908,498,DO
2020-05-31,377,4,17285,502,DO
2020-06-01,287,0,17572,502,DO
2020-06-02,180,13,17752,515,DO
2020-06-03,288,1,18040,516,DO
2020-06-04,279,4,18319,520,DO
2020-06-05,389,5,18708,525,DO
2020-06-06,487,11,19195,536,DO
2020-06-07,405,2,19600,538,DO
2020-06-08,526,1,20126,539,DO
2020-06-09,289,5,20415,544,DO
2020-06-10,393,6,20808,550,DO
2020-06-11,629,11,21437,561,DO
2020-06-12,571,7,22008,568,DO
2020-06-13,564,9,22572,577,DO
2020-06-14,390,15,22962,592,DO
2020-06-15,309,13,23271,605,DO
2020-06-16,415,10,23686,615,DO
2020-06-17,419,18,24105,633,DO
2020-06-18,540,2,24645,635,DO
2020-06-19,423,12,25068,647,DO
2020-06-20,710,8,25778,655,DO
2020-06-21,899,7,26677,662,DO
2020-06-22,693,7,27370,669,DO
2020-06-23,566,6,27936,675,DO
2020-06-24,695,16,28631,691,DO
2020-06-25,510,7,29141,698,DO
2020-06-26,623,14,29764,712,DO
2019-12-30,0,0,0,0,DZ
2019-12-31,0,0,0,0,DZ
2020-01-01,0,0,0,0,DZ
2020-01-02,0,0,0,0,DZ
2020-01-03,0,0,0,0,DZ
2020-01-04,0,0,0,0,DZ
2020-01-05,0,0,0,0,DZ
2020-01-06,0,0,0,0,DZ
2020-01-07,0,0,0,0,DZ
2020-01-08,0,0,0,0,DZ
2020-01-09,0,0,0,0,DZ
2020-01-10,0,0,0,0,DZ
2020-01-11,0,0,0,0,DZ
2020-01-12,0,0,0,0,DZ
2020-01-13,0,0,0,0,DZ
2020-01-14,0,0,0,0,DZ
2020-01-15,0,0,0,0,DZ
2020-01-16,0,0,0,0,DZ
2020-01-17,0,0,0,0,DZ
2020-01-18,0,0,0,0,DZ
2020-01-19,0,0,0,0,DZ
2020-01-20,0,0,0,0,DZ
2020-01-21,0,0,0,0,DZ
2020-01-22,0,0,0,0,DZ
2020-01-23,0,0,0,0,DZ
2020-01-24,0,0,0,0,DZ
2020-01-25,0,0,0,0,DZ
2020-01-26,0,0,0,0,DZ
2020-01-27,0,0,0,0,DZ
2020-01-28,0,0,0,0,DZ
2020-01-29,0,0,0,0,DZ
2020-01-30,0,0,0,0,DZ
2020-01-31,0,0,0,0,DZ
2020-02-01,0,0,0,0,DZ
2020-02-02,0,0,0,0,DZ
2020-02-03,0,0,0,0,DZ
2020-02-04,0,0,0,0,DZ
2020-02-05,0,0,0,0,DZ
2020-02-06,0,0,0,0,DZ
2020-02-07,0,0,0,0,DZ
2020-02-08,0,0,0,0,DZ
2020-02-09,0,0,0,0,DZ
2020-02-10,0,0,0,0,DZ
2020-02-11,0,0,0,0,DZ
2020-02-12,0,0,0,0,DZ
2020-02-13,0,0,0,0,DZ
2020-02-14,0,0,0,0,DZ
2020-02-15,0,0,0,0,DZ
2020-02-16,0,0,0,0,DZ
2020-02-17,0,0,0,0,DZ
2020-02-18,0,0,0,0,DZ
2020-02-19,0,0,0,0,DZ
2020-02-20,0,0,0,0,DZ
2020-02-21,0,0,0,0,DZ
2020-02-22,0,0,0,0,DZ
2020-02-23,0,0,0,0,DZ
2020-02-24,0,0,0,0,DZ
2020-02-25,1,0,1,0,DZ
2020-02-26,0,0,1,0,DZ
2020-02-27,0,0,1,0,DZ
2020-02-28,0,0,1,0,DZ
2020-02-29,2,0,3,0,DZ
2020-03-01,0,0,3,0,DZ
2020-03-03,2,0,5,0,DZ
2020-03-04,7,0,12,0,DZ
2020-03-05,5,0,17,0,DZ
2020-03-08,3,0,20,0,DZ
2020-03-11,0,0,20,0,DZ
2020-03-12,5,1,25,1,DZ
2020-03-13,1,1,26,2,DZ
2020-03-14,11,0,37,2,DZ
2020-03-15,11,2,48,4,DZ
2020-03-16,10,0,58,4,DZ
2020-03-17,2,1,60,5,DZ
2020-03-18,12,1,72,6,DZ
2020-03-19,18,1,90,7,DZ
2020-03-20,12,3,102,10,DZ
2020-03-21,37,5,139,15,DZ
2020-03-22,62,2,201,17,DZ
2020-03-23,29,0,230,17,DZ
2020-03-24,34,2,264,19,DZ
2020-03-25,38,2,302,21,DZ
2020-03-26,65,4,367,25,DZ
2020-03-27,42,1,409,26,DZ
2020-03-28,45,3,454,29,DZ
2020-03-29,57,2,511,31,DZ
2020-03-30,73,4,584,35,DZ
2020-03-31,132,9,716,44,DZ
2020-04-01,131,14,847,58,DZ
2020-04-02,139,5,986,63,DZ
2020-04-03,185,42,1171,105,DZ
2020-04-04,80,25,1251,130,DZ
2020-04-05,69,22,1320,152,DZ
2020-04-06,103,21,1423,173,DZ
2020-04-07,45,20,1468,193,DZ
2020-04-08,104,12,1572,205,DZ
2020-04-09,94,30,1666,235,DZ
2020-04-10,95,21,1761,256,DZ
2020-04-11,64,19,1825,275,DZ
2020-04-12,89,18,1914,293,DZ
2020-04-13,69,20,1983,313,DZ
2020-04-14,87,12,2070,325,DZ
2020-04-15,90,11,2160,336,DZ
2020-04-16,108,12,2268,348,DZ
2020-04-17,150,16,2418,364,DZ
2020-04-18,117,3,2535,367,DZ
2020-04-19,94,8,2629,375,DZ
2020-04-20,89,9,2718,384,DZ
2020-04-21,93,8,2811,392,DZ
2020-04-22,99,10,2910,402,DZ
2020-04-23,97,5,3007,407,DZ
2020-04-24,120,8,3127,415,DZ
2020-04-25,129,4,3256,419,DZ
2020-04-26,126,6,3382,425,DZ
2020-04-27,135,7,3517,432,DZ
2020-04-28,132,5,3649,437,DZ
2020-04-29,199,7,3848,444,DZ
2020-04-30,158,6,4006,450,DZ
2020-05-01,148,3,4154,453,DZ
2020-05-02,141,6,4295,459,DZ
2020-05-03,179,4,4474,463,DZ
2020-05-04,174,2,4648,465,DZ
2020-05-05,190,5,4838,470,DZ
2020-05-06,159,6,4997,476,DZ
2020-05-07,185,7,5182,483,DZ
2020-05-08,187,5,5369,488,DZ
2020-05-09,189,6,5558,494,DZ
2020-05-10,165,8,5723,502,DZ
2020-05-11,168,5,5891,507,DZ
2020-05-12,176,8,6067,515,DZ
2020-05-13,186,7,6253,522,DZ
2020-05-14,189,7,6442,529,DZ
2020-05-15,187,7,6629,536,DZ
2020-05-16,192,6,6821,542,DZ
2020-05-17,198,6,7019,548,DZ
2020-05-18,182,7,7201,555,DZ
2020-05-19,176,6,7377,561,DZ
2020-05-20,165,7,7542,568,DZ
2020-05-21,186,7,7728,575,DZ
2020-05-22,190,7,7918,582,DZ
2020-05-23,195,10,8113,592,DZ
2020-05-24,193,8,8306,600,DZ
2020-05-25,197,9,8503,609,DZ
2020-05-26,194,8,8697,617,DZ
2020-05-27,160,6,8857,623,DZ
2020-05-28,140,7,8997,630,DZ
2020-05-29,137,8,9134,638,DZ
2020-05-30,133,8,9267,646,DZ
2020-05-31,127,7,9394,653,DZ
2020-06-01,119,8,9513,661,DZ
2020-06-02,113,6,9626,667,DZ
2020-06-03,0,0,9626,667,DZ
2020-06-04,205,14,9831,681,DZ
2020-06-05,104,9,9935,690,DZ
2020-06-06,115,8,10050,698,DZ
2020-06-07,104,9,10154,707,DZ
2020-06-08,111,8,10265,715,DZ
2020-06-09,117,9,10382,724,DZ
2020-06-10,102,8,10484,732,DZ
2020-06-11,105,9,10589,741,DZ
2020-06-12,109,10,10698,751,DZ
2020-06-13,112,9,10810,760,DZ
2020-06-14,109,7,10919,767,DZ
2020-06-15,112,10,11031,777,DZ
2020-06-16,116,11,11147,788,DZ
2020-06-17,121,11,11268,799,DZ
2020-06-18,117,12,11385,811,DZ
2020-06-19,119,14,11504,825,DZ
2020-06-20,127,12,11631,837,DZ
2020-06-21,140,8,11771,845,DZ
2020-06-22,149,7,11920,852,DZ
2020-06-23,156,9,12076,861,DZ
2020-06-24,172,8,12248,869,DZ
2020-06-25,197,9,12445,878,DZ
2020-06-26,240,7,12685,885,DZ
2019-12-30,0,0,0,0,EC
2019-12-31,0,0,0,0,EC
2020-01-01,0,0,0,0,EC
2020-01-02,0,0,0,0,EC
2020-01-03,0,0,0,0,EC
2020-01-04,0,0,0,0,EC
2020-01-05,0,0,0,0,EC
2020-01-06,0,0,0,0,EC
2020-01-07,0,0,0,0,EC
2020-01-08,0,0,0,0,EC
2020-01-09,0,0,0,0,EC
2020-01-10,0,0,0,0,EC
2020-01-11,0,0,0,0,EC
2020-01-12,0,0,0,0,EC
2020-01-13,0,0,0,0,EC
2020-01-14,0,0,0,0,EC
2020-01-15,0,0,0,0,EC
2020-01-16,0,0,0,0,EC
2020-01-17,0,0,0,0,EC
2020-01-18,0,0,0,0,EC
2020-01-19,0,0,0,0,EC
2020-01-20,0,0,0,0,EC
2020-01-21,0,0,0,0,EC
2020-01-22,0,0,0,0,EC
2020-01-23,0,0,0,0,EC
2020-01-24,0,0,0,0,EC
2020-01-25,0,0,0,0,EC
2020-01-26,0,0,0,0,EC
2020-01-27,0,0,0,0,EC
2020-01-28,0,0,0,0,EC
2020-01-29,0,0,0,0,EC
2020-01-30,0,0,0,0,EC
2020-01-31,0,0,0,0,EC
2020-02-01,0,0,0,0,EC
2020-02-02,0,0,0,0,EC
2020-02-03,0,0,0,0,EC
2020-02-04,0,0,0,0,EC
2020-02-05,0,0,0,0,EC
2020-02-06,0,0,0,0,EC
2020-02-07,0,0,0,0,EC
2020-02-08,0,0,0,0,EC
2020-02-09,0,0,0,0,EC
2020-02-10,0,0,0,0,EC
2020-02-11,0,0,0,0,EC
2020-02-12,0,0,0,0,EC
2020-02-13,0,0,0,0,EC
2020-02-14,0,0,0,0,EC
2020-02-15,0,0,0,0,EC
2020-02-16,0,0,0,0,EC
2020-02-17,0,0,0,0,EC
2020-02-18,0,0,0,0,EC
2020-02-19,0,0,0,0,EC
2020-02-20,0,0,0,0,EC
2020-02-21,0,0,0,0,EC
2020-02-22,0,0,0,0,EC
2020-02-23,0,0,0,0,EC
2020-02-24,0,0,0,0,EC
2020-02-25,0,0,0,0,EC
2020-02-26,0,0,0,0,EC
2020-02-27,0,0,0,0,EC
2020-02-28,0,0,0,0,EC
2020-02-29,1,0,1,0,EC
2020-03-01,5,0,6,0,EC
2020-03-02,1,0,7,0,EC
2020-03-04,3,0,10,0,EC
2020-03-05,3,0,13,0,EC
2020-03-08,1,0,14,0,EC
2020-03-09,1,0,15,0,EC
2020-03-10,2,0,17,0,EC
2020-03-13,6,1,23,1,EC
2020-03-14,5,1,28,2,EC
2020-03-15,9,0,37,2,EC
2020-03-16,21,0,58,2,EC
2020-03-17,53,0,111,2,EC
2020-03-18,57,1,168,3,EC
2020-03-19,31,0,199,3,EC
2020-03-20,227,4,426,7,EC
2020-03-21,106,0,532,7,EC
2020-03-22,257,7,789,14,EC
2020-03-23,192,4,981,18,EC
2020-03-24,101,9,1082,27,EC
2020-03-25,129,2,1211,29,EC
2020-03-26,192,5,1403,34,EC
2020-03-27,224,7,1627,41,EC
2020-03-28,208,7,1835,48,EC
2020-03-29,55,10,1890,58,EC
2020-03-30,76,4,1966,62,EC
2020-03-31,336,17,2302,79,EC
2020-04-01,456,41,2758,120,EC
2020-04-02,405,0,3163,120,EC
2020-04-03,205,25,3368,145,EC
2020-04-04,97,27,3465,172,EC
2020-04-05,181,8,3646,180,EC
2020-04-06,101,11,3747,191,EC
2020-04-07,248,29,3995,220,EC
2020-04-08,455,22,4450,242,EC
2020-04-09,515,30,4965,272,EC
2020-04-10,2196,25,7161,297,EC
2020-04-11,96,18,7257,315,EC
2020-04-12,209,18,7466,333,EC
2020-04-13,63,22,7529,355,EC
2020-04-14,74,0,7603,355,EC
2020-04-15,255,33,7858,388,EC
2020-04-16,367,15,8225,403,EC
2020-04-17,225,18,8450,421,EC
2020-04-18,572,35,9022,456,EC
2020-04-19,446,18,9468,474,EC
2020-04-20,660,33,10128,507,EC
2020-04-21,270,13,10398,520,EC
2020-04-22,452,17,10850,537,EC
2020-04-23,333,23,11183,560,EC
2020-04-24,0,16,11183,576,EC
2020-04-25,0,0,11183,576,EC
2020-04-26,11536,0,22719,576,EC
2020-04-27,521,87,23240,663,EC
2020-04-28,1018,208,24258,871,EC
2020-04-29,417,12,24675,883,EC
2020-04-30,259,17,24934,900,EC
2020-05-01,1402,163,26336,1063,EC
2020-05-02,1128,308,27464,1371,EC
2020-05-03,2074,193,29538,1564,EC
2020-05-04,2343,5,31881,1569,EC
2020-05-05,0,0,31881,1569,EC
2020-05-06,-2461,49,29420,1618,EC
2020-05-07,878,36,30298,1654,EC
2020-05-08,-1480,50,28818,1704,EC
2020-05-09,253,13,29071,1717,EC
2020-05-10,488,410,29559,2127,EC
2020-05-11,-50,18,29509,2145,EC
2020-05-12,910,182,30419,2327,EC
2020-05-13,67,7,30486,2334,EC
2020-05-14,16,4,30502,2338,EC
2020-05-15,965,256,31467,2594,EC
2020-05-16,1296,94,32763,2688,EC
2020-05-17,419,48,33182,2736,EC
2020-05-18,400,63,33582,2799,EC
2020-05-19,569,40,34151,2839,EC
2020-05-20,703,49,34854,2888,EC
2020-05-21,452,51,35306,2939,EC
2020-05-22,522,117,35828,3056,EC
2020-05-23,430,40,36258,3096,EC
2020-05-24,498,12,36756,3108,EC
2020-05-25,599,95,37355,3203,EC
2020-05-26,0,0,37355,3203,EC
2020-05-27,748,72,38103,3275,EC
2020-05-28,368,38,38471,3313,EC
2020-05-29,100,21,38571,3334,EC
2020-05-30,0,0,38571,3334,EC
2020-05-31,527,24,39098,3358,EC
2020-06-01,896,36,39994,3394,EC
2020-06-02,420,44,40414,3438,EC
2020-06-03,552,48,40966,3486,EC
2020-06-04,0,0,40966,3486,EC
2020-06-05,609,48,41575,3534,EC
2020-06-06,1153,74,42728,3608,EC
2020-06-07,392,13,43120,3621,EC
2020-06-08,258,21,43378,3642,EC
2020-06-09,539,48,43917,3690,EC
2020-06-10,523,30,44440,3720,EC
2020-06-11,0,0,44440,3720,EC
2020-06-12,1338,108,45778,3828,EC
2020-06-13,578,46,46356,3874,EC
2020-06-14,395,22,46751,3896,EC
2020-06-15,571,33,47322,3929,EC
2020-06-16,621,41,47943,3970,EC
2020-06-17,547,37,48490,4007,EC
2020-06-18,607,80,49097,4087,EC
2020-06-19,634,69,49731,4156,EC
2020-06-20,452,43,50183,4199,EC
2020-06-21,457,24,50640,4223,EC
2020-06-22,0,0,50640,4223,EC
2020-06-23,1003,51,51643,4274,EC
2020-06-24,691,35,52334,4309,EC
2020-06-25,822,34,53156,4343,EC
2020-06-26,700,63,53856,4406,EC
2019-12-30,0,0,0,0,EE
2019-12-31,0,0,0,0,EE
2020-01-01,0,0,0,0,EE
2020-01-02,0,0,0,0,EE
2020-01-03,0,0,0,0,EE
2020-01-04,0,0,0,0,EE
2020-01-05,0,0,0,0,EE
2020-01-06,0,0,0,0,EE
2020-01-07,0,0,0,0,EE
2020-01-08,0,0,0,0,EE
2020-01-09,0,0,0,0,EE
2020-01-10,0,0,0,0,EE
2020-01-11,0,0,0,0,EE
2020-01-12,0,0,0,0,EE
2020-01-13,0,0,0,0,EE
2020-01-14,0,0,0,0,EE
2020-01-15,0,0,0,0,EE
2020-01-16,0,0,0,0,EE
2020-01-17,0,0,0,0,EE
2020-01-18,0,0,0,0,EE
2020-01-19,0,0,0,0,EE
2020-01-20,0,0,0,0,EE
2020-01-21,0,0,0,0,EE
2020-01-22,0,0,0,0,EE
2020-01-23,0,0,0,0,EE
2020-01-24,0,0,0,0,EE
2020-01-25,0,0,0,0,EE
2020-01-26,0,0,0,0,EE
2020-01-27,0,0,0,0,EE
2020-01-28,0,0,0,0,EE
2020-01-29,0,0,0,0,EE
2020-01-30,0,0,0,0,EE
2020-01-31,0,0,0,0,EE
2020-02-01,0,0,0,0,EE
2020-02-02,0,0,0,0,EE
2020-02-03,0,0,0,0,EE
2020-02-04,0,0,0,0,EE
2020-02-05,0,0,0,0,EE
2020-02-06,0,0,0,0,EE
2020-02-07,0,0,0,0,EE
2020-02-08,0,0,0,0,EE
2020-02-09,0,0,0,0,EE
2020-02-10,0,0,0,0,EE
2020-02-11,0,0,0,0,EE
2020-02-12,0,0,0,0,EE
2020-02-13,0,0,0,0,EE
2020-02-14,0,0,0,0,EE
2020-02-15,0,0,0,0,EE
2020-02-16,0,0,0,0,EE
2020-02-17,0,0,0,0,EE
2020-02-18,0,0,0,0,EE
2020-02-19,0,0,0,0,EE
2020-02-20,0,0,0,0,EE
2020-02-21,0,0,0,0,EE
2020-02-22,0,0,0,0,EE
2020-02-23,0,0,0,0,EE
2020-02-24,0,0,0,0,EE
2020-02-25,0,0,0,0,EE
2020-02-26,0,0,0,0,EE
2020-02-27,1,0,1,0,EE
2020-02-28,0,0,1,0,EE
2020-02-29,0,0,1,0,EE
2020-03-01,0,0,1,0,EE
2020-03-03,1,0,2,0,EE
2020-03-05,3,0,5,0,EE
2020-03-06,5,0,10,0,EE
2020-03-10,3,0,13,0,EE
2020-03-11,3,0,16,0,EE
2020-03-12,11,0,27,0,EE
2020-03-13,52,0,79,0,EE
2020-03-14,36,0,115,0,EE
2020-03-15,56,0,171,0,EE
2020-03-16,34,0,205,0,EE
2020-03-17,20,0,225,0,EE
2020-03-18,33,0,258,0,EE
2020-03-19,9,0,267,0,EE
2020-03-20,16,0,283,0,EE
2020-03-21,23,0,306,0,EE
2020-03-22,20,0,326,0,EE
2020-03-23,26,0,352,0,EE
2020-03-24,17,0,369,0,EE
2020-03-25,35,1,404,1,EE
2020-03-26,134,0,538,1,EE
2020-03-27,37,0,575,1,EE
2020-03-28,65,0,640,1,EE
2020-03-29,39,2,679,3,EE
2020-03-30,36,0,715,3,EE
2020-03-31,30,1,745,4,EE
2020-04-01,34,1,779,5,EE
2020-04-02,79,6,858,11,EE
2020-04-03,103,1,961,12,EE
2020-04-04,57,1,1018,13,EE
2020-04-05,79,2,1097,15,EE
2020-04-06,11,4,1108,19,EE
2020-04-07,41,2,1149,21,EE
2020-04-08,36,3,1185,24,EE
2020-04-09,22,0,1207,24,EE
2020-04-10,51,0,1258,24,EE
2020-04-11,46,0,1304,24,EE
2020-04-12,5,1,1309,25,EE
2020-04-13,23,3,1332,28,EE
2020-04-14,41,3,1373,31,EE
2020-04-15,29,4,1402,35,EE
2020-04-16,32,1,1434,36,EE
2020-04-17,25,2,1459,38,EE
2020-04-18,53,0,1512,38,EE
2020-04-19,16,2,1528,40,EE
2020-04-20,7,0,1535,40,EE
2020-04-21,17,3,1552,43,EE
2020-04-22,7,1,1559,44,EE
2020-04-23,33,1,1592,45,EE
2020-04-24,13,1,1605,46,EE
2020-04-25,30,0,1635,46,EE
2020-04-26,8,3,1643,49,EE
2020-04-27,4,1,1647,50,EE
2020-04-28,13,0,1660,50,EE
2020-04-29,6,0,1666,50,EE
2020-04-30,23,2,1689,52,EE
2020-05-01,5,0,1694,52,EE
2020-05-02,5,1,1699,53,EE
2020-05-03,1,2,1700,55,EE
2020-05-04,3,0,1703,55,EE
2020-05-05,8,0,1711,55,EE
2020-05-06,2,0,1713,55,EE
2020-05-07,7,1,1720,56,EE
2020-05-08,5,0,1725,56,EE
2020-05-09,8,4,1733,60,EE
2020-05-10,6,0,1739,60,EE
2020-05-11,2,1,1741,61,EE
2020-05-12,5,0,1746,61,EE
2020-05-13,5,0,1751,61,EE
2020-05-14,7,1,1758,62,EE
2020-05-15,8,1,1766,63,EE
2020-05-16,4,0,1770,63,EE
2020-05-17,4,0,1774,63,EE
2020-05-18,10,1,1784,64,EE
2020-05-19,7,0,1791,64,EE
2020-05-20,3,0,1794,64,EE
2020-05-21,6,0,1800,64,EE
2020-05-22,7,0,1807,64,EE
2020-05-23,14,0,1821,64,EE
2020-05-24,2,0,1823,64,EE
2020-05-25,1,1,1824,65,EE
2020-05-26,10,0,1834,65,EE
2020-05-27,6,1,1840,66,EE
2020-05-28,11,0,1851,66,EE
2020-05-29,8,1,1859,67,EE
2020-05-30,6,0,1865,67,EE
2020-05-31,4,1,1869,68,EE
2020-06-01,1,0,1870,68,EE
2020-06-02,0,0,1870,68,EE
2020-06-03,10,1,1880,69,EE
2020-06-04,10,0,1890,69,EE
2020-06-05,20,0,1910,69,EE
2020-06-06,21,0,1931,69,EE
2020-06-07,8,0,1939,69,EE
2020-06-08,1,0,1940,69,EE
2020-06-09,7,0,1947,69,EE
2020-06-10,11,0,1958,69,EE
2020-06-11,7,0,1965,69,EE
2020-06-12,5,0,1970,69,EE
2020-06-13,3,0,1973,69,EE
2020-06-14,0,0,1973,69,EE
2020-06-15,1,0,1974,69,EE
2020-06-16,1,0,1975,69,EE
2020-06-17,2,0,1977,69,EE
2020-06-18,0,0,1977,69,EE
2020-06-19,2,0,1979,69,EE
2020-06-20,2,0,1981,69,EE
2020-06-21,0,0,1981,69,EE
2020-06-22,0,0,1981,69,EE
2020-06-23,1,0,1982,69,EE
2020-06-24,1,0,1983,69,EE
2020-06-25,1,0,1984,69,EE
2020-06-26,2,0,1986,69,EE
2019-12-30,0,0,0,0,EG
2019-12-31,0,0,0,0,EG
2020-01-01,0,0,0,0,EG
2020-01-02,0,0,0,0,EG
2020-01-03,0,0,0,0,EG
2020-01-04,0,0,0,0,EG
2020-01-05,0,0,0,0,EG
2020-01-06,0,0,0,0,EG
2020-01-07,0,0,0,0,EG
2020-01-08,0,0,0,0,EG
2020-01-09,0,0,0,0,EG
2020-01-10,0,0,0,0,EG
2020-01-11,0,0,0,0,EG
2020-01-12,0,0,0,0,EG
2020-01-13,0,0,0,0,EG
2020-01-14,0,0,0,0,EG
2020-01-15,0,0,0,0,EG
2020-01-16,0,0,0,0,EG
2020-01-17,0,0,0,0,EG
2020-01-18,0,0,0,0,EG
2020-01-19,0,0,0,0,EG
2020-01-20,0,0,0,0,EG
2020-01-21,0,0,0,0,EG
2020-01-22,0,0,0,0,EG
2020-01-23,0,0,0,0,EG
2020-01-24,0,0,0,0,EG
2020-01-25,0,0,0,0,EG
2020-01-26,0,0,0,0,EG
2020-01-27,0,0,0,0,EG
2020-01-28,0,0,0,0,EG
2020-01-29,0,0,0,0,EG
2020-01-30,0,0,0,0,EG
2020-01-31,0,0,0,0,EG
2020-02-01,0,0,0,0,EG
2020-02-02,0,0,0,0,EG
2020-02-03,0,0,0,0,EG
2020-02-04,0,0,0,0,EG
2020-02-05,0,0,0,0,EG
2020-02-06,0,0,0,0,EG
2020-02-07,0,0,0,0,EG
2020-02-08,0,0,0,0,EG
2020-02-09,0,0,0,0,EG
2020-02-10,0,0,0,0,EG
2020-02-11,0,0,0,0,EG
2020-02-12,0,0,0,0,EG
2020-02-13,0,0,0,0,EG
2020-02-14,1,0,1,0,EG
2020-02-15,0,0,1,0,EG
2020-02-16,0,0,1,0,EG
2020-02-17,0,0,1,0,EG
2020-02-18,0,0,1,0,EG
2020-02-19,0,0,1,0,EG
2020-02-20,0,0,1,0,EG
2020-02-21,0,0,1,0,EG
2020-02-22,0,0,1,0,EG
2020-02-23,0,0,1,0,EG
2020-02-24,0,0,1,0,EG
2020-02-25,0,0,1,0,EG
2020-02-26,0,0,1,0,EG
2020-02-27,0,0,1,0,EG
2020-02-28,0,0,1,0,EG
2020-02-29,0,0,1,0,EG
2020-03-01,1,0,2,0,EG
2020-03-05,1,0,3,0,EG
2020-03-06,12,0,15,0,EG
2020-03-08,34,1,49,1,EG
2020-03-09,6,0,55,1,EG
2020-03-10,4,0,59,1,EG
2020-03-11,1,0,60,1,EG
2020-03-12,20,1,80,2,EG
2020-03-13,13,0,93,2,EG
2020-03-14,0,0,93,2,EG
2020-03-15,17,0,110,2,EG
2020-03-16,16,0,126,2,EG
2020-03-17,40,2,166,4,EG
2020-03-18,30,2,196,6,EG
2020-03-19,14,0,210,6,EG
2020-03-20,46,1,256,7,EG
2020-03-21,29,1,285,8,EG
2020-03-22,9,2,294,10,EG
2020-03-23,33,4,327,14,EG
2020-03-24,39,5,366,19,EG
2020-03-25,76,2,442,21,EG
2020-03-26,14,0,456,21,EG
2020-03-27,39,3,495,24,EG
2020-03-28,41,6,536,30,EG
2020-03-29,40,6,576,36,EG
2020-03-30,33,4,609,40,EG
2020-03-31,47,1,656,41,EG
2020-04-01,54,5,710,46,EG
2020-04-02,69,6,779,52,EG
2020-04-03,0,0,779,52,EG
2020-04-04,206,14,985,66,EG
2020-04-05,85,5,1070,71,EG
2020-04-06,3,7,1073,78,EG
2020-04-07,249,7,1322,85,EG
2020-04-08,238,18,1560,103,EG
2020-04-09,139,15,1699,118,EG
2020-04-10,95,17,1794,135,EG
2020-04-11,145,11,1939,146,EG
2020-04-12,126,13,2065,159,EG
2020-04-13,125,5,2190,164,EG
2020-04-14,160,14,2350,178,EG
2020-04-15,155,5,2505,183,EG
2020-04-16,168,13,2673,196,EG
2020-04-17,171,9,2844,205,EG
2020-04-18,188,19,3032,224,EG
2020-04-19,112,15,3144,239,EG
2020-04-20,189,11,3333,250,EG
2020-04-21,157,14,3490,264,EG
2020-04-22,0,0,3490,264,EG
2020-04-23,169,12,3659,276,EG
2020-04-24,433,18,4092,294,EG
2020-04-25,227,13,4319,307,EG
2020-04-26,0,0,4319,307,EG
2020-04-27,463,30,4782,337,EG
2020-04-28,260,22,5042,359,EG
2020-04-29,226,21,5268,380,EG
2020-04-30,269,12,5537,392,EG
2020-05-01,358,14,5895,406,EG
2020-05-02,298,9,6193,415,EG
2020-05-03,272,14,6465,429,EG
2020-05-04,348,7,6813,436,EG
2020-05-05,388,16,7201,452,EG
2020-05-06,387,17,7588,469,EG
2020-05-07,393,13,7981,482,EG
2020-05-08,495,21,8476,503,EG
2020-05-09,488,11,8964,514,EG
2020-05-10,436,11,9400,525,EG
2020-05-11,346,8,9746,533,EG
2020-05-12,347,11,10093,544,EG
2020-05-13,338,12,10431,556,EG
2020-05-14,398,15,10829,571,EG
2020-05-15,399,21,11228,592,EG
2020-05-16,491,20,11719,612,EG
2020-05-17,510,18,12229,630,EG
2020-05-18,535,15,12764,645,EG
2020-05-19,720,14,13484,659,EG
2020-05-20,745,21,14229,680,EG
2020-05-21,774,16,15003,696,EG
2020-05-22,783,11,15786,707,EG
2020-05-23,827,28,16613,735,EG
2020-05-24,652,29,17265,764,EG
2020-05-25,702,19,17967,783,EG
2020-05-26,789,14,18756,797,EG
2020-05-27,910,19,19666,816,EG
2020-05-28,1127,29,20793,845,EG
2020-05-29,1289,34,22082,879,EG
2020-05-30,1367,34,23449,913,EG
2020-05-31,1536,46,24985,959,EG
2020-06-01,1399,46,26384,1005,EG
2020-06-02,1152,47,27536,1052,EG
2020-06-03,1079,36,28615,1088,EG
2020-06-04,1152,38,29767,1126,EG
2020-06-05,1348,40,31115,1166,EG
2020-06-06,1497,32,32612,1198,EG
2020-06-07,1467,39,34079,1237,EG
2020-06-08,1365,34,35444,1271,EG
2020-06-09,1385,35,36829,1306,EG
2020-06-10,1455,36,38284,1342,EG
2020-06-11,1442,35,39726,1377,EG
2020-06-12,1578,45,41304,1422,EG
2020-06-13,1676,62,42980,1484,EG
2020-06-14,1618,91,44598,1575,EG
2020-06-15,1691,97,46289,1672,EG
2020-06-16,1567,94,47856,1766,EG
2020-06-17,1363,84,49219,1850,EG
2020-06-18,1218,88,50437,1938,EG
2020-06-19,1774,79,52211,2017,EG
2020-06-20,1547,89,53758,2106,EG
2020-06-21,1475,87,55233,2193,EG
2020-06-22,1576,85,56809,2278,EG
2020-06-23,1332,87,58141,2365,EG
2020-06-24,0,0,58141,2365,EG
2020-06-25,2989,168,61130,2533,EG
2020-06-26,1625,87,62755,2620,EG
2020-04-25,6,0,6,0,EH
2020-04-26,0,0,6,0,EH
2020-04-27,0,0,6,0,EH
2020-04-28,0,0,6,0,EH
2020-04-29,0,0,6,0,EH
2020-04-30,0,0,6,0,EH
2020-05-01,0,0,6,0,EH
2020-05-02,0,0,6,0,EH
2020-05-03,0,0,6,0,EH
2020-05-04,0,0,6,0,EH
2020-05-05,0,0,6,0,EH
2020-05-06,0,0,6,0,EH
2020-05-07,0,0,6,0,EH
2020-05-08,0,0,6,0,EH
2020-05-09,0,0,6,0,EH
2020-05-10,0,0,6,0,EH
2020-05-11,0,0,6,0,EH
2020-05-12,0,0,6,0,EH
2020-05-13,0,0,6,0,EH
2020-05-14,0,0,6,0,EH
2020-05-15,0,0,6,0,EH
2020-05-16,0,0,6,0,EH
2020-05-17,0,0,6,0,EH
2020-05-18,0,0,6,0,EH
2020-05-19,0,0,6,0,EH
2020-05-20,0,0,6,0,EH
2020-05-21,0,0,6,0,EH
2020-05-22,0,0,6,0,EH
2020-05-23,0,0,6,0,EH
2020-05-24,0,0,6,0,EH
2020-05-25,0,0,6,0,EH
2020-05-26,0,0,6,0,EH
2020-05-27,0,0,6,0,EH
2020-05-28,0,0,6,0,EH
2020-05-29,17,1,23,1,EH
2020-05-30,0,0,23,1,EH
2020-05-31,0,0,23,1,EH
2020-06-01,0,0,23,1,EH
2020-06-02,0,0,23,1,EH
2020-06-03,0,0,23,1,EH
2020-06-04,0,0,23,1,EH
2020-06-05,0,0,23,1,EH
2020-06-06,0,0,23,1,EH
2020-06-07,0,0,23,1,EH
2020-06-08,0,0,23,1,EH
2020-06-09,0,0,23,1,EH
2020-06-10,0,0,23,1,EH
2020-06-11,0,0,23,1,EH
2020-06-12,0,0,23,1,EH
2020-06-13,0,0,23,1,EH
2020-06-14,0,0,23,1,EH
2020-06-15,0,0,23,1,EH
2020-06-16,0,0,23,1,EH
2020-06-17,0,0,23,1,EH
2020-06-18,0,0,23,1,EH
2020-06-19,2,0,25,1,EH
2020-06-20,0,0,25,1,EH
2020-06-21,0,0,25,1,EH
2020-06-22,0,0,25,1,EH
2020-06-23,0,0,25,1,EH
2020-06-24,0,0,25,1,EH
2020-06-25,0,0,25,1,EH
2020-06-26,0,0,25,1,EH
2020-03-21,1,0,1,0,ER
2020-03-22,0,0,1,0,ER
2020-03-23,0,0,1,0,ER
2020-03-24,0,0,1,0,ER
2020-03-25,3,0,4,0,ER
2020-03-26,2,0,6,0,ER
2020-03-27,0,0,6,0,ER
2020-03-28,0,0,6,0,ER
2020-03-29,6,0,12,0,ER
2020-03-30,0,0,12,0,ER
2020-03-31,3,0,15,0,ER
2020-04-01,3,0,18,0,ER
2020-04-02,4,0,22,0,ER
2020-04-03,0,0,22,0,ER
2020-04-04,7,0,29,0,ER
2020-04-05,0,0,29,0,ER
2020-04-06,2,0,31,0,ER
2020-04-07,0,0,31,0,ER
2020-04-08,2,0,33,0,ER
2020-04-09,0,0,33,0,ER
2020-04-10,1,0,34,0,ER
2020-04-11,0,0,34,0,ER
2020-04-12,0,0,34,0,ER
2020-04-13,0,0,34,0,ER
2020-04-14,1,0,35,0,ER
2020-04-15,0,0,35,0,ER
2020-04-16,0,0,35,0,ER
2020-04-17,0,0,35,0,ER
2020-04-18,0,0,35,0,ER
2020-04-19,4,0,39,0,ER
2020-04-20,0,0,39,0,ER
2020-04-21,0,0,39,0,ER
2020-04-22,0,0,39,0,ER
2020-04-23,0,0,39,0,ER
2020-04-24,0,0,39,0,ER
2020-04-25,0,0,39,0,ER
2020-04-26,0,0,39,0,ER
2020-04-27,0,0,39,0,ER
2020-04-28,0,0,39,0,ER
2020-04-29,0,0,39,0,ER
2020-04-30,0,0,39,0,ER
2020-05-01,0,0,39,0,ER
2020-05-02,0,0,39,0,ER
2020-05-03,0,0,39,0,ER
2020-05-04,0,0,39,0,ER
2020-05-05,0,0,39,0,ER
2020-05-06,0,0,39,0,ER
2020-05-07,0,0,39,0,ER
2020-05-08,0,0,39,0,ER
2020-05-09,0,0,39,0,ER
2020-05-10,0,0,39,0,ER
2020-05-11,0,0,39,0,ER
2020-05-12,0,0,39,0,ER
2020-05-13,0,0,39,0,ER
2020-05-14,0,0,39,0,ER
2020-05-15,0,0,39,0,ER
2020-05-16,0,0,39,0,ER
2020-05-17,0,0,39,0,ER
2020-05-18,0,0,39,0,ER
2020-05-19,0,0,39,0,ER
2020-05-20,0,0,39,0,ER
2020-05-21,0,0,39,0,ER
2020-05-22,0,0,39,0,ER
2020-05-23,0,0,39,0,ER
2020-05-24,0,0,39,0,ER
2020-05-25,0,0,39,0,ER
2020-05-26,0,0,39,0,ER
2020-05-27,0,0,39,0,ER
2020-05-28,0,0,39,0,ER
2020-05-29,0,0,39,0,ER
2020-05-30,0,0,39,0,ER
2020-05-31,0,0,39,0,ER
2020-06-01,0,0,39,0,ER
2020-06-02,0,0,39,0,ER
2020-06-03,1,0,40,0,ER
2020-06-04,1,0,41,0,ER
2020-06-05,0,0,41,0,ER
2020-06-06,0,0,41,0,ER
2020-06-07,0,0,41,0,ER
2020-06-08,0,0,41,0,ER
2020-06-09,0,0,41,0,ER
2020-06-10,0,0,41,0,ER
2020-06-11,0,0,41,0,ER
2020-06-12,0,0,41,0,ER
2020-06-13,24,0,65,0,ER
2020-06-14,31,0,96,0,ER
2020-06-15,13,0,109,0,ER
2020-06-16,12,0,121,0,ER
2020-06-17,10,0,131,0,ER
2020-06-18,11,0,142,0,ER
2020-06-19,0,0,142,0,ER
2020-06-20,1,0,143,0,ER
2020-06-21,0,0,143,0,ER
2020-06-22,0,0,143,0,ER
2020-06-23,0,0,143,0,ER
2020-06-24,0,0,143,0,ER
2020-06-25,1,0,144,0,ER
2020-06-26,23,0,167,0,ER
2019-12-31,0,0,0,0,ES
2020-01-01,0,0,0,0,ES
2020-01-02,0,0,0,0,ES
2020-01-03,0,0,0,0,ES
2020-01-04,0,0,0,0,ES
2020-01-05,0,0,0,0,ES
2020-01-06,0,0,0,0,ES
2020-01-07,0,0,0,0,ES
2020-01-08,0,0,0,0,ES
2020-01-09,0,0,0,0,ES
2020-01-10,0,0,0,0,ES
2020-01-11,0,0,0,0,ES
2020-01-12,0,0,0,0,ES
2020-01-13,0,0,0,0,ES
2020-01-14,0,0,0,0,ES
2020-01-15,0,0,0,0,ES
2020-01-16,0,0,0,0,ES
2020-01-17,0,0,0,0,ES
2020-01-18,0,0,0,0,ES
2020-01-19,0,0,0,0,ES
2020-01-20,0,0,0,0,ES
2020-01-21,0,0,0,0,ES
2020-01-22,0,0,0,0,ES
2020-01-23,0,0,0,0,ES
2020-01-24,0,0,0,0,ES
2020-01-25,0,0,0,0,ES
2020-01-26,0,0,0,0,ES
2020-01-27,0,0,0,0,ES
2020-01-28,0,0,0,0,ES
2020-01-29,0,0,0,0,ES
2020-01-30,0,0,0,0,ES
2020-01-31,0,0,0,0,ES
2020-02-01,1,0,1,0,ES
2020-02-02,0,0,1,0,ES
2020-02-03,0,0,1,0,ES
2020-02-04,0,0,1,0,ES
2020-02-05,0,0,1,0,ES
2020-02-06,0,0,1,0,ES
2020-02-07,0,0,1,0,ES
2020-02-08,0,0,1,0,ES
2020-02-09,0,0,1,0,ES
2020-02-10,1,0,2,0,ES
2020-02-11,0,0,2,0,ES
2020-02-12,0,0,2,0,ES
2020-02-13,0,0,2,0,ES
2020-02-14,0,0,2,0,ES
2020-02-15,0,0,2,0,ES
2020-02-16,0,0,2,0,ES
2020-02-17,0,0,2,0,ES
2020-02-18,0,0,2,0,ES
2020-02-19,0,0,2,0,ES
2020-02-20,0,0,2,0,ES
2020-02-21,0,0,2,0,ES
2020-02-22,0,0,2,0,ES
2020-02-23,0,0,2,0,ES
2020-02-24,0,0,2,0,ES
2020-02-25,1,0,3,0,ES
2020-02-26,6,0,9,0,ES
2020-02-27,8,0,17,0,ES
2020-02-28,18,0,35,0,ES
2020-02-29,19,0,54,0,ES
2020-03-01,28,0,82,0,ES
2020-03-02,54,0,136,0,ES
2020-03-03,56,0,192,0,ES
2020-03-04,75,0,267,0,ES
2020-03-05,81,1,348,1,ES
2020-03-06,183,2,531,3,ES
2020-03-07,233,2,764,5,ES
2020-03-08,330,0,1094,5,ES
2020-03-09,433,0,1527,5,ES
2020-03-10,772,23,2299,28,ES
2020-03-11,975,7,3274,35,ES
2020-03-12,1153,12,4427,47,ES
2020-03-13,1531,37,5958,84,ES
2020-03-14,1683,37,7641,121,ES
2020-03-15,2144,15,9785,136,ES
2020-03-16,1706,152,11491,288,ES
2020-03-17,2503,21,13994,309,ES
2020-03-18,3694,182,17688,491,ES
2020-03-19,4047,107,21735,598,ES
2020-03-20,4569,169,26304,767,ES
2020-03-21,5446,235,31750,1002,ES
2020-03-22,4866,324,36616,1326,ES
2020-03-23,4646,394,41262,1720,ES
2020-03-24,7691,462,48953,2182,ES
2020-03-25,8553,514,57506,2696,ES
2020-03-26,8954,738,66460,3434,ES
2020-03-27,9181,655,75641,4089,ES
2020-03-28,8244,769,83885,4858,ES
2020-03-29,6424,832,90309,5690,ES
2020-03-30,5813,838,96122,6528,ES
2020-03-31,8145,812,104267,7340,ES
2020-04-01,7413,849,111680,8189,ES
2020-04-02,7583,864,119263,9053,ES
2020-04-03,7272,950,126535,10003,ES
2020-04-04,6663,932,133198,10935,ES
2020-04-05,5533,809,138731,11744,ES
2020-04-06,3667,674,142398,12418,ES
2020-04-07,5209,637,147607,13055,ES
2020-04-08,5583,743,153190,13798,ES
2020-04-09,5745,757,158935,14555,ES
2020-04-10,4537,683,163472,15238,ES
2020-04-11,4550,605,168022,15843,ES
2020-04-12,3899,510,171921,16353,ES
2020-04-13,3030,619,174951,16972,ES
2020-04-14,3116,517,178067,17489,ES
2020-04-15,4424,787,182491,18276,ES
2020-04-16,3820,617,186311,18893,ES
2020-04-17,3818,585,190129,19478,ES
2020-04-18,3836,565,193965,20043,ES
2020-04-19,-713,410,193252,20453,ES
2020-04-20,2218,399,195470,20852,ES
2020-04-21,2951,430,198421,21282,ES
2020-04-22,2312,435,200733,21717,ES
2020-04-23,2916,440,203649,22157,ES
2020-04-24,2114,367,205763,22524,ES
2020-04-25,2506,378,208269,22902,ES
2020-04-26,1641,288,209910,23190,ES
2020-04-27,1660,0,211570,23190,ES
2020-04-28,1525,632,213095,23822,ES
2020-04-29,847,453,213942,24275,ES
2020-04-30,1241,268,215183,24543,ES
2020-05-01,1387,281,216570,24824,ES
2020-05-02,1234,276,217804,25100,ES
2020-05-03,935,164,218739,25264,ES
2020-05-04,466,164,219205,25428,ES
2020-05-05,1039,185,220244,25613,ES
2020-05-06,880,244,221124,25857,ES
2020-05-07,921,213,222045,26070,ES
2020-05-08,1173,181,223218,26251,ES
2020-05-09,743,227,223961,26478,ES
2020-05-10,3416,143,227377,26621,ES
2020-05-11,393,123,227770,26744,ES
2020-05-12,482,176,228252,26920,ES
2020-05-13,439,184,228691,27104,ES
2020-05-14,849,217,229540,27321,ES
2020-05-15,643,138,230183,27459,ES
2020-05-16,515,104,230698,27563,ES
2020-05-17,652,87,231350,27650,ES
2020-05-18,256,59,231606,27709,ES
2020-05-19,431,69,232037,27778,ES
2020-05-20,518,110,232555,27888,ES
2020-05-21,482,52,233037,27940,ES
2020-05-22,1787,688,234824,28628,ES
2020-05-23,466,50,235290,28678,ES
2020-05-24,482,74,235772,28752,ES
2020-05-25,-372,-1918,235400,26834,ES
2020-05-26,859,283,236259,27117,ES
2020-05-27,510,1,236769,27118,ES
2020-05-28,1137,1,237906,27119,ES
2020-05-29,658,2,238564,27121,ES
2020-05-30,664,4,239228,27125,ES
2020-05-31,201,2,239429,27127,ES
2020-06-01,209,0,239638,27127,ES
2020-06-02,294,0,239932,27127,ES
2020-06-03,394,1,240326,27128,ES
2020-06-04,334,5,240660,27133,ES
2020-06-05,318,1,240978,27134,ES
2020-06-06,332,1,241310,27135,ES
2020-06-07,240,1,241550,27136,ES
2020-06-08,167,0,241717,27136,ES
2020-06-09,249,0,241966,27136,ES
2020-06-10,314,0,242280,27136,ES
2020-06-11,427,0,242707,27136,ES
2020-06-12,502,0,243209,27136,ES
2020-06-13,396,0,243605,27136,ES
2020-06-14,323,0,243928,27136,ES
2020-06-15,181,0,244109,27136,ES
2020-06-16,219,0,244328,27136,ES
2020-06-17,355,0,244683,27136,ES
2020-06-18,585,0,245268,27136,ES
2020-06-19,307,1179,245575,28315,ES
2020-06-20,363,7,245938,28322,ES
2020-06-21,334,1,246272,28323,ES
2020-06-22,232,1,246504,28324,ES
2020-06-23,248,1,246752,28325,ES
2020-06-24,334,2,247086,28327,ES
2020-06-25,400,3,247486,28330,ES
2020-06-26,419,8,247905,28338,ES
2020-03-13,1,0,1,0,ET
2020-03-14,0,0,1,0,ET
2020-03-15,3,0,4,0,ET
2020-03-16,1,0,5,0,ET
2020-03-17,0,0,5,0,ET
2020-03-18,1,0,6,0,ET
2020-03-19,1,0,7,0,ET
2020-03-20,2,0,9,0,ET
2020-03-21,0,0,9,0,ET
2020-03-22,2,0,11,0,ET
2020-03-23,0,0,11,0,ET
2020-03-24,0,0,11,0,ET
2020-03-25,1,0,12,0,ET
2020-03-26,0,0,12,0,ET
2020-03-27,4,0,16,0,ET
2020-03-28,0,0,16,0,ET
2020-03-29,0,0,16,0,ET
2020-03-30,7,0,23,0,ET
2020-03-31,2,0,25,0,ET
2020-04-01,4,0,29,0,ET
2020-04-02,0,0,29,0,ET
2020-04-03,6,0,35,0,ET
2020-04-04,3,0,38,0,ET
2020-04-05,5,2,43,2,ET
2020-04-06,1,0,44,2,ET
2020-04-07,8,0,52,2,ET
2020-04-08,3,0,55,2,ET
2020-04-09,1,0,56,2,ET
2020-04-10,9,0,65,2,ET
2020-04-11,4,1,69,3,ET
2020-04-12,2,0,71,3,ET
2020-04-13,3,0,74,3,ET
2020-04-14,8,0,82,3,ET
2020-04-15,3,0,85,3,ET
2020-04-16,7,0,92,3,ET
2020-04-17,4,0,96,3,ET
2020-04-18,9,0,105,3,ET
2020-04-19,3,0,108,3,ET
2020-04-20,3,0,111,3,ET
2020-04-21,3,0,114,3,ET
2020-04-22,2,0,116,3,ET
2020-04-23,0,0,116,3,ET
2020-04-24,1,0,117,3,ET
2020-04-25,5,0,122,3,ET
2020-04-26,1,0,123,3,ET
2020-04-27,1,0,124,3,ET
2020-04-28,2,0,126,3,ET
2020-04-29,4,0,130,3,ET
2020-04-30,1,0,131,3,ET
2020-05-01,2,0,133,3,ET
2020-05-02,0,0,133,3,ET
2020-05-03,2,0,135,3,ET
2020-05-04,5,0,140,3,ET
2020-05-05,5,1,145,4,ET
2020-05-06,17,0,162,4,ET
2020-05-07,29,0,191,4,ET
2020-05-08,3,0,194,4,ET
2020-05-09,16,1,210,5,ET
2020-05-10,29,0,239,5,ET
2020-05-11,11,0,250,5,ET
2020-05-12,11,0,261,5,ET
2020-05-13,2,0,263,5,ET
2020-05-14,9,0,272,5,ET
2020-05-15,15,0,287,5,ET
2020-05-16,19,0,306,5,ET
2020-05-17,11,0,317,5,ET
2020-05-18,35,0,352,5,ET
2020-05-19,13,0,365,5,ET
2020-05-20,24,0,389,5,ET
2020-05-21,10,0,399,5,ET
2020-05-22,34,0,433,5,ET
2020-05-23,61,0,494,5,ET
2020-05-24,88,0,582,5,ET
2020-05-25,73,0,655,5,ET
2020-05-26,46,1,701,6,ET
2020-05-27,30,0,731,6,ET
2020-05-28,100,1,831,7,ET
2020-05-29,137,1,968,8,ET
2020-05-30,95,0,1063,8,ET
2020-05-31,109,3,1172,11,ET
2020-06-01,85,1,1257,12,ET
2020-06-02,87,2,1344,14,ET
2020-06-03,142,3,1486,17,ET
2020-06-04,150,1,1636,18,ET
2020-06-05,169,1,1805,19,ET
2020-06-06,129,1,1934,20,ET
2020-06-07,86,7,2020,27,ET
2020-06-08,136,0,2156,27,ET
2020-06-09,180,5,2336,32,ET
2020-06-10,170,3,2506,35,ET
2020-06-11,164,5,2670,40,ET
2020-06-12,245,7,2915,47,ET
2020-06-13,251,8,3166,55,ET
2020-06-14,179,2,3345,57,ET
2020-06-15,176,3,3521,60,ET
2020-06-16,109,1,3630,61,ET
2020-06-17,129,2,3759,63,ET
2020-06-18,195,2,3954,65,ET
2020-06-19,116,7,4070,72,ET
2020-06-20,399,0,4469,72,ET
2020-06-21,63,2,4532,74,ET
2020-06-22,131,1,4663,75,ET
2020-06-23,185,0,4848,75,ET
2020-06-24,186,3,5034,78,ET
2020-06-25,141,3,5175,81,ET
2020-06-26,250,8,5425,89,ET
2019-12-30,0,0,0,0,FI
2019-12-31,0,0,0,0,FI
2020-01-01,0,0,0,0,FI
2020-01-02,0,0,0,0,FI
2020-01-03,0,0,0,0,FI
2020-01-04,0,0,0,0,FI
2020-01-05,0,0,0,0,FI
2020-01-06,0,0,0,0,FI
2020-01-07,0,0,0,0,FI
2020-01-08,0,0,0,0,FI
2020-01-09,0,0,0,0,FI
2020-01-10,0,0,0,0,FI
2020-01-11,0,0,0,0,FI
2020-01-12,0,0,0,0,FI
2020-01-13,0,0,0,0,FI
2020-01-14,0,0,0,0,FI
2020-01-15,0,0,0,0,FI
2020-01-16,0,0,0,0,FI
2020-01-17,0,0,0,0,FI
2020-01-18,0,0,0,0,FI
2020-01-19,0,0,0,0,FI
2020-01-20,0,0,0,0,FI
2020-01-21,0,0,0,0,FI
2020-01-22,0,0,0,0,FI
2020-01-23,0,0,0,0,FI
2020-01-24,0,0,0,0,FI
2020-01-25,0,0,0,0,FI
2020-01-26,0,0,0,0,FI
2020-01-27,0,0,0,0,FI
2020-01-28,0,0,0,0,FI
2020-01-29,1,0,1,0,FI
2020-01-30,0,0,1,0,FI
2020-01-31,0,0,1,0,FI
2020-02-01,0,0,1,0,FI
2020-02-02,0,0,1,0,FI
2020-02-03,0,0,1,0,FI
2020-02-04,0,0,1,0,FI
2020-02-05,0,0,1,0,FI
2020-02-06,0,0,1,0,FI
2020-02-07,0,0,1,0,FI
2020-02-08,0,0,1,0,FI
2020-02-09,0,0,1,0,FI
2020-02-10,0,0,1,0,FI
2020-02-11,0,0,1,0,FI
2020-02-12,0,0,1,0,FI
2020-02-13,0,0,1,0,FI
2020-02-14,0,0,1,0,FI
2020-02-15,0,0,1,0,FI
2020-02-16,0,0,1,0,FI
2020-02-17,0,0,1,0,FI
2020-02-18,0,0,1,0,FI
2020-02-19,0,0,1,0,FI
2020-02-20,0,0,1,0,FI
2020-02-21,0,0,1,0,FI
2020-02-22,0,0,1,0,FI
2020-02-23,0,0,1,0,FI
2020-02-24,0,0,1,0,FI
2020-02-25,0,0,1,0,FI
2020-02-26,1,0,2,0,FI
2020-02-27,0,0,2,0,FI
2020-02-28,1,0,3,0,FI
2020-02-29,0,0,3,0,FI
2020-03-01,3,0,6,0,FI
2020-03-03,1,0,7,0,FI
2020-03-05,5,0,12,0,FI
2020-03-06,7,0,19,0,FI
2020-03-08,11,0,30,0,FI
2020-03-09,10,0,40,0,FI
2020-03-11,19,0,59,0,FI
2020-03-12,96,0,155,0,FI
2020-03-13,28,0,183,0,FI
2020-03-14,27,0,210,0,FI
2020-03-15,57,0,267,0,FI
2020-03-16,5,0,272,0,FI
2020-03-17,47,0,319,0,FI
2020-03-18,50,0,369,0,FI
2020-03-19,31,0,400,0,FI
2020-03-20,50,0,450,0,FI
2020-03-21,71,1,521,1,FI
2020-03-22,105,0,626,1,FI
2020-03-23,74,0,700,1,FI
2020-03-24,92,0,792,1,FI
2020-03-25,88,2,880,3,FI
2020-03-26,78,1,958,4,FI
2020-03-27,67,3,1025,7,FI
2020-03-28,193,2,1218,9,FI
2020-03-29,0,2,1218,11,FI
2020-03-30,95,2,1313,13,FI
2020-03-31,71,4,1384,17,FI
2020-04-01,62,0,1446,17,FI
2020-04-02,72,2,1518,19,FI
2020-04-03,97,1,1615,20,FI
2020-04-04,267,5,1882,25,FI
2020-04-05,45,2,1927,27,FI
2020-04-06,249,0,2176,27,FI
2020-04-07,132,7,2308,34,FI
2020-04-08,179,6,2487,40,FI
2020-04-09,118,2,2605,42,FI
2020-04-10,164,6,2769,48,FI
2020-04-11,136,1,2905,49,FI
2020-04-12,69,7,2974,56,FI
2020-04-13,90,3,3064,59,FI
2020-04-14,97,5,3161,64,FI
2020-04-15,76,8,3237,72,FI
2020-04-16,132,3,3369,75,FI
2020-04-17,120,7,3489,82,FI
2020-04-18,192,8,3681,90,FI
2020-04-19,102,4,3783,94,FI
2020-04-20,85,4,3868,98,FI
2020-04-21,146,43,4014,141,FI
2020-04-22,115,8,4129,149,FI
2020-04-23,155,23,4284,172,FI
2020-04-24,111,5,4395,177,FI
2020-04-25,80,9,4475,186,FI
2020-04-26,101,4,4576,190,FI
2020-04-27,119,3,4695,193,FI
2020-04-28,45,6,4740,199,FI
2020-04-29,166,7,4906,206,FI
2020-04-30,89,5,4995,211,FI
2020-05-01,56,7,5051,218,FI
2020-05-02,128,2,5179,220,FI
2020-05-03,75,10,5254,230,FI
2020-05-04,73,10,5327,240,FI
2020-05-05,85,6,5412,246,FI
2020-05-06,161,6,5573,252,FI
2020-05-07,100,3,5673,255,FI
2020-05-08,65,5,5738,260,FI
2020-05-09,142,5,5880,265,FI
2020-05-10,82,2,5962,267,FI
2020-05-11,22,4,5984,271,FI
2020-05-12,19,4,6003,275,FI
2020-05-13,51,9,6054,284,FI
2020-05-14,91,3,6145,287,FI
2020-05-15,83,6,6228,293,FI
2020-05-16,58,4,6286,297,FI
2020-05-17,61,1,6347,298,FI
2020-05-18,33,2,6380,300,FI
2020-05-19,19,1,6399,301,FI
2020-05-20,44,3,6443,304,FI
2020-05-21,50,2,6493,306,FI
2020-05-22,44,0,6537,306,FI
2020-05-23,31,0,6568,306,FI
2020-05-24,11,1,6579,307,FI
2020-05-25,20,1,6599,308,FI
2020-05-26,29,4,6628,312,FI
2020-05-27,64,1,6692,313,FI
2020-05-28,51,0,6743,313,FI
2020-05-29,33,1,6776,314,FI
2020-05-30,50,2,6826,316,FI
2020-05-31,33,4,6859,320,FI
2020-06-01,26,0,6885,320,FI
2020-06-02,2,0,6887,320,FI
2020-06-03,24,1,6911,321,FI
2020-06-04,0,1,6911,322,FI
2020-06-05,30,0,6941,322,FI
2020-06-06,23,0,6964,322,FI
2020-06-07,17,1,6981,323,FI
2020-06-08,20,0,7001,323,FI
2020-06-09,24,1,7025,324,FI
2020-06-10,15,0,7040,324,FI
2020-06-11,24,1,7064,325,FI
2020-06-12,9,0,7073,325,FI
2020-06-13,14,0,7087,325,FI
2020-06-14,17,1,7104,326,FI
2020-06-15,4,0,7108,326,FI
2020-06-16,4,0,7112,326,FI
2020-06-17,5,0,7117,326,FI
2020-06-18,0,0,7117,326,FI
2020-06-19,16,0,7133,326,FI
2020-06-20,9,0,7142,326,FI
2020-06-21,1,0,7143,326,FI
2020-06-22,1,1,7144,327,FI
2020-06-23,11,0,7155,327,FI
2020-06-24,12,0,7167,327,FI
2020-06-25,5,0,7172,327,FI
2020-06-26,19,1,7191,328,FI
2020-03-20,1,0,1,0,FJ
2020-03-21,0,0,1,0,FJ
2020-03-22,1,0,2,0,FJ
2020-03-23,1,0,3,0,FJ
2020-03-24,1,0,4,0,FJ
2020-03-25,1,0,5,0,FJ
2020-03-26,0,0,5,0,FJ
2020-03-27,0,0,5,0,FJ
2020-03-28,0,0,5,0,FJ
2020-03-29,0,0,5,0,FJ
2020-03-30,0,0,5,0,FJ
2020-03-31,0,0,5,0,FJ
2020-04-01,0,0,5,0,FJ
2020-04-02,2,0,7,0,FJ
2020-04-03,0,0,7,0,FJ
2020-04-04,5,0,12,0,FJ
2020-04-05,0,0,12,0,FJ
2020-04-06,2,0,14,0,FJ
2020-04-07,0,0,14,0,FJ
2020-04-08,1,0,15,0,FJ
2020-04-09,0,0,15,0,FJ
2020-04-10,0,0,15,0,FJ
2020-04-11,1,0,16,0,FJ
2020-04-12,0,0,16,0,FJ
2020-04-13,0,0,16,0,FJ
2020-04-14,0,0,16,0,FJ
2020-04-15,0,0,16,0,FJ
2020-04-16,0,0,16,0,FJ
2020-04-17,1,0,17,0,FJ
2020-04-18,0,0,17,0,FJ
2020-04-19,0,0,17,0,FJ
2020-04-20,0,0,17,0,FJ
2020-04-21,1,0,18,0,FJ
2020-04-22,0,0,18,0,FJ
2020-04-23,0,0,18,0,FJ
2020-04-24,0,0,18,0,FJ
2020-04-25,0,0,18,0,FJ
2020-04-26,0,0,18,0,FJ
2020-04-27,0,0,18,0,FJ
2020-04-28,0,0,18,0,FJ
2020-04-29,0,0,18,0,FJ
2020-04-30,0,0,18,0,FJ
2020-05-01,0,0,18,0,FJ
2020-05-02,0,0,18,0,FJ
2020-05-03,0,0,18,0,FJ
2020-05-04,0,0,18,0,FJ
2020-05-05,0,0,18,0,FJ
2020-05-06,0,0,18,0,FJ
2020-05-07,0,0,18,0,FJ
2020-05-08,0,0,18,0,FJ
2020-05-09,0,0,18,0,FJ
2020-05-10,0,0,18,0,FJ
2020-05-11,0,0,18,0,FJ
2020-05-12,0,0,18,0,FJ
2020-05-13,0,0,18,0,FJ
2020-05-14,0,0,18,0,FJ
2020-05-15,0,0,18,0,FJ
2020-05-16,0,0,18,0,FJ
2020-05-17,0,0,18,0,FJ
2020-05-18,0,0,18,0,FJ
2020-05-19,0,0,18,0,FJ
2020-05-20,0,0,18,0,FJ
2020-05-21,0,0,18,0,FJ
2020-05-22,0,0,18,0,FJ
2020-05-23,0,0,18,0,FJ
2020-05-24,0,0,18,0,FJ
2020-05-25,0,0,18,0,FJ
2020-05-26,0,0,18,0,FJ
2020-05-27,0,0,18,0,FJ
2020-05-28,0,0,18,0,FJ
2020-05-29,0,0,18,0,FJ
2020-05-30,0,0,18,0,FJ
2020-05-31,0,0,18,0,FJ
2020-06-01,0,0,18,0,FJ
2020-06-02,0,0,18,0,FJ
2020-06-03,0,0,18,0,FJ
2020-06-04,0,0,18,0,FJ
2020-06-05,0,0,18,0,FJ
2020-06-06,0,0,18,0,FJ
2020-06-07,0,0,18,0,FJ
2020-06-08,0,0,18,0,FJ
2020-06-09,0,0,18,0,FJ
2020-06-10,0,0,18,0,FJ
2020-06-11,0,0,18,0,FJ
2020-06-12,0,0,18,0,FJ
2020-06-13,0,0,18,0,FJ
2020-06-14,0,0,18,0,FJ
2020-06-15,0,0,18,0,FJ
2020-06-16,0,0,18,0,FJ
2020-06-17,0,0,18,0,FJ
2020-06-18,0,0,18,0,FJ
2020-06-19,0,0,18,0,FJ
2020-06-20,0,0,18,0,FJ
2020-06-21,0,0,18,0,FJ
2020-06-22,0,0,18,0,FJ
2020-06-23,0,0,18,0,FJ
2020-06-24,0,0,18,0,FJ
2020-06-25,0,0,18,0,FJ
2020-06-26,0,0,18,0,FJ
2020-06-27,0,0,18,0,FJ
2020-04-03,1,0,1,0,FK
2020-04-04,0,0,1,0,FK
2020-04-05,1,0,2,0,FK
2020-04-06,0,0,2,0,FK
2020-04-07,3,0,5,0,FK
2020-04-08,0,0,5,0,FK
2020-04-09,0,0,5,0,FK
2020-04-10,0,0,5,0,FK
2020-04-11,0,0,5,0,FK
2020-04-12,0,0,5,0,FK
2020-04-13,0,0,5,0,FK
2020-04-14,6,0,11,0,FK
2020-04-15,0,0,11,0,FK
2020-04-16,0,0,11,0,FK
2020-04-17,0,0,11,0,FK
2020-04-18,0,0,11,0,FK
2020-04-19,0,0,11,0,FK
2020-04-20,0,0,11,0,FK
2020-04-21,1,0,12,0,FK
2020-04-22,0,0,12,0,FK
2020-04-23,0,0,12,0,FK
2020-04-24,0,0,12,0,FK
2020-04-25,1,0,13,0,FK
2020-04-26,0,0,13,0,FK
2020-04-27,0,0,13,0,FK
2020-04-28,0,0,13,0,FK
2020-04-29,0,0,13,0,FK
2020-04-30,0,0,13,0,FK
2020-05-01,0,0,13,0,FK
2020-05-02,0,0,13,0,FK
2020-05-03,0,0,13,0,FK
2020-05-04,0,0,13,0,FK
2020-05-05,0,0,13,0,FK
2020-05-06,0,0,13,0,FK
2020-05-07,0,0,13,0,FK
2020-05-08,0,0,13,0,FK
2020-05-09,0,0,13,0,FK
2020-05-10,0,0,13,0,FK
2020-05-11,0,0,13,0,FK
2020-05-12,0,0,13,0,FK
2020-05-13,0,0,13,0,FK
2020-05-14,0,0,13,0,FK
2020-05-15,0,0,13,0,FK
2020-05-16,0,0,13,0,FK
2020-05-17,0,0,13,0,FK
2020-05-18,0,0,13,0,FK
2020-05-19,0,0,13,0,FK
2020-05-20,0,0,13,0,FK
2020-05-21,0,0,13,0,FK
2020-05-22,0,0,13,0,FK
2020-05-23,0,0,13,0,FK
2020-05-24,0,0,13,0,FK
2020-05-25,0,0,13,0,FK
2020-05-26,0,0,13,0,FK
2020-05-27,0,0,13,0,FK
2020-05-28,0,0,13,0,FK
2020-05-29,0,0,13,0,FK
2020-05-30,0,0,13,0,FK
2020-05-31,0,0,13,0,FK
2020-06-01,0,0,13,0,FK
2020-06-02,0,0,13,0,FK
2020-06-03,0,0,13,0,FK
2020-06-04,0,0,13,0,FK
2020-06-05,0,0,13,0,FK
2020-06-06,0,0,13,0,FK
2020-06-07,0,0,13,0,FK
2020-06-08,0,0,13,0,FK
2020-06-09,0,0,13,0,FK
2020-06-10,0,0,13,0,FK
2020-06-11,0,0,13,0,FK
2020-06-12,0,0,13,0,FK
2020-06-13,0,0,13,0,FK
2020-06-14,0,0,13,0,FK
2020-06-15,0,0,13,0,FK
2020-06-16,0,0,13,0,FK
2020-06-17,0,0,13,0,FK
2020-06-18,0,0,13,0,FK
2020-06-19,0,0,13,0,FK
2020-06-20,0,0,13,0,FK
2020-06-21,0,0,13,0,FK
2020-06-22,0,0,13,0,FK
2020-06-23,0,0,13,0,FK
2020-06-24,0,0,13,0,FK
2020-06-25,0,0,13,0,FK
2020-06-26,0,0,13,0,FK
2020-03-19,72,0,72,0,FO
2020-03-20,8,0,80,0,FO
2020-03-21,12,0,92,0,FO
2020-03-22,23,0,115,0,FO
2020-03-23,3,0,118,0,FO
2020-03-24,4,0,122,0,FO
2020-03-25,10,0,132,0,FO
2020-03-26,8,0,140,0,FO
2020-03-27,4,0,144,0,FO
2020-03-28,11,0,155,0,FO
2020-03-29,4,0,159,0,FO
2020-03-30,9,0,168,0,FO
2020-03-31,1,0,169,0,FO
2020-04-01,4,0,173,0,FO
2020-04-02,4,0,177,0,FO
2020-04-03,2,0,179,0,FO
2020-04-04,2,0,181,0,FO
2020-04-05,0,0,181,0,FO
2020-04-06,2,0,183,0,FO
2020-04-07,1,0,184,0,FO
2020-04-08,0,0,184,0,FO
2020-04-09,0,0,184,0,FO
2020-04-10,0,0,184,0,FO
2020-04-11,0,0,184,0,FO
2020-04-12,0,0,184,0,FO
2020-04-13,0,0,184,0,FO
2020-04-14,0,0,184,0,FO
2020-04-15,0,0,184,0,FO
2020-04-16,0,0,184,0,FO
2020-04-17,0,0,184,0,FO
2020-04-18,0,0,184,0,FO
2020-04-19,1,0,185,0,FO
2020-04-20,0,0,185,0,FO
2020-04-21,0,0,185,0,FO
2020-04-22,0,0,185,0,FO
2020-04-23,2,0,187,0,FO
2020-04-24,0,0,187,0,FO
2020-04-25,0,0,187,0,FO
2020-04-26,0,0,187,0,FO
2020-04-27,0,0,187,0,FO
2020-04-28,0,0,187,0,FO
2020-04-29,0,0,187,0,FO
2020-04-30,0,0,187,0,FO
2020-05-01,0,0,187,0,FO
2020-05-02,0,0,187,0,FO
2020-05-03,0,0,187,0,FO
2020-05-04,0,0,187,0,FO
2020-05-05,0,0,187,0,FO
2020-05-06,0,0,187,0,FO
2020-05-07,0,0,187,0,FO
2020-05-08,0,0,187,0,FO
2020-05-09,0,0,187,0,FO
2020-05-10,0,0,187,0,FO
2020-05-11,0,0,187,0,FO
2020-05-12,0,0,187,0,FO
2020-05-13,0,0,187,0,FO
2020-05-14,0,0,187,0,FO
2020-05-15,0,0,187,0,FO
2020-05-16,0,0,187,0,FO
2020-05-17,0,0,187,0,FO
2020-05-18,0,0,187,0,FO
2020-05-19,0,0,187,0,FO
2020-05-20,0,0,187,0,FO
2020-05-21,0,0,187,0,FO
2020-05-22,0,0,187,0,FO
2020-05-23,0,0,187,0,FO
2020-05-24,0,0,187,0,FO
2020-05-25,0,0,187,0,FO
2020-05-26,0,0,187,0,FO
2020-05-27,0,0,187,0,FO
2020-05-28,0,0,187,0,FO
2020-05-29,0,0,187,0,FO
2020-05-30,0,0,187,0,FO
2020-05-31,0,0,187,0,FO
2020-06-01,0,0,187,0,FO
2020-06-02,0,0,187,0,FO
2020-06-03,0,0,187,0,FO
2020-06-04,0,0,187,0,FO
2020-06-05,0,0,187,0,FO
2020-06-06,0,0,187,0,FO
2020-06-07,0,0,187,0,FO
2020-06-08,0,0,187,0,FO
2020-06-09,0,0,187,0,FO
2020-06-10,0,0,187,0,FO
2020-06-11,0,0,187,0,FO
2020-06-12,0,0,187,0,FO
2020-06-13,0,0,187,0,FO
2020-06-14,0,0,187,0,FO
2020-06-15,0,0,187,0,FO
2020-06-16,0,0,187,0,FO
2020-06-17,0,0,187,0,FO
2020-06-18,0,0,187,0,FO
2020-06-19,0,0,187,0,FO
2020-06-20,0,0,187,0,FO
2020-06-21,0,0,187,0,FO
2020-06-22,0,0,187,0,FO
2020-06-23,0,0,187,0,FO
2020-06-24,0,0,187,0,FO
2020-06-25,0,0,187,0,FO
2020-06-26,0,0,187,0,FO
2019-12-30,0,0,0,0,FR
2019-12-31,0,0,0,0,FR
2020-01-01,0,0,0,0,FR
2020-01-02,0,0,0,0,FR
2020-01-03,0,0,0,0,FR
2020-01-04,0,0,0,0,FR
2020-01-05,0,0,0,0,FR
2020-01-06,0,0,0,0,FR
2020-01-07,0,0,0,0,FR
2020-01-08,0,0,0,0,FR
2020-01-09,0,0,0,0,FR
2020-01-10,0,0,0,0,FR
2020-01-11,0,0,0,0,FR
2020-01-12,0,0,0,0,FR
2020-01-13,0,0,0,0,FR
2020-01-14,0,0,0,0,FR
2020-01-15,0,0,0,0,FR
2020-01-16,0,0,0,0,FR
2020-01-17,0,0,0,0,FR
2020-01-18,0,0,0,0,FR
2020-01-19,0,0,0,0,FR
2020-01-20,0,0,0,0,FR
2020-01-21,0,0,0,0,FR
2020-01-22,0,0,0,0,FR
2020-01-23,0,0,0,0,FR
2020-01-24,3,0,3,0,FR
2020-01-25,0,0,3,0,FR
2020-01-26,0,0,3,0,FR
2020-01-27,0,0,3,0,FR
2020-01-28,1,0,4,0,FR
2020-01-29,1,0,5,0,FR
2020-01-30,1,0,6,0,FR
2020-01-31,0,0,6,0,FR
2020-02-01,0,0,6,0,FR
2020-02-02,0,0,6,0,FR
2020-02-03,0,0,6,0,FR
2020-02-04,0,0,6,0,FR
2020-02-05,0,0,6,0,FR
2020-02-06,0,0,6,0,FR
2020-02-07,5,0,11,0,FR
2020-02-08,0,0,11,0,FR
2020-02-09,0,0,11,0,FR
2020-02-10,0,0,11,0,FR
2020-02-11,0,0,11,0,FR
2020-02-12,0,0,11,0,FR
2020-02-13,0,0,11,0,FR
2020-02-14,0,1,11,1,FR
2020-02-15,0,0,11,1,FR
2020-02-16,1,0,12,1,FR
2020-02-17,0,0,12,1,FR
2020-02-18,0,0,12,1,FR
2020-02-19,0,0,12,1,FR
2020-02-20,0,0,12,1,FR
2020-02-21,0,0,12,1,FR
2020-02-22,0,0,12,1,FR
2020-02-23,0,0,12,1,FR
2020-02-24,0,0,12,1,FR
2020-02-25,2,0,14,1,FR
2020-02-26,3,1,17,2,FR
2020-02-27,21,0,38,2,FR
2020-02-28,19,0,57,2,FR
2020-02-29,43,0,100,2,FR
2020-03-01,30,0,130,2,FR
2020-03-02,48,1,178,3,FR
2020-03-03,34,1,212,4,FR
2020-03-04,73,0,285,4,FR
2020-03-05,138,3,423,7,FR
2020-03-06,190,2,613,9,FR
2020-03-07,103,1,716,10,FR
2020-03-08,410,9,1126,19,FR
2020-03-09,286,11,1412,30,FR
2020-03-10,372,3,1784,33,FR
2020-03-11,497,15,2281,48,FR
2020-03-12,595,13,2876,61,FR
2020-03-13,785,18,3661,79,FR
2020-03-14,838,12,4499,91,FR
2020-03-15,924,36,5423,127,FR
2020-03-16,1210,21,6633,148,FR
2020-03-17,1097,27,7730,175,FR
2020-03-18,1404,69,9134,244,FR
2020-03-19,1861,128,10995,372,FR
2020-03-20,1617,78,12612,450,FR
2020-03-21,1847,112,14459,562,FR
2020-03-22,1559,112,16018,674,FR
2020-03-23,3838,186,19856,860,FR
2020-03-24,2446,240,22302,1100,FR
2020-03-25,2931,231,25233,1331,FR
2020-03-26,3922,365,29155,1696,FR
2020-03-27,3809,299,32964,1995,FR
2020-03-28,4611,319,37575,2314,FR
2020-03-29,2599,292,40174,2606,FR
2020-03-30,4376,418,44550,3024,FR
2020-03-31,7578,499,52128,3523,FR
2020-04-01,4861,509,56989,4032,FR
2020-04-02,2116,471,59105,4503,FR
2020-04-03,5233,2004,64338,6507,FR
2020-04-04,4267,1053,68605,7560,FR
2020-04-05,1873,518,70478,8078,FR
2020-04-06,3912,833,74390,8911,FR
2020-04-07,3777,1417,78167,10328,FR
2020-04-08,3881,541,82048,10869,FR
2020-04-09,4286,1341,86334,12210,FR
2020-04-10,4342,987,90676,13197,FR
2020-04-11,3114,635,93790,13832,FR
2020-04-12,1613,561,95403,14393,FR
2020-04-13,2673,574,98076,14967,FR
2020-04-14,5497,762,103573,15729,FR
2020-04-15,2633,1438,106206,17167,FR
2020-04-16,2641,753,108847,17920,FR
2020-04-17,405,761,109252,18681,FR
2020-04-18,2569,642,111821,19323,FR
2020-04-19,785,395,112606,19718,FR
2020-04-20,2051,547,114657,20265,FR
2020-04-21,2667,531,117324,20796,FR
2020-04-22,1827,544,119151,21340,FR
2020-04-23,1653,516,120804,21856,FR
2020-04-24,1773,389,122577,22245,FR
2020-04-25,1537,369,124114,22614,FR
2020-04-26,461,242,124575,22856,FR
2020-04-27,1195,437,125770,23293,FR
2020-04-28,1065,367,126835,23660,FR
2020-04-29,1607,427,128442,24087,FR
2020-04-30,1139,289,129581,24376,FR
2020-05-01,604,218,130185,24594,FR
2020-05-02,794,166,130979,24760,FR
2020-05-03,308,135,131287,24895,FR
2020-05-04,576,306,131863,25201,FR
2020-05-05,1104,330,132967,25531,FR
2020-05-06,4183,278,137150,25809,FR
2020-05-07,629,178,137779,25987,FR
2020-05-08,642,243,138421,26230,FR
2020-05-09,433,80,138854,26310,FR
2020-05-10,209,70,139063,26380,FR
2020-05-11,456,263,139519,26643,FR
2020-05-12,708,348,140227,26991,FR
2020-05-13,507,83,140734,27074,FR
2020-05-14,622,351,141356,27425,FR
2020-05-15,563,130,141919,27555,FR
2020-05-16,372,88,142291,27643,FR
2020-05-17,120,68,142411,27711,FR
2020-05-18,492,186,142903,27897,FR
2020-05-19,524,125,143427,28022,FR
2020-05-20,418,110,143845,28132,FR
2020-05-21,318,83,144163,28215,FR
2020-05-22,403,74,144566,28289,FR
2020-05-23,240,43,144806,28332,FR
2020-05-24,115,35,144921,28367,FR
2020-05-25,358,65,145279,28432,FR
2020-05-26,276,98,145555,28530,FR
2020-05-27,191,66,145746,28596,FR
2020-05-28,3325,66,149071,28662,FR
2020-05-29,597,52,149668,28714,FR
2020-05-30,1828,57,151496,28771,FR
2020-05-31,257,31,151753,28802,FR
2020-06-01,338,31,152091,28833,FR
2020-06-02,-766,107,151325,28940,FR
2020-06-03,352,81,151677,29021,FR
2020-06-04,767,44,152444,29065,FR
2020-06-05,611,46,153055,29111,FR
2020-06-06,579,31,153634,29142,FR
2020-06-07,343,13,153977,29155,FR
2020-06-08,211,54,154188,29209,FR
2020-06-09,403,87,154591,29296,FR
2020-06-10,545,23,155136,29319,FR
2020-06-11,425,27,155561,29346,FR
2020-06-12,726,28,156287,29374,FR
2020-06-13,526,24,156813,29398,FR
2020-06-14,407,9,157220,29407,FR
2020-06-15,152,29,157372,29436,FR
2020-06-16,344,111,157716,29547,FR
2020-06-17,458,28,158174,29575,FR
2020-06-18,467,28,158641,29603,FR
2020-06-19,811,14,159452,29617,FR
2020-06-20,641,16,160093,29633,FR
2020-06-21,284,7,160377,29640,FR
2020-06-22,373,23,160750,29663,FR
2020-06-23,517,57,161267,29720,FR
2020-06-24,81,11,161348,29731,FR
2020-06-25,0,21,161348,29752,FR
2020-06-26,1588,26,162936,29778,FR
2020-03-12,1,0,1,0,GA
2020-03-14,0,0,1,0,GA
2020-03-15,0,0,1,0,GA
2020-03-16,0,0,1,0,GA
2020-03-17,0,0,1,0,GA
2020-03-18,2,0,3,0,GA
2020-03-19,0,0,3,0,GA
2020-03-20,0,1,3,1,GA
2020-03-21,0,0,3,1,GA
2020-03-22,3,0,6,1,GA
2020-03-23,0,0,6,1,GA
2020-03-24,0,0,6,1,GA
2020-03-25,0,0,6,1,GA
2020-03-26,1,0,7,1,GA
2020-03-27,0,0,7,1,GA
2020-03-28,0,0,7,1,GA
2020-03-29,0,0,7,1,GA
2020-03-30,0,0,7,1,GA
2020-03-31,9,0,16,1,GA
2020-04-01,2,0,18,1,GA
2020-04-02,0,0,18,1,GA
2020-04-03,3,0,21,1,GA
2020-04-04,0,0,21,1,GA
2020-04-05,0,0,21,1,GA
2020-04-06,0,0,21,1,GA
2020-04-07,9,0,30,1,GA
2020-04-08,3,0,33,1,GA
2020-04-09,11,0,44,1,GA
2020-04-10,2,0,46,1,GA
2020-04-11,3,0,49,1,GA
2020-04-12,8,0,57,1,GA
2020-04-13,0,0,57,1,GA
2020-04-14,18,0,75,1,GA
2020-04-15,12,0,87,1,GA
2020-04-16,8,0,95,1,GA
2020-04-17,13,0,108,1,GA
2020-04-18,1,0,109,1,GA
2020-04-19,0,0,109,1,GA
2020-04-20,11,0,120,1,GA
2020-04-21,36,0,156,1,GA
2020-04-22,10,0,166,1,GA
2020-04-23,1,1,167,2,GA
2020-04-24,5,1,172,3,GA
2020-04-25,4,0,176,3,GA
2020-04-26,0,0,176,3,GA
2020-04-27,35,0,211,3,GA
2020-04-28,27,0,238,3,GA
2020-04-29,38,0,276,3,GA
2020-04-30,0,0,276,3,GA
2020-05-01,32,1,308,4,GA
2020-05-02,27,1,335,5,GA
2020-05-03,0,0,335,5,GA
2020-05-04,32,1,367,6,GA
2020-05-05,30,0,397,6,GA
2020-05-06,42,2,439,8,GA
2020-05-07,65,0,504,8,GA
2020-05-08,116,0,620,8,GA
2020-05-09,41,0,661,8,GA
2020-05-10,0,0,661,8,GA
2020-05-11,141,1,802,9,GA
2020-05-12,61,0,863,9,GA
2020-05-13,141,0,1004,9,GA
2020-05-14,100,1,1104,10,GA
2020-05-15,105,0,1209,10,GA
2020-05-16,111,1,1320,11,GA
2020-05-17,0,0,1320,11,GA
2020-05-18,112,0,1432,11,GA
2020-05-19,70,1,1502,12,GA
2020-05-20,65,0,1567,12,GA
2020-05-21,0,0,1567,12,GA
2020-05-22,161,0,1728,12,GA
2020-05-23,206,0,1934,12,GA
2020-05-24,0,0,1934,12,GA
2020-05-25,201,2,2135,14,GA
2020-05-26,103,0,2238,14,GA
2020-05-27,81,0,2319,14,GA
2020-05-28,112,0,2431,14,GA
2020-05-29,182,1,2613,15,GA
2020-05-30,42,2,2655,17,GA
2020-05-31,0,0,2655,17,GA
2020-06-01,0,0,2655,17,GA
2020-06-02,148,3,2803,20,GA
2020-06-03,99,0,2902,20,GA
2020-06-04,53,1,2955,21,GA
2020-06-05,146,0,3101,21,GA
2020-06-06,0,0,3101,21,GA
2020-06-07,0,0,3101,21,GA
2020-06-08,146,0,3247,21,GA
2020-06-09,47,0,3294,21,GA
2020-06-10,81,1,3375,22,GA
2020-06-11,88,1,3463,23,GA
2020-06-12,0,0,3463,23,GA
2020-06-13,0,0,3463,23,GA
2020-06-14,0,0,3463,23,GA
2020-06-15,570,4,4033,27,GA
2020-06-16,81,2,4114,29,GA
2020-06-17,115,1,4229,30,GA
2020-06-18,111,2,4340,32,GA
2020-06-19,88,2,4428,34,GA
2020-06-20,0,0,4428,34,GA
2020-06-21,0,0,4428,34,GA
2020-06-22,311,5,4739,39,GA
2020-06-23,134,0,4873,39,GA
2020-06-24,83,0,4956,39,GA
2020-06-25,131,1,5087,40,GA
2020-06-26,122,0,5209,40,GA
2019-12-30,0,0,0,0,GB
2019-12-31,0,0,0,0,GB
2020-01-01,0,0,0,0,GB
2020-01-02,0,0,0,0,GB
2020-01-03,0,0,0,0,GB
2020-01-04,0,0,0,0,GB
2020-01-05,0,0,0,0,GB
2020-01-06,0,0,0,0,GB
2020-01-07,0,0,0,0,GB
2020-01-08,0,0,0,0,GB
2020-01-09,0,0,0,0,GB
2020-01-10,0,0,0,0,GB
2020-01-11,0,0,0,0,GB
2020-01-12,0,0,0,0,GB
2020-01-13,0,0,0,0,GB
2020-01-14,0,0,0,0,GB
2020-01-15,0,0,0,0,GB
2020-01-16,0,0,0,0,GB
2020-01-17,0,0,0,0,GB
2020-01-18,0,0,0,0,GB
2020-01-19,0,0,0,0,GB
2020-01-20,0,0,0,0,GB
2020-01-21,0,0,0,0,GB
2020-01-22,0,0,0,0,GB
2020-01-23,0,0,0,0,GB
2020-01-24,0,0,0,0,GB
2020-01-25,0,0,0,0,GB
2020-01-26,0,0,0,0,GB
2020-01-27,0,0,0,0,GB
2020-01-28,0,0,0,0,GB
2020-01-29,0,0,0,0,GB
2020-01-30,2,0,2,0,GB
2020-01-31,0,0,2,0,GB
2020-02-01,0,0,2,0,GB
2020-02-02,0,0,2,0,GB
2020-02-03,0,0,2,0,GB
2020-02-04,0,0,2,0,GB
2020-02-05,0,0,2,0,GB
2020-02-06,1,0,3,0,GB
2020-02-07,0,0,3,0,GB
2020-02-08,1,0,4,0,GB
2020-02-09,0,0,4,0,GB
2020-02-10,4,0,8,0,GB
2020-02-11,0,0,8,0,GB
2020-02-12,1,0,9,0,GB
2020-02-13,0,0,9,0,GB
2020-02-14,0,0,9,0,GB
2020-02-15,0,0,9,0,GB
2020-02-16,0,0,9,0,GB
2020-02-17,0,0,9,0,GB
2020-02-18,0,0,9,0,GB
2020-02-19,0,0,9,0,GB
2020-02-20,0,0,9,0,GB
2020-02-21,0,0,9,0,GB
2020-02-22,0,0,9,0,GB
2020-02-23,4,0,13,0,GB
2020-02-24,0,0,13,0,GB
2020-02-25,0,0,13,0,GB
2020-02-26,0,0,13,0,GB
2020-02-27,3,0,16,0,GB
2020-02-28,2,0,18,0,GB
2020-02-29,5,0,23,0,GB
2020-03-01,13,0,36,0,GB
2020-03-02,4,0,40,0,GB
2020-03-03,11,0,51,0,GB
2020-03-04,34,0,85,0,GB
2020-03-05,30,0,115,0,GB
2020-03-06,48,1,163,1,GB
2020-03-07,43,1,206,2,GB
2020-03-08,67,0,273,2,GB
2020-03-09,48,1,321,3,GB
2020-03-10,52,4,373,7,GB
2020-03-11,83,0,456,7,GB
2020-03-12,134,2,590,9,GB
2020-03-13,117,1,707,10,GB
2020-03-14,433,18,1140,28,GB
2020-03-15,251,15,1391,43,GB
2020-03-16,152,22,1543,65,GB
2020-03-17,407,16,1950,81,GB
2020-03-18,680,34,2630,115,GB
2020-03-19,647,43,3277,158,GB
2020-03-20,706,36,3983,194,GB
2020-03-21,1035,56,5018,250,GB
2020-03-22,665,35,5683,285,GB
2020-03-23,967,74,6650,359,GB
2020-03-24,1427,149,8077,508,GB
2020-03-25,1452,186,9529,694,GB
2020-03-26,2129,183,11658,877,GB
2020-03-27,2885,284,14543,1161,GB
2020-03-28,2546,294,17089,1455,GB
2020-03-29,2433,214,19522,1669,GB
2020-03-30,2619,374,22141,2043,GB
2020-03-31,3009,382,25150,2425,GB
2020-04-01,4324,670,29474,3095,GB
2020-04-02,4244,652,33718,3747,GB
2020-04-03,4450,714,38168,4461,GB
2020-04-04,3735,760,41903,5221,GB
2020-04-05,5903,644,47806,5865,GB
2020-04-06,3802,568,51608,6433,GB
2020-04-07,3634,1038,55242,7471,GB
2020-04-08,5491,1034,60733,8505,GB
2020-04-09,4344,1103,65077,9608,GB
2020-04-10,5195,1152,70272,10760,GB
2020-04-11,8719,839,78991,11599,GB
2020-04-12,5288,686,84279,12285,GB
2020-04-13,4342,744,88621,13029,GB
2020-04-14,5252,1044,93873,14073,GB
2020-04-15,4603,842,98476,14915,GB
2020-04-16,4617,1029,103093,15944,GB
2020-04-17,5599,935,108692,16879,GB
2020-04-18,5525,1115,114217,17994,GB
2020-04-19,5850,498,120067,18492,GB
2020-04-20,4676,559,124743,19051,GB
2020-04-21,4301,1172,129044,20223,GB
2020-04-22,4451,837,133495,21060,GB
2020-04-23,4583,727,138078,21787,GB
2020-04-24,5386,1005,143464,22792,GB
2020-04-25,4913,843,148377,23635,GB
2020-04-26,4463,420,152840,24055,GB
2020-04-27,4309,338,157149,24393,GB
2020-04-28,3996,909,161145,25302,GB
2020-04-29,4076,795,165221,26097,GB
2020-04-30,6032,674,171253,26771,GB
2020-05-01,6201,739,177454,27510,GB
2020-05-02,4806,621,182260,28131,GB
2020-05-03,4339,315,186599,28446,GB
2020-05-04,3985,288,190584,28734,GB
2020-05-05,4406,693,194990,29427,GB
2020-05-06,6211,649,201201,30076,GB
2020-05-07,5514,539,206715,30615,GB
2020-05-08,4649,626,211364,31241,GB
2020-05-09,3896,346,215260,31587,GB
2020-05-10,3923,268,219183,31855,GB
2020-05-11,3877,210,223060,32065,GB
2020-05-12,3403,627,226463,32692,GB
2020-05-13,3242,494,229705,33186,GB
2020-05-14,3446,428,233151,33614,GB
2020-05-15,3560,384,236711,33998,GB
2020-05-16,3450,468,240161,34466,GB
2020-05-17,3534,170,243695,34636,GB
2020-05-18,2711,160,246406,34796,GB
2020-05-19,2412,545,248818,35341,GB
2020-05-20,-525,363,248293,35704,GB
2020-05-21,2615,338,250908,36042,GB
2020-05-22,3287,351,254195,36393,GB
2020-05-23,2959,282,257154,36675,GB
2020-05-24,2405,118,259559,36793,GB
2020-05-25,1625,121,261184,36914,GB
2020-05-26,4043,134,265227,37048,GB
2020-05-27,2013,412,267240,37460,GB
2020-05-28,1887,377,269127,37837,GB
2020-05-29,2095,324,271222,38161,GB
2020-05-30,1604,215,272826,38376,GB
2020-05-31,1936,113,274762,38489,GB
2020-06-01,1570,556,276332,39045,GB
2020-06-02,1653,324,277985,39369,GB
2020-06-03,1871,359,279856,39728,GB
2020-06-04,1805,176,281661,39904,GB
2020-06-05,1650,357,283311,40261,GB
2020-06-06,1557,204,284868,40465,GB
2020-06-07,1326,77,286194,40542,GB
2020-06-08,1205,55,287399,40597,GB
2020-06-09,1741,286,289140,40883,GB
2020-06-10,1003,245,290143,41128,GB
2020-06-11,1266,151,291409,41279,GB
2020-06-12,1541,202,292950,41481,GB
2020-06-13,1425,181,294375,41662,GB
2020-06-14,1514,36,295889,41698,GB
2020-06-15,968,38,296857,41736,GB
2020-06-16,1279,233,298136,41969,GB
2020-06-17,1115,184,299251,42153,GB
2020-06-18,1218,135,300469,42288,GB
2020-06-19,1346,173,301815,42461,GB
2020-06-20,1295,128,303110,42589,GB
2020-06-21,1221,43,304331,42632,GB
2020-06-22,958,15,305289,42647,GB
2020-06-23,921,280,306210,42927,GB
2020-06-24,652,154,306862,43081,GB
2020-06-25,1118,149,307980,43230,GB
2020-06-26,1380,184,309360,43414,GB
2020-03-23,1,0,1,0,GD
2020-03-24,0,0,1,0,GD
2020-03-25,0,0,1,0,GD
2020-03-26,0,0,1,0,GD
2020-03-27,6,0,7,0,GD
2020-03-28,0,0,7,0,GD
2020-03-29,2,0,9,0,GD
2020-03-30,0,0,9,0,GD
2020-03-31,0,0,9,0,GD
2020-04-01,0,0,9,0,GD
2020-04-02,1,0,10,0,GD
2020-04-03,0,0,10,0,GD
2020-04-04,2,0,12,0,GD
2020-04-05,0,0,12,0,GD
2020-04-06,0,0,12,0,GD
2020-04-07,0,0,12,0,GD
2020-04-08,0,0,12,0,GD
2020-04-09,0,0,12,0,GD
2020-04-10,0,0,12,0,GD
2020-04-11,2,0,14,0,GD
2020-04-12,0,0,14,0,GD
2020-04-13,0,0,14,0,GD
2020-04-14,0,0,14,0,GD
2020-04-15,0,0,14,0,GD
2020-04-16,0,0,14,0,GD
2020-04-17,0,0,14,0,GD
2020-04-18,0,0,14,0,GD
2020-04-19,0,0,14,0,GD
2020-04-20,0,0,14,0,GD
2020-04-21,0,0,14,0,GD
2020-04-22,0,0,14,0,GD
2020-04-23,1,0,15,0,GD
2020-04-24,0,0,15,0,GD
2020-04-25,0,0,15,0,GD
2020-04-26,3,0,18,0,GD
2020-04-27,0,0,18,0,GD
2020-04-28,0,0,18,0,GD
2020-04-29,0,0,18,0,GD
2020-04-30,2,0,20,0,GD
2020-05-01,0,0,20,0,GD
2020-05-02,0,0,20,0,GD
2020-05-03,1,0,21,0,GD
2020-05-04,0,0,21,0,GD
2020-05-05,0,0,21,0,GD
2020-05-06,0,0,21,0,GD
2020-05-07,0,0,21,0,GD
2020-05-08,0,0,21,0,GD
2020-05-09,0,0,21,0,GD
2020-05-10,0,0,21,0,GD
2020-05-11,0,0,21,0,GD
2020-05-12,0,0,21,0,GD
2020-05-13,0,0,21,0,GD
2020-05-14,0,0,21,0,GD
2020-05-15,0,0,21,0,GD
2020-05-16,1,0,22,0,GD
2020-05-17,0,0,22,0,GD
2020-05-18,0,0,22,0,GD
2020-05-19,0,0,22,0,GD
2020-05-20,0,0,22,0,GD
2020-05-21,0,0,22,0,GD
2020-05-22,0,0,22,0,GD
2020-05-23,0,0,22,0,GD
2020-05-24,0,0,22,0,GD
2020-05-25,0,0,22,0,GD
2020-05-26,1,0,23,0,GD
2020-05-27,0,0,23,0,GD
2020-05-28,0,0,23,0,GD
2020-05-29,0,0,23,0,GD
2020-05-30,0,0,23,0,GD
2020-05-31,0,0,23,0,GD
2020-06-01,0,0,23,0,GD
2020-06-02,0,0,23,0,GD
2020-06-03,0,0,23,0,GD
2020-06-04,0,0,23,0,GD
2020-06-05,0,0,23,0,GD
2020-06-06,0,0,23,0,GD
2020-06-07,0,0,23,0,GD
2020-06-08,0,0,23,0,GD
2020-06-09,0,0,23,0,GD
2020-06-10,0,0,23,0,GD
2020-06-11,0,0,23,0,GD
2020-06-12,0,0,23,0,GD
2020-06-13,0,0,23,0,GD
2020-06-14,0,0,23,0,GD
2020-06-15,0,0,23,0,GD
2020-06-16,0,0,23,0,GD
2020-06-17,0,0,23,0,GD
2020-06-18,0,0,23,0,GD
2020-06-19,0,0,23,0,GD
2020-06-20,0,0,23,0,GD
2020-06-21,0,0,23,0,GD
2020-06-22,0,0,23,0,GD
2020-06-23,0,0,23,0,GD
2020-06-24,0,0,23,0,GD
2020-06-25,0,0,23,0,GD
2020-06-26,0,0,23,0,GD
2020-06-27,0,0,23,0,GD
2019-12-30,0,0,0,0,GE
2019-12-31,0,0,0,0,GE
2020-01-01,0,0,0,0,GE
2020-01-02,0,0,0,0,GE
2020-01-03,0,0,0,0,GE
2020-01-04,0,0,0,0,GE
2020-01-05,0,0,0,0,GE
2020-01-06,0,0,0,0,GE
2020-01-07,0,0,0,0,GE
2020-01-08,0,0,0,0,GE
2020-01-09,0,0,0,0,GE
2020-01-10,0,0,0,0,GE
2020-01-11,0,0,0,0,GE
2020-01-12,0,0,0,0,GE
2020-01-13,0,0,0,0,GE
2020-01-14,0,0,0,0,GE
2020-01-15,0,0,0,0,GE
2020-01-16,0,0,0,0,GE
2020-01-17,0,0,0,0,GE
2020-01-18,0,0,0,0,GE
2020-01-19,0,0,0,0,GE
2020-01-20,0,0,0,0,GE
2020-01-21,0,0,0,0,GE
2020-01-22,0,0,0,0,GE
2020-01-23,0,0,0,0,GE
2020-01-24,0,0,0,0,GE
2020-01-25,0,0,0,0,GE
2020-01-26,0,0,0,0,GE
2020-01-27,0,0,0,0,GE
2020-01-28,0,0,0,0,GE
2020-01-29,0,0,0,0,GE
2020-01-30,0,0,0,0,GE
2020-01-31,0,0,0,0,GE
2020-02-01,0,0,0,0,GE
2020-02-02,0,0,0,0,GE
2020-02-03,0,0,0,0,GE
2020-02-04,0,0,0,0,GE
2020-02-05,0,0,0,0,GE
2020-02-06,0,0,0,0,GE
2020-02-07,0,0,0,0,GE
2020-02-08,0,0,0,0,GE
2020-02-09,0,0,0,0,GE
2020-02-10,0,0,0,0,GE
2020-02-11,0,0,0,0,GE
2020-02-12,0,0,0,0,GE
2020-02-13,0,0,0,0,GE
2020-02-14,0,0,0,0,GE
2020-02-15,0,0,0,0,GE
2020-02-16,0,0,0,0,GE
2020-02-17,0,0,0,0,GE
2020-02-18,0,0,0,0,GE
2020-02-19,0,0,0,0,GE
2020-02-20,0,0,0,0,GE
2020-02-21,0,0,0,0,GE
2020-02-22,0,0,0,0,GE
2020-02-23,0,0,0,0,GE
2020-02-24,0,0,0,0,GE
2020-02-25,0,0,0,0,GE
2020-02-26,1,0,1,0,GE
2020-02-27,0,0,1,0,GE
2020-02-28,1,0,2,0,GE
2020-02-29,1,0,3,0,GE
2020-03-01,0,0,3,0,GE
2020-03-04,0,0,3,0,GE
2020-03-05,6,0,9,0,GE
2020-03-07,3,0,12,0,GE
2020-03-08,1,0,13,0,GE
2020-03-09,2,0,15,0,GE
2020-03-10,8,0,23,0,GE
2020-03-11,1,0,24,0,GE
2020-03-12,1,0,25,0,GE
2020-03-13,5,0,30,0,GE
2020-03-14,0,0,30,0,GE
2020-03-15,0,0,30,0,GE
2020-03-16,3,0,33,0,GE
2020-03-17,1,0,34,0,GE
2020-03-18,0,0,34,0,GE
2020-03-19,6,0,40,0,GE
2020-03-20,3,0,43,0,GE
2020-03-21,6,0,49,0,GE
2020-03-22,5,0,54,0,GE
2020-03-23,7,0,61,0,GE
2020-03-24,9,0,70,0,GE
2020-03-25,3,0,73,0,GE
2020-03-26,6,0,79,0,GE
2020-03-27,2,0,81,0,GE
2020-03-28,4,0,85,0,GE
2020-03-29,5,0,90,0,GE
2020-03-30,8,0,98,0,GE
2020-03-31,12,0,110,0,GE
2020-04-01,5,0,115,0,GE
2020-04-02,6,0,121,0,GE
2020-04-03,27,0,148,0,GE
2020-04-04,9,0,157,0,GE
2020-04-05,17,2,174,2,GE
2020-04-06,14,0,188,2,GE
2020-04-07,8,1,196,3,GE
2020-04-08,15,0,211,3,GE
2020-04-09,7,0,218,3,GE
2020-04-10,16,0,234,3,GE
2020-04-11,8,0,242,3,GE
2020-04-12,15,0,257,3,GE
2020-04-13,15,0,272,3,GE
2020-04-14,28,0,300,3,GE
2020-04-15,6,0,306,3,GE
2020-04-16,42,0,348,3,GE
2020-04-17,22,0,370,3,GE
2020-04-18,18,1,388,4,GE
2020-04-19,6,0,394,4,GE
2020-04-20,8,0,402,4,GE
2020-04-21,6,0,408,4,GE
2020-04-22,8,1,416,5,GE
2020-04-23,9,0,425,5,GE
2020-04-24,19,0,444,5,GE
2020-04-25,12,0,456,5,GE
2020-04-26,30,1,486,6,GE
2020-04-27,11,0,497,6,GE
2020-04-28,14,0,511,6,GE
2020-04-29,6,0,517,6,GE
2020-04-30,22,0,539,6,GE
2020-05-01,43,2,582,8,GE
2020-05-02,0,0,582,8,GE
2020-05-03,7,1,589,9,GE
2020-05-04,4,0,593,9,GE
2020-05-05,11,0,604,9,GE
2020-05-06,6,0,610,9,GE
2020-05-07,5,0,615,9,GE
2020-05-08,8,1,623,10,GE
2020-05-09,3,0,626,10,GE
2020-05-10,9,0,635,10,GE
2020-05-11,3,1,638,11,GE
2020-05-12,4,0,642,11,GE
2020-05-13,5,0,647,11,GE
2020-05-14,20,1,667,12,GE
2020-05-15,4,0,671,12,GE
2020-05-16,24,0,695,12,GE
2020-05-17,6,0,701,12,GE
2020-05-18,1,0,702,12,GE
2020-05-19,5,0,707,12,GE
2020-05-20,6,0,713,12,GE
2020-05-21,8,0,721,12,GE
2020-05-22,2,0,723,12,GE
2020-05-23,5,0,728,12,GE
2020-05-24,2,0,730,12,GE
2020-05-25,1,0,731,12,GE
2020-05-26,1,0,732,12,GE
2020-05-27,3,0,735,12,GE
2020-05-28,3,0,738,12,GE
2020-05-29,8,0,746,12,GE
2020-05-30,11,0,757,12,GE
2020-05-31,26,0,783,12,GE
2020-06-01,13,0,796,12,GE
2020-06-02,4,1,800,13,GE
2020-06-03,0,0,800,13,GE
2020-06-04,1,0,801,13,GE
2020-06-05,4,0,805,13,GE
2020-06-06,3,0,808,13,GE
2020-06-07,0,0,808,13,GE
2020-06-08,4,0,812,13,GE
2020-06-09,6,0,818,13,GE
2020-06-10,9,0,827,13,GE
2020-06-11,4,0,831,13,GE
2020-06-12,12,0,843,13,GE
2020-06-13,8,1,851,14,GE
2020-06-14,28,0,879,14,GE
2020-06-15,0,0,879,14,GE
2020-06-16,9,0,888,14,GE
2020-06-17,5,0,893,14,GE
2020-06-18,2,0,895,14,GE
2020-06-19,1,0,896,14,GE
2020-06-20,2,0,898,14,GE
2020-06-21,10,0,908,14,GE
2020-06-22,3,0,911,14,GE
2020-06-23,3,0,914,14,GE
2020-06-24,3,0,917,14,GE
2020-06-25,2,0,919,14,GE
2020-06-26,2,0,921,14,GE
2020-03-19,1,0,1,0,GG
2020-03-20,0,0,1,0,GG
2020-03-21,0,0,1,0,GG
2020-03-22,16,0,17,0,GG
2020-03-23,3,0,20,0,GG
2020-03-24,3,0,23,0,GG
2020-03-25,7,0,30,0,GG
2020-03-26,4,0,34,0,GG
2020-03-27,2,0,36,0,GG
2020-03-28,3,0,39,0,GG
2020-03-29,6,0,45,0,GG
2020-03-30,0,0,45,0,GG
2020-03-31,15,0,60,0,GG
2020-04-01,18,0,78,0,GG
2020-04-02,13,0,91,0,GG
2020-04-03,23,2,114,2,GG
2020-04-04,22,0,136,2,GG
2020-04-05,18,1,154,3,GG
2020-04-06,11,1,165,4,GG
2020-04-07,1,0,166,4,GG
2020-04-08,15,1,181,5,GG
2020-04-09,10,0,191,5,GG
2020-04-10,9,1,200,6,GG
2020-04-11,9,0,209,6,GG
2020-04-12,9,0,218,6,GG
2020-04-13,1,0,219,6,GG
2020-04-14,4,1,223,7,GG
2020-04-15,0,0,223,7,GG
2020-04-16,11,2,234,9,GG
2020-04-17,0,0,234,9,GG
2020-04-18,5,0,239,9,GG
2020-04-19,0,0,239,9,GG
2020-04-20,0,1,239,10,GG
2020-04-21,0,0,239,10,GG
2020-04-22,4,0,243,10,GG
2020-04-23,2,0,245,10,GG
2020-04-24,0,1,245,11,GG
2020-04-25,0,1,245,12,GG
2020-04-26,2,1,247,13,GG
2020-04-27,0,0,247,13,GG
2020-04-28,0,0,247,13,GG
2020-04-29,4,0,251,13,GG
2020-04-30,0,0,251,13,GG
2020-05-01,1,0,252,13,GG
2020-05-02,0,0,252,13,GG
2020-05-03,0,0,252,13,GG
2020-05-04,0,0,252,13,GG
2020-05-05,0,0,252,13,GG
2020-05-06,0,0,252,13,GG
2020-05-07,0,0,252,13,GG
2020-05-08,0,0,252,13,GG
2020-05-09,0,0,252,13,GG
2020-05-10,0,0,252,13,GG
2020-05-11,0,0,252,13,GG
2020-05-12,0,0,252,13,GG
2020-05-13,0,0,252,13,GG
2020-05-14,0,0,252,13,GG
2020-05-15,0,0,252,13,GG
2020-05-16,0,0,252,13,GG
2020-05-17,0,0,252,13,GG
2020-05-18,0,0,252,13,GG
2020-05-19,0,0,252,13,GG
2020-05-20,0,0,252,13,GG
2020-05-21,0,0,252,13,GG
2020-05-22,0,0,252,13,GG
2020-05-23,0,0,252,13,GG
2020-05-24,0,0,252,13,GG
2020-05-25,0,0,252,13,GG
2020-05-26,0,0,252,13,GG
2020-05-27,0,0,252,13,GG
2020-05-28,0,0,252,13,GG
2020-05-29,0,0,252,13,GG
2020-05-30,0,0,252,13,GG
2020-05-31,0,0,252,13,GG
2020-06-01,0,0,252,13,GG
2020-06-02,0,0,252,13,GG
2020-06-03,0,0,252,13,GG
2020-06-04,0,0,252,13,GG
2020-06-05,0,0,252,13,GG
2020-06-06,0,0,252,13,GG
2020-06-07,0,0,252,13,GG
2020-06-08,0,0,252,13,GG
2020-06-09,0,0,252,13,GG
2020-06-10,0,0,252,13,GG
2020-06-11,0,0,252,13,GG
2020-06-12,0,0,252,13,GG
2020-06-13,0,0,252,13,GG
2020-06-14,0,0,252,13,GG
2020-06-15,0,0,252,13,GG
2020-06-16,0,0,252,13,GG
2020-06-17,0,0,252,13,GG
2020-06-18,0,0,252,13,GG
2020-06-19,0,0,252,13,GG
2020-06-20,0,0,252,13,GG
2020-06-21,0,0,252,13,GG
2020-06-22,0,0,252,13,GG
2020-06-23,0,0,252,13,GG
2020-06-24,0,0,252,13,GG
2020-06-25,0,0,252,13,GG
2020-06-26,0,0,252,13,GG
2020-03-12,2,0,2,0,GH
2020-03-14,0,0,2,0,GH
2020-03-15,0,0,2,0,GH
2020-03-16,4,0,6,0,GH
2020-03-17,0,0,6,0,GH
2020-03-18,1,0,7,0,GH
2020-03-19,4,0,11,0,GH
2020-03-20,5,0,16,0,GH
2020-03-21,5,1,21,1,GH
2020-03-22,3,0,24,1,GH
2020-03-23,3,1,27,2,GH
2020-03-24,26,0,53,2,GH
2020-03-25,15,1,68,3,GH
2020-03-26,64,0,132,3,GH
2020-03-27,5,0,137,3,GH
2020-03-28,4,2,141,5,GH
2020-03-29,11,0,152,5,GH
2020-03-30,0,0,152,5,GH
2020-03-31,0,0,152,5,GH
2020-04-01,43,0,195,5,GH
2020-04-02,9,0,204,5,GH
2020-04-03,1,0,205,5,GH
2020-04-04,9,0,214,5,GH
2020-04-05,0,0,214,5,GH
2020-04-06,73,0,287,5,GH
2020-04-07,0,0,287,5,GH
2020-04-08,26,1,313,6,GH
2020-04-09,65,0,378,6,GH
2020-04-10,0,0,378,6,GH
2020-04-11,30,2,408,8,GH
2020-04-12,158,0,566,8,GH
2020-04-13,0,0,566,8,GH
2020-04-14,70,0,636,8,GH
2020-04-15,5,0,641,8,GH
2020-04-16,0,0,641,8,GH
2020-04-17,0,0,641,8,GH
2020-04-18,193,1,834,9,GH
2020-04-19,208,0,1042,9,GH
2020-04-20,0,0,1042,9,GH
2020-04-21,0,0,1042,9,GH
2020-04-22,112,0,1154,9,GH
2020-04-23,0,0,1154,9,GH
2020-04-24,125,1,1279,10,GH
2020-04-25,0,0,1279,10,GH
2020-04-26,271,1,1550,11,GH
2020-04-27,0,0,1550,11,GH
2020-04-28,121,5,1671,16,GH
2020-04-29,0,0,1671,16,GH
2020-04-30,403,1,2074,17,GH
2020-05-01,0,0,2074,17,GH
2020-05-02,95,1,2169,18,GH
2020-05-03,0,0,2169,18,GH
2020-05-04,550,0,2719,18,GH
2020-05-05,0,0,2719,18,GH
2020-05-06,372,0,3091,18,GH
2020-05-07,0,0,3091,18,GH
2020-05-08,921,0,4012,18,GH
2020-05-09,251,4,4263,22,GH
2020-05-10,0,0,4263,22,GH
2020-05-11,437,0,4700,22,GH
2020-05-12,427,0,5127,22,GH
2020-05-13,281,2,5408,24,GH
2020-05-14,122,0,5530,24,GH
2020-05-15,108,4,5638,28,GH
2020-05-16,97,1,5735,29,GH
2020-05-17,0,0,5735,29,GH
2020-05-18,0,0,5735,29,GH
2020-05-19,361,2,6096,31,GH
2020-05-20,173,0,6269,31,GH
2020-05-21,217,0,6486,31,GH
2020-05-22,131,0,6617,31,GH
2020-05-23,0,0,6617,31,GH
2020-05-24,66,1,6683,32,GH
2020-05-25,125,0,6808,32,GH
2020-05-26,309,2,7117,34,GH
2020-05-27,186,0,7303,34,GH
2020-05-28,0,0,7303,34,GH
2020-05-29,313,0,7616,34,GH
2020-05-30,152,1,7768,35,GH
2020-05-31,302,1,8070,36,GH
2020-06-01,0,0,8070,36,GH
2020-06-02,227,2,8297,38,GH
2020-06-03,251,0,8548,38,GH
2020-06-04,337,0,8885,38,GH
2020-06-05,283,4,9168,42,GH
2020-06-06,294,2,9462,44,GH
2020-06-07,176,0,9638,44,GH
2020-06-08,272,4,9910,48,GH
2020-06-09,291,0,10201,48,GH
2020-06-10,157,0,10358,48,GH
2020-06-11,0,0,10358,48,GH
2020-06-12,760,0,11118,48,GH
2020-06-13,304,3,11422,51,GH
2020-06-14,542,3,11964,54,GH
2020-06-15,0,0,11964,54,GH
2020-06-16,229,4,12193,58,GH
2020-06-17,397,8,12590,66,GH
2020-06-18,339,0,12929,66,GH
2020-06-19,274,4,13203,70,GH
2020-06-20,508,15,13711,85,GH
2020-06-21,443,0,14154,85,GH
2020-06-22,0,0,14154,85,GH
2020-06-23,414,10,14568,95,GH
2020-06-24,445,0,15013,95,GH
2020-06-25,460,0,15473,95,GH
2020-06-26,361,8,15834,103,GH
2020-03-19,10,0,10,0,GI
2020-03-20,0,0,10,0,GI
2020-03-21,0,0,10,0,GI
2020-03-22,5,0,15,0,GI
2020-03-23,0,0,15,0,GI
2020-03-24,0,0,15,0,GI
2020-03-25,11,0,26,0,GI
2020-03-26,9,0,35,0,GI
2020-03-27,20,0,55,0,GI
2020-03-28,1,0,56,0,GI
2020-03-29,9,0,65,0,GI
2020-03-30,4,0,69,0,GI
2020-03-31,0,0,69,0,GI
2020-04-01,0,0,69,0,GI
2020-04-02,19,0,88,0,GI
2020-04-03,7,0,95,0,GI
2020-04-04,3,0,98,0,GI
2020-04-05,5,0,103,0,GI
2020-04-06,6,0,109,0,GI
2020-04-07,4,0,113,0,GI
2020-04-08,7,0,120,0,GI
2020-04-09,3,0,123,0,GI
2020-04-10,4,0,127,0,GI
2020-04-11,2,0,129,0,GI
2020-04-12,0,0,129,0,GI
2020-04-13,0,0,129,0,GI
2020-04-14,0,0,129,0,GI
2020-04-15,2,0,131,0,GI
2020-04-16,2,0,133,0,GI
2020-04-17,0,0,133,0,GI
2020-04-18,0,0,133,0,GI
2020-04-19,0,0,133,0,GI
2020-04-20,0,0,133,0,GI
2020-04-21,0,0,133,0,GI
2020-04-22,0,0,133,0,GI
2020-04-23,0,0,133,0,GI
2020-04-24,0,0,133,0,GI
2020-04-25,3,0,136,0,GI
2020-04-26,5,0,141,0,GI
2020-04-27,0,0,141,0,GI
2020-04-28,0,0,141,0,GI
2020-04-29,0,0,141,0,GI
2020-04-30,3,0,144,0,GI
2020-05-01,0,0,144,0,GI
2020-05-02,0,0,144,0,GI
2020-05-03,0,0,144,0,GI
2020-05-04,0,0,144,0,GI
2020-05-05,0,0,144,0,GI
2020-05-06,0,0,144,0,GI
2020-05-07,0,0,144,0,GI
2020-05-08,2,0,146,0,GI
2020-05-09,0,0,146,0,GI
2020-05-10,0,0,146,0,GI
2020-05-11,1,0,147,0,GI
2020-05-12,0,0,147,0,GI
2020-05-13,0,0,147,0,GI
2020-05-14,0,0,147,0,GI
2020-05-15,0,0,147,0,GI
2020-05-16,0,0,147,0,GI
2020-05-17,0,0,147,0,GI
2020-05-18,0,0,147,0,GI
2020-05-19,0,0,147,0,GI
2020-05-20,2,0,149,0,GI
2020-05-21,2,0,151,0,GI
2020-05-22,0,0,151,0,GI
2020-05-23,0,0,151,0,GI
2020-05-24,0,0,151,0,GI
2020-05-25,4,0,155,0,GI
2020-05-26,0,0,155,0,GI
2020-05-27,2,0,157,0,GI
2020-05-28,0,0,157,0,GI
2020-05-29,4,0,161,0,GI
2020-05-30,0,0,161,0,GI
2020-05-31,8,0,169,0,GI
2020-06-01,1,0,170,0,GI
2020-06-02,2,0,172,0,GI
2020-06-03,1,0,173,0,GI
2020-06-04,0,0,173,0,GI
2020-06-05,1,0,174,0,GI
2020-06-06,0,0,174,0,GI
2020-06-07,1,0,175,0,GI
2020-06-08,1,0,176,0,GI
2020-06-09,0,0,176,0,GI
2020-06-10,0,0,176,0,GI
2020-06-11,0,0,176,0,GI
2020-06-12,0,0,176,0,GI
2020-06-13,0,0,176,0,GI
2020-06-14,0,0,176,0,GI
2020-06-15,0,0,176,0,GI
2020-06-16,0,0,176,0,GI
2020-06-17,0,0,176,0,GI
2020-06-18,0,0,176,0,GI
2020-06-19,0,0,176,0,GI
2020-06-20,0,0,176,0,GI
2020-06-21,0,0,176,0,GI
2020-06-22,0,0,176,0,GI
2020-06-23,0,0,176,0,GI
2020-06-24,0,0,176,0,GI
2020-06-25,0,0,176,0,GI
2020-06-26,0,0,176,0,GI
2020-03-19,2,0,2,0,GL
2020-03-20,0,0,2,0,GL
2020-03-21,0,0,2,0,GL
2020-03-22,0,0,2,0,GL
2020-03-23,2,0,4,0,GL
2020-03-24,0,0,4,0,GL
2020-03-25,1,0,5,0,GL
2020-03-26,1,0,6,0,GL
2020-03-27,3,0,9,0,GL
2020-03-28,1,0,10,0,GL
2020-03-29,0,0,10,0,GL
2020-03-30,0,0,10,0,GL
2020-03-31,0,0,10,0,GL
2020-04-01,0,0,10,0,GL
2020-04-02,0,0,10,0,GL
2020-04-03,0,0,10,0,GL
2020-04-04,0,0,10,0,GL
2020-04-05,1,0,11,0,GL
2020-04-06,0,0,11,0,GL
2020-04-07,0,0,11,0,GL
2020-04-08,0,0,11,0,GL
2020-04-09,0,0,11,0,GL
2020-04-10,0,0,11,0,GL
2020-04-11,0,0,11,0,GL
2020-04-12,0,0,11,0,GL
2020-04-13,0,0,11,0,GL
2020-04-14,0,0,11,0,GL
2020-04-15,0,0,11,0,GL
2020-04-16,0,0,11,0,GL
2020-04-17,0,0,11,0,GL
2020-04-18,0,0,11,0,GL
2020-04-19,0,0,11,0,GL
2020-04-20,0,0,11,0,GL
2020-04-21,0,0,11,0,GL
2020-04-22,0,0,11,0,GL
2020-04-23,0,0,11,0,GL
2020-04-24,0,0,11,0,GL
2020-04-25,0,0,11,0,GL
2020-04-26,0,0,11,0,GL
2020-04-27,0,0,11,0,GL
2020-04-28,0,0,11,0,GL
2020-04-29,0,0,11,0,GL
2020-04-30,0,0,11,0,GL
2020-05-01,0,0,11,0,GL
2020-05-02,0,0,11,0,GL
2020-05-03,0,0,11,0,GL
2020-05-04,0,0,11,0,GL
2020-05-05,0,0,11,0,GL
2020-05-06,0,0,11,0,GL
2020-05-07,0,0,11,0,GL
2020-05-08,0,0,11,0,GL
2020-05-09,0,0,11,0,GL
2020-05-10,0,0,11,0,GL
2020-05-11,0,0,11,0,GL
2020-05-12,0,0,11,0,GL
2020-05-13,0,0,11,0,GL
2020-05-14,0,0,11,0,GL
2020-05-15,0,0,11,0,GL
2020-05-16,0,0,11,0,GL
2020-05-17,0,0,11,0,GL
2020-05-18,0,0,11,0,GL
2020-05-19,0,0,11,0,GL
2020-05-20,0,0,11,0,GL
2020-05-21,0,0,11,0,GL
2020-05-22,0,0,11,0,GL
2020-05-23,0,0,11,0,GL
2020-05-24,0,0,11,0,GL
2020-05-25,1,0,12,0,GL
2020-05-26,0,0,12,0,GL
2020-05-27,0,0,12,0,GL
2020-05-28,1,0,13,0,GL
2020-05-29,0,0,13,0,GL
2020-05-30,0,0,13,0,GL
2020-05-31,0,0,13,0,GL
2020-06-01,0,0,13,0,GL
2020-06-02,0,0,13,0,GL
2020-06-03,0,0,13,0,GL
2020-06-04,0,0,13,0,GL
2020-06-05,0,0,13,0,GL
2020-06-06,0,0,13,0,GL
2020-06-07,0,0,13,0,GL
2020-06-08,0,0,13,0,GL
2020-06-09,0,0,13,0,GL
2020-06-10,0,0,13,0,GL
2020-06-11,0,0,13,0,GL
2020-06-12,0,0,13,0,GL
2020-06-13,0,0,13,0,GL
2020-06-14,0,0,13,0,GL
2020-06-15,0,0,13,0,GL
2020-06-16,0,0,13,0,GL
2020-06-17,0,0,13,0,GL
2020-06-18,0,0,13,0,GL
2020-06-19,0,0,13,0,GL
2020-06-20,0,0,13,0,GL
2020-06-21,0,0,13,0,GL
2020-06-22,0,0,13,0,GL
2020-06-23,0,0,13,0,GL
2020-06-24,0,0,13,0,GL
2020-06-25,0,0,13,0,GL
2020-06-26,0,0,13,0,GL
2020-03-17,1,0,1,0,GM
2020-03-18,0,0,1,0,GM
2020-03-19,0,0,1,0,GM
2020-03-20,0,0,1,0,GM
2020-03-21,0,0,1,0,GM
2020-03-22,0,0,1,0,GM
2020-03-23,1,1,2,1,GM
2020-03-24,1,0,3,1,GM
2020-03-25,0,0,3,1,GM
2020-03-26,0,0,3,1,GM
2020-03-27,0,0,3,1,GM
2020-03-28,0,0,3,1,GM
2020-03-29,0,0,3,1,GM
2020-03-30,1,0,4,1,GM
2020-03-31,0,0,4,1,GM
2020-04-01,0,0,4,1,GM
2020-04-02,0,0,4,1,GM
2020-04-03,0,0,4,1,GM
2020-04-04,0,0,4,1,GM
2020-04-05,0,0,4,1,GM
2020-04-06,0,0,4,1,GM
2020-04-07,0,0,4,1,GM
2020-04-08,0,0,4,1,GM
2020-04-09,0,0,4,1,GM
2020-04-10,0,0,4,1,GM
2020-04-11,5,0,9,1,GM
2020-04-12,0,0,9,1,GM
2020-04-13,0,0,9,1,GM
2020-04-14,0,0,9,1,GM
2020-04-15,0,0,9,1,GM
2020-04-16,0,0,9,1,GM
2020-04-17,0,0,9,1,GM
2020-04-18,0,0,9,1,GM
2020-04-19,1,0,10,1,GM
2020-04-20,0,0,10,1,GM
2020-04-21,0,0,10,1,GM
2020-04-22,0,0,10,1,GM
2020-04-23,0,0,10,1,GM
2020-04-24,0,0,10,1,GM
2020-04-25,0,0,10,1,GM
2020-04-26,0,0,10,1,GM
2020-04-27,0,0,10,1,GM
2020-04-28,0,0,10,1,GM
2020-04-29,1,0,11,1,GM
2020-04-30,1,0,12,1,GM
2020-05-01,0,0,12,1,GM
2020-05-02,5,0,17,1,GM
2020-05-03,0,0,17,1,GM
2020-05-04,0,0,17,1,GM
2020-05-05,0,0,17,1,GM
2020-05-06,0,0,17,1,GM
2020-05-07,1,0,18,1,GM
2020-05-08,2,0,20,1,GM
2020-05-09,0,0,20,1,GM
2020-05-10,0,0,20,1,GM
2020-05-11,2,0,22,1,GM
2020-05-12,1,0,23,1,GM
2020-05-13,0,0,23,1,GM
2020-05-14,0,0,23,1,GM
2020-05-15,0,0,23,1,GM
2020-05-16,0,0,23,1,GM
2020-05-17,0,0,23,1,GM
2020-05-18,1,0,24,1,GM
2020-05-19,0,0,24,1,GM
2020-05-20,0,0,24,1,GM
2020-05-21,0,0,24,1,GM
2020-05-22,1,0,25,1,GM
2020-05-23,0,0,25,1,GM
2020-05-24,0,0,25,1,GM
2020-05-25,0,0,25,1,GM
2020-05-26,0,0,25,1,GM
2020-05-27,0,0,25,1,GM
2020-05-28,0,0,25,1,GM
2020-05-29,0,0,25,1,GM
2020-05-30,0,0,25,1,GM
2020-05-31,0,0,25,1,GM
2020-06-01,0,0,25,1,GM
2020-06-02,1,0,26,1,GM
2020-06-03,0,0,26,1,GM
2020-06-04,0,0,26,1,GM
2020-06-05,0,0,26,1,GM
2020-06-06,0,0,26,1,GM
2020-06-07,0,0,26,1,GM
2020-06-08,2,0,28,1,GM
2020-06-09,0,0,28,1,GM
2020-06-10,0,0,28,1,GM
2020-06-11,0,0,28,1,GM
2020-06-12,0,0,28,1,GM
2020-06-13,0,0,28,1,GM
2020-06-14,0,0,28,1,GM
2020-06-15,2,0,30,1,GM
2020-06-16,4,0,34,1,GM
2020-06-17,0,0,34,1,GM
2020-06-18,2,0,36,1,GM
2020-06-19,0,0,36,1,GM
2020-06-20,1,1,37,2,GM
2020-06-21,0,0,37,2,GM
2020-06-22,4,0,41,2,GM
2020-06-23,1,0,42,2,GM
2020-06-24,0,0,42,2,GM
2020-06-25,1,0,43,2,GM
2020-06-26,1,0,44,2,GM
2020-03-13,1,0,1,0,GN
2020-03-14,0,0,1,0,GN
2020-03-16,0,0,1,0,GN
2020-03-17,0,0,1,0,GN
2020-03-18,0,0,1,0,GN
2020-03-19,0,0,1,0,GN
2020-03-20,1,0,2,0,GN
2020-03-21,0,0,2,0,GN
2020-03-22,0,0,2,0,GN
2020-03-23,0,0,2,0,GN
2020-03-24,2,0,4,0,GN
2020-03-25,0,0,4,0,GN
2020-03-26,1,0,5,0,GN
2020-03-27,0,0,5,0,GN
2020-03-28,3,0,8,0,GN
2020-03-29,0,0,8,0,GN
2020-03-30,8,0,16,0,GN
2020-03-31,0,0,16,0,GN
2020-04-01,14,0,30,0,GN
2020-04-02,22,0,52,0,GN
2020-04-03,0,0,52,0,GN
2020-04-04,59,0,111,0,GN
2020-04-05,10,0,121,0,GN
2020-04-06,7,0,128,0,GN
2020-04-07,16,0,144,0,GN
2020-04-08,20,0,164,0,GN
2020-04-09,30,0,194,0,GN
2020-04-10,18,0,212,0,GN
2020-04-11,38,0,250,0,GN
2020-04-12,0,0,250,0,GN
2020-04-13,69,0,319,0,GN
2020-04-14,44,0,363,0,GN
2020-04-15,41,1,404,1,GN
2020-04-16,34,0,438,1,GN
2020-04-17,39,2,477,3,GN
2020-04-18,0,0,477,3,GN
2020-04-19,102,2,579,5,GN
2020-04-20,43,0,622,5,GN
2020-04-21,66,1,688,6,GN
2020-04-22,73,0,761,6,GN
2020-04-23,101,0,862,6,GN
2020-04-24,92,0,954,6,GN
2020-04-25,42,1,996,7,GN
2020-04-26,98,0,1094,7,GN
2020-04-27,69,0,1163,7,GN
2020-04-28,77,0,1240,7,GN
2020-04-29,111,0,1351,7,GN
2020-04-30,144,0,1495,7,GN
2020-05-01,42,0,1537,7,GN
2020-05-02,49,0,1586,7,GN
2020-05-03,0,0,1586,7,GN
2020-05-04,124,2,1710,9,GN
2020-05-05,101,1,1811,10,GN
2020-05-06,45,1,1856,11,GN
2020-05-07,71,0,1927,11,GN
2020-05-08,82,0,2009,11,GN
2020-05-09,33,0,2042,11,GN
2020-05-10,104,0,2146,11,GN
2020-05-11,67,0,2213,11,GN
2020-05-12,0,0,2213,11,GN
2020-05-13,161,3,2374,14,GN
2020-05-14,99,0,2473,14,GN
2020-05-15,58,1,2531,15,GN
2020-05-16,127,1,2658,16,GN
2020-05-17,0,0,2658,16,GN
2020-05-18,138,0,2796,16,GN
2020-05-19,67,2,2863,18,GN
2020-05-20,0,0,2863,18,GN
2020-05-21,204,1,3067,19,GN
2020-05-22,0,0,3067,19,GN
2020-05-23,109,1,3176,20,GN
2020-05-24,99,0,3275,20,GN
2020-05-25,0,0,3275,20,GN
2020-05-26,83,0,3358,20,GN
2020-05-27,88,1,3446,21,GN
2020-05-28,107,1,3553,22,GN
2020-05-29,103,0,3656,22,GN
2020-05-30,50,1,3706,23,GN
2020-05-31,65,0,3771,23,GN
2020-06-01,73,0,3844,23,GN
2020-06-02,0,0,3844,23,GN
2020-06-03,42,0,3886,23,GN
2020-06-04,105,0,3991,23,GN
2020-06-05,69,0,4060,23,GN
2020-06-06,57,0,4117,23,GN
2020-06-07,48,0,4165,23,GN
2020-06-08,51,0,4216,23,GN
2020-06-09,42,0,4258,23,GN
2020-06-10,0,0,4258,23,GN
2020-06-11,114,0,4372,23,GN
2020-06-12,54,1,4426,24,GN
2020-06-13,58,1,4484,25,GN
2020-06-14,48,0,4532,25,GN
2020-06-15,40,1,4572,26,GN
2020-06-16,67,0,4639,26,GN
2020-06-17,29,0,4668,26,GN
2020-06-18,173,0,4841,26,GN
2020-06-19,63,1,4904,27,GN
2020-06-20,56,0,4960,27,GN
2020-06-21,28,0,4988,27,GN
2020-06-22,0,0,4988,27,GN
2020-06-23,116,2,5104,29,GN
2020-06-24,70,0,5174,29,GN
2020-06-25,37,0,5211,29,GN
2020-06-26,49,0,5260,29,GN
2020-03-14,1,0,1,0,GQ
2020-03-15,0,0,1,0,GQ
2020-03-16,0,0,1,0,GQ
2020-03-17,0,0,1,0,GQ
2020-03-18,2,0,3,0,GQ
2020-03-19,1,0,4,0,GQ
2020-03-20,0,0,4,0,GQ
2020-03-21,2,0,6,0,GQ
2020-03-22,0,0,6,0,GQ
2020-03-23,3,0,9,0,GQ
2020-03-24,0,0,9,0,GQ
2020-03-25,2,0,11,0,GQ
2020-03-26,1,0,12,0,GQ
2020-03-27,1,0,13,0,GQ
2020-03-28,0,0,13,0,GQ
2020-03-29,1,0,14,0,GQ
2020-03-30,0,0,14,0,GQ
2020-03-31,1,0,15,0,GQ
2020-04-01,0,0,15,0,GQ
2020-04-02,0,0,15,0,GQ
2020-04-03,1,0,16,0,GQ
2020-04-04,0,0,16,0,GQ
2020-04-05,0,0,16,0,GQ
2020-04-06,0,0,16,0,GQ
2020-04-07,0,0,16,0,GQ
2020-04-08,2,0,18,0,GQ
2020-04-09,0,0,18,0,GQ
2020-04-10,0,0,18,0,GQ
2020-04-11,0,0,18,0,GQ
2020-04-12,3,0,21,0,GQ
2020-04-13,0,0,21,0,GQ
2020-04-14,20,0,41,0,GQ
2020-04-15,10,0,51,0,GQ
2020-04-16,0,0,51,0,GQ
2020-04-17,28,0,79,0,GQ
2020-04-18,0,0,79,0,GQ
2020-04-19,0,0,79,0,GQ
2020-04-20,0,0,79,0,GQ
2020-04-21,0,0,79,0,GQ
2020-04-22,4,0,83,0,GQ
2020-04-23,1,1,84,1,GQ
2020-04-24,128,0,212,1,GQ
2020-04-25,2,0,214,1,GQ
2020-04-26,44,0,258,1,GQ
2020-04-27,0,0,258,1,GQ
2020-04-28,57,0,315,1,GQ
2020-04-29,0,0,315,1,GQ
2020-04-30,0,0,315,1,GQ
2020-05-01,0,0,315,1,GQ
2020-05-02,0,0,315,1,GQ
2020-05-03,0,0,315,1,GQ
2020-05-04,0,1,315,2,GQ
2020-05-05,124,2,439,4,GQ
2020-05-06,0,0,439,4,GQ
2020-05-07,0,0,439,4,GQ
2020-05-08,0,0,439,4,GQ
2020-05-09,0,0,439,4,GQ
2020-05-10,0,0,439,4,GQ
2020-05-11,0,0,439,4,GQ
2020-05-12,0,0,439,4,GQ
2020-05-13,83,2,522,6,GQ
2020-05-14,72,1,594,7,GQ
2020-05-15,0,0,594,7,GQ
2020-05-16,0,0,594,7,GQ
2020-05-17,0,0,594,7,GQ
2020-05-18,125,0,719,7,GQ
2020-05-19,171,0,890,7,GQ
2020-05-20,0,0,890,7,GQ
2020-05-21,13,3,903,10,GQ
2020-05-22,0,0,903,10,GQ
2020-05-23,140,2,1043,12,GQ
2020-05-24,0,0,1043,12,GQ
2020-05-25,0,0,1043,12,GQ
2020-05-26,0,0,1043,12,GQ
2020-05-27,0,0,1043,12,GQ
2020-05-28,0,0,1043,12,GQ
2020-05-29,0,0,1043,12,GQ
2020-05-30,263,0,1306,12,GQ
2020-05-31,0,0,1306,12,GQ
2020-06-01,0,0,1306,12,GQ
2020-06-02,0,0,1306,12,GQ
2020-06-03,0,0,1306,12,GQ
2020-06-04,0,0,1306,12,GQ
2020-06-05,0,0,1306,12,GQ
2020-06-06,0,0,1306,12,GQ
2020-06-07,0,0,1306,12,GQ
2020-06-08,0,0,1306,12,GQ
2020-06-09,0,0,1306,12,GQ
2020-06-10,0,0,1306,12,GQ
2020-06-11,0,0,1306,12,GQ
2020-06-12,0,0,1306,12,GQ
2020-06-13,0,0,1306,12,GQ
2020-06-14,0,0,1306,12,GQ
2020-06-15,0,0,1306,12,GQ
2020-06-16,0,0,1306,12,GQ
2020-06-17,0,0,1306,12,GQ
2020-06-18,0,0,1306,12,GQ
2020-06-19,358,20,1664,32,GQ
2020-06-20,0,0,1664,32,GQ
2020-06-21,0,0,1664,32,GQ
2020-06-22,337,0,2001,32,GQ
2020-06-23,0,0,2001,32,GQ
2020-06-24,0,0,2001,32,GQ
2020-06-25,0,0,2001,32,GQ
2020-06-26,0,0,2001,32,GQ
2019-12-30,0,0,0,0,GR
2019-12-31,0,0,0,0,GR
2020-01-01,0,0,0,0,GR
2020-01-02,0,0,0,0,GR
2020-01-03,0,0,0,0,GR
2020-01-04,0,0,0,0,GR
2020-01-05,0,0,0,0,GR
2020-01-06,0,0,0,0,GR
2020-01-07,0,0,0,0,GR
2020-01-08,0,0,0,0,GR
2020-01-09,0,0,0,0,GR
2020-01-10,0,0,0,0,GR
2020-01-11,0,0,0,0,GR
2020-01-12,0,0,0,0,GR
2020-01-13,0,0,0,0,GR
2020-01-14,0,0,0,0,GR
2020-01-15,0,0,0,0,GR
2020-01-16,0,0,0,0,GR
2020-01-17,0,0,0,0,GR
2020-01-18,0,0,0,0,GR
2020-01-19,0,0,0,0,GR
2020-01-20,0,0,0,0,GR
2020-01-21,0,0,0,0,GR
2020-01-22,0,0,0,0,GR
2020-01-23,0,0,0,0,GR
2020-01-24,0,0,0,0,GR
2020-01-25,0,0,0,0,GR
2020-01-26,0,0,0,0,GR
2020-01-27,0,0,0,0,GR
2020-01-28,0,0,0,0,GR
2020-01-29,0,0,0,0,GR
2020-01-30,0,0,0,0,GR
2020-01-31,0,0,0,0,GR
2020-02-01,0,0,0,0,GR
2020-02-02,0,0,0,0,GR
2020-02-03,0,0,0,0,GR
2020-02-04,0,0,0,0,GR
2020-02-05,0,0,0,0,GR
2020-02-06,0,0,0,0,GR
2020-02-07,0,0,0,0,GR
2020-02-08,0,0,0,0,GR
2020-02-09,0,0,0,0,GR
2020-02-10,0,0,0,0,GR
2020-02-11,0,0,0,0,GR
2020-02-12,0,0,0,0,GR
2020-02-13,0,0,0,0,GR
2020-02-14,0,0,0,0,GR
2020-02-15,0,0,0,0,GR
2020-02-16,0,0,0,0,GR
2020-02-17,0,0,0,0,GR
2020-02-18,0,0,0,0,GR
2020-02-19,0,0,0,0,GR
2020-02-20,0,0,0,0,GR
2020-02-21,0,0,0,0,GR
2020-02-22,0,0,0,0,GR
2020-02-23,0,0,0,0,GR
2020-02-24,0,0,0,0,GR
2020-02-25,0,0,0,0,GR
2020-02-26,1,0,1,0,GR
2020-02-27,2,0,3,0,GR
2020-02-28,1,0,4,0,GR
2020-02-29,3,0,7,0,GR
2020-03-01,0,0,7,0,GR
2020-03-04,3,0,10,0,GR
2020-03-05,22,0,32,0,GR
2020-03-06,13,0,45,0,GR
2020-03-07,21,0,66,0,GR
2020-03-08,7,0,73,0,GR
2020-03-09,11,0,84,0,GR
2020-03-10,6,0,90,0,GR
2020-03-11,9,1,99,1,GR
2020-03-12,34,0,133,1,GR
2020-03-13,57,0,190,1,GR
2020-03-14,38,2,228,3,GR
2020-03-15,103,1,331,4,GR
2020-03-16,21,0,352,4,GR
2020-03-17,35,1,387,5,GR
2020-03-18,31,0,418,5,GR
2020-03-19,46,0,464,5,GR
2020-03-20,31,3,495,8,GR
2020-03-21,35,5,530,13,GR
2020-03-22,94,2,624,15,GR
2020-03-23,71,2,695,17,GR
2020-03-24,48,3,743,20,GR
2020-03-25,78,2,821,22,GR
2020-03-26,71,4,892,26,GR
2020-03-27,74,2,966,28,GR
2020-03-28,95,4,1061,32,GR
2020-03-29,95,6,1156,38,GR
2020-03-30,56,5,1212,43,GR
2020-03-31,102,6,1314,49,GR
2020-04-01,61,1,1375,50,GR
2020-04-02,139,3,1514,53,GR
2020-04-03,99,6,1613,59,GR
2020-04-04,60,9,1673,68,GR
2020-04-05,62,5,1735,73,GR
2020-04-06,20,6,1755,79,GR
2020-04-07,77,2,1832,81,GR
2020-04-08,52,2,1884,83,GR
2020-04-09,71,3,1955,86,GR
2020-04-10,56,4,2011,90,GR
2020-04-11,70,3,2081,93,GR
2020-04-12,33,5,2114,98,GR
2020-04-13,31,1,2145,99,GR
2020-04-14,25,2,2170,101,GR
2020-04-15,22,1,2192,102,GR
2020-04-16,15,3,2207,105,GR
2020-04-17,0,0,2207,105,GR
2020-04-18,0,0,2207,105,GR
2020-04-19,28,5,2235,110,GR
2020-04-20,10,6,2245,116,GR
2020-04-21,156,5,2401,121,GR
2020-04-22,7,0,2408,121,GR
2020-04-23,55,4,2463,125,GR
2020-04-24,27,5,2490,130,GR
2020-04-25,16,0,2506,130,GR
2020-04-26,0,0,2506,130,GR
2020-04-27,28,6,2534,136,GR
2020-04-28,0,0,2534,136,GR
2020-04-29,42,3,2576,139,GR
2020-04-30,15,1,2591,140,GR
2020-05-01,0,0,2591,140,GR
2020-05-02,29,3,2620,143,GR
2020-05-03,6,1,2626,144,GR
2020-05-04,6,2,2632,146,GR
2020-05-05,10,0,2642,146,GR
2020-05-06,21,1,2663,147,GR
2020-05-07,15,1,2678,148,GR
2020-05-08,13,2,2691,150,GR
2020-05-09,19,1,2710,151,GR
2020-05-10,6,0,2716,151,GR
2020-05-11,10,0,2726,151,GR
2020-05-12,18,1,2744,152,GR
2020-05-13,16,3,2760,155,GR
2020-05-14,10,1,2770,156,GR
2020-05-15,40,4,2810,160,GR
2020-05-16,9,2,2819,162,GR
2020-05-17,15,1,2834,163,GR
2020-05-18,2,2,2836,165,GR
2020-05-19,4,0,2840,165,GR
2020-05-20,10,1,2850,166,GR
2020-05-21,3,2,2853,168,GR
2020-05-22,20,1,2873,169,GR
2020-05-23,3,2,2876,171,GR
2020-05-24,2,0,2878,171,GR
2020-05-25,4,1,2882,172,GR
2020-05-26,10,1,2892,173,GR
2020-05-27,11,0,2903,173,GR
2020-05-28,3,2,2906,175,GR
2020-05-29,3,0,2909,175,GR
2020-05-30,6,0,2915,175,GR
2020-05-31,2,0,2917,175,GR
2020-06-01,0,0,2917,175,GR
2020-06-02,1,4,2918,179,GR
2020-06-03,19,0,2937,179,GR
2020-06-04,0,0,2937,179,GR
2020-06-05,0,0,2937,179,GR
2020-06-06,15,1,2952,180,GR
2020-06-07,0,0,2952,180,GR
2020-06-08,97,2,3049,182,GR
2020-06-09,9,1,3058,183,GR
2020-06-10,10,0,3068,183,GR
2020-06-11,20,0,3088,183,GR
2020-06-12,20,0,3108,183,GR
2020-06-13,4,0,3112,183,GR
2020-06-14,9,0,3121,183,GR
2020-06-15,13,1,3134,184,GR
2020-06-16,14,1,3148,185,GR
2020-06-17,55,2,3203,187,GR
2020-06-18,24,1,3227,188,GR
2020-06-19,10,1,3237,189,GR
2020-06-20,19,1,3256,190,GR
2020-06-21,10,0,3266,190,GR
2020-06-22,21,0,3287,190,GR
2020-06-23,15,0,3302,190,GR
2020-06-24,8,0,3310,190,GR
2020-06-25,11,1,3321,191,GR
2020-06-26,22,0,3343,191,GR
2020-03-14,1,0,1,0,GT
2020-03-15,0,1,1,1,GT
2020-03-16,5,0,6,1,GT
2020-03-17,0,0,6,1,GT
2020-03-18,2,0,8,1,GT
2020-03-19,1,0,9,1,GT
2020-03-20,4,0,13,1,GT
2020-03-21,4,0,17,1,GT
2020-03-22,2,0,19,1,GT
2020-03-23,1,0,20,1,GT
2020-03-24,1,0,21,1,GT
2020-03-25,3,0,24,1,GT
2020-03-26,1,0,25,1,GT
2020-03-27,7,0,32,1,GT
2020-03-28,2,0,34,1,GT
2020-03-29,2,0,36,1,GT
2020-03-30,0,0,36,1,GT
2020-03-31,2,0,38,1,GT
2020-04-01,8,0,46,1,GT
2020-04-02,1,0,47,1,GT
2020-04-03,3,0,50,1,GT
2020-04-04,11,1,61,2,GT
2020-04-05,9,1,70,3,GT
2020-04-06,4,0,74,3,GT
2020-04-07,6,0,80,3,GT
2020-04-08,7,0,87,3,GT
2020-04-09,39,0,126,3,GT
2020-04-10,11,0,137,3,GT
2020-04-11,16,0,153,3,GT
2020-04-12,3,2,156,5,GT
2020-04-13,11,0,167,5,GT
2020-04-14,13,0,180,5,GT
2020-04-15,16,0,196,5,GT
2020-04-16,18,2,214,7,GT
2020-04-17,21,0,235,7,GT
2020-04-18,22,0,257,7,GT
2020-04-19,32,0,289,7,GT
2020-04-20,5,0,294,7,GT
2020-04-21,22,1,316,8,GT
2020-04-22,26,2,342,10,GT
2020-04-23,42,1,384,11,GT
2020-04-24,46,0,430,11,GT
2020-04-25,43,2,473,13,GT
2020-04-26,27,2,500,15,GT
2020-04-27,30,0,530,15,GT
2020-04-28,27,1,557,16,GT
2020-04-29,28,0,585,16,GT
2020-04-30,14,0,599,16,GT
2020-05-01,45,0,644,16,GT
2020-05-02,44,1,688,17,GT
2020-05-03,15,0,703,17,GT
2020-05-04,27,2,730,19,GT
2020-05-05,33,0,763,19,GT
2020-05-06,35,2,798,21,GT
2020-05-07,34,2,832,23,GT
2020-05-08,68,1,900,24,GT
2020-05-09,67,0,967,24,GT
2020-05-10,85,2,1052,26,GT
2020-05-11,62,0,1114,26,GT
2020-05-12,85,1,1199,27,GT
2020-05-13,143,2,1342,29,GT
2020-05-14,176,0,1518,29,GT
2020-05-15,125,1,1643,30,GT
2020-05-16,120,3,1763,33,GT
2020-05-17,149,2,1912,35,GT
2020-05-18,89,3,2001,38,GT
2020-05-19,132,5,2133,43,GT
2020-05-20,132,2,2265,45,GT
2020-05-21,247,3,2512,48,GT
2020-05-22,231,3,2743,51,GT
2020-05-23,311,4,3054,55,GT
2020-05-24,370,3,3424,58,GT
2020-05-25,336,1,3760,59,GT
2020-05-26,194,4,3954,63,GT
2020-05-27,191,5,4145,68,GT
2020-05-28,203,12,4348,80,GT
2020-05-29,259,10,4607,90,GT
2020-05-30,132,12,4739,102,GT
2020-05-31,348,6,5087,108,GT
2020-06-01,249,8,5336,116,GT
2020-06-02,250,7,5586,123,GT
2020-06-03,174,20,5760,143,GT
2020-06-04,394,15,6154,158,GT
2020-06-05,331,58,6485,216,GT
2020-06-06,307,14,6792,230,GT
2020-06-07,263,22,7055,252,GT
2020-06-08,447,15,7502,267,GT
2020-06-09,364,22,7866,289,GT
2020-06-10,355,27,8221,316,GT
2020-06-11,340,18,8561,334,GT
2020-06-12,421,17,8982,351,GT
2020-06-13,509,16,9491,367,GT
2020-06-14,354,17,9845,384,GT
2020-06-15,427,15,10272,399,GT
2020-06-16,434,19,10706,418,GT
2020-06-17,545,14,11251,432,GT
2020-06-18,617,17,11868,449,GT
2020-06-19,641,34,12509,483,GT
2020-06-20,246,31,12755,514,GT
2020-06-21,390,17,13145,531,GT
2020-06-22,624,16,13769,547,GT
2020-06-23,771,35,14540,582,GT
2020-06-24,279,19,14819,601,GT
2020-06-25,800,22,15619,623,GT
2020-06-26,209,49,15828,672,GT
2020-03-18,3,0,3,0,GU
2020-03-19,9,0,12,0,GU
2020-03-20,2,0,14,0,GU
2020-03-21,1,1,15,1,GU
2020-03-22,12,0,27,1,GU
2020-03-23,2,0,29,1,GU
2020-03-24,3,0,32,1,GU
2020-03-25,5,0,37,1,GU
2020-03-26,12,0,49,1,GU
2020-03-27,2,0,51,1,GU
2020-03-28,4,0,55,1,GU
2020-03-29,1,0,56,1,GU
2020-03-30,4,0,60,1,GU
2020-03-31,9,2,69,3,GU
2020-04-01,8,0,77,3,GU
2020-04-02,5,0,82,3,GU
2020-04-03,5,1,87,4,GU
2020-04-04,6,0,93,4,GU
2020-04-05,17,0,110,4,GU
2020-04-06,2,0,112,4,GU
2020-04-07,9,0,121,4,GU
2020-04-08,4,0,125,4,GU
2020-04-09,3,0,128,4,GU
2020-04-10,2,0,130,4,GU
2020-04-11,3,1,133,5,GU
2020-04-12,0,0,133,5,GU
2020-04-13,1,0,134,5,GU
2020-04-14,1,0,135,5,GU
2020-04-15,0,0,135,5,GU
2020-04-16,0,0,135,5,GU
2020-04-17,1,0,136,5,GU
2020-04-18,0,0,136,5,GU
2020-04-19,0,0,136,5,GU
2020-04-20,0,0,136,5,GU
2020-04-21,0,0,136,5,GU
2020-04-22,1,0,137,5,GU
2020-04-23,3,0,140,5,GU
2020-04-24,1,0,141,5,GU
2020-04-25,0,0,141,5,GU
2020-04-26,1,0,142,5,GU
2020-04-27,2,0,144,5,GU
2020-04-28,1,0,145,5,GU
2020-04-29,0,0,145,5,GU
2020-04-30,1,0,146,5,GU
2020-05-01,0,0,146,5,GU
2020-05-02,2,0,148,5,GU
2020-05-03,1,0,149,5,GU
2020-05-04,0,0,149,5,GU
2020-05-05,0,0,149,5,GU
2020-05-06,2,0,151,5,GU
2020-05-07,0,0,151,5,GU
2020-05-08,0,0,151,5,GU
2020-05-09,0,0,151,5,GU
2020-05-10,0,0,151,5,GU
2020-05-11,1,0,152,5,GU
2020-05-12,0,0,152,5,GU
2020-05-13,0,0,152,5,GU
2020-05-14,2,0,154,5,GU
2020-05-15,0,0,154,5,GU
2020-05-16,0,0,154,5,GU
2020-05-17,0,0,154,5,GU
2020-05-18,0,0,154,5,GU
2020-05-19,0,0,154,5,GU
2020-05-20,11,0,165,5,GU
2020-05-21,0,0,165,5,GU
2020-05-22,0,0,165,5,GU
2020-05-23,1,0,166,5,GU
2020-05-24,0,0,166,5,GU
2020-05-25,0,0,166,5,GU
2020-05-26,3,0,169,5,GU
2020-05-27,2,0,171,5,GU
2020-05-28,1,0,172,5,GU
2020-05-29,0,0,172,5,GU
2020-05-30,1,0,173,5,GU
2020-05-31,2,0,175,5,GU
2020-06-01,0,0,175,5,GU
2020-06-02,2,0,177,5,GU
2020-06-03,2,0,179,5,GU
2020-06-04,0,0,179,5,GU
2020-06-05,0,0,179,5,GU
2020-06-06,0,0,179,5,GU
2020-06-07,0,0,179,5,GU
2020-06-08,1,0,180,5,GU
2020-06-09,0,0,180,5,GU
2020-06-10,2,0,182,5,GU
2020-06-11,0,0,182,5,GU
2020-06-12,3,0,185,5,GU
2020-06-13,0,0,185,5,GU
2020-06-14,0,0,185,5,GU
2020-06-15,1,0,186,5,GU
2020-06-16,2,0,188,5,GU
2020-06-17,4,0,192,5,GU
2020-06-18,8,0,200,5,GU
2020-06-19,0,0,200,5,GU
2020-06-20,22,0,222,5,GU
2020-06-21,0,0,222,5,GU
2020-06-22,3,0,225,5,GU
2020-06-23,1,0,226,5,GU
2020-06-24,5,0,231,5,GU
2020-06-25,16,0,247,5,GU
2020-06-26,1,0,248,5,GU
2020-03-26,2,0,2,0,GW
2020-03-27,0,0,2,0,GW
2020-03-28,0,0,2,0,GW
2020-03-29,0,0,2,0,GW
2020-03-30,0,0,2,0,GW
2020-03-31,6,0,8,0,GW
2020-04-01,1,0,9,0,GW
2020-04-02,0,0,9,0,GW
2020-04-03,6,0,15,0,GW
2020-04-04,3,0,18,0,GW
2020-04-05,0,0,18,0,GW
2020-04-06,15,0,33,0,GW
2020-04-07,0,0,33,0,GW
2020-04-08,0,0,33,0,GW
2020-04-09,2,0,35,0,GW
2020-04-10,0,0,35,0,GW
2020-04-11,3,0,38,0,GW
2020-04-12,1,0,39,0,GW
2020-04-13,0,0,39,0,GW
2020-04-14,1,0,40,0,GW
2020-04-15,3,0,43,0,GW
2020-04-16,3,0,46,0,GW
2020-04-17,4,0,50,0,GW
2020-04-18,0,0,50,0,GW
2020-04-19,0,0,50,0,GW
2020-04-20,0,0,50,0,GW
2020-04-21,0,0,50,0,GW
2020-04-22,0,0,50,0,GW
2020-04-23,2,0,52,0,GW
2020-04-24,0,0,52,0,GW
2020-04-25,0,0,52,0,GW
2020-04-26,1,1,53,1,GW
2020-04-27,20,0,73,1,GW
2020-04-28,0,0,73,1,GW
2020-04-29,4,0,77,1,GW
2020-04-30,128,0,205,1,GW
2020-05-01,52,0,257,1,GW
2020-05-02,0,0,257,1,GW
2020-05-03,35,1,292,2,GW
2020-05-04,121,0,413,2,GW
2020-05-05,62,0,475,2,GW
2020-05-06,0,0,475,2,GW
2020-05-07,89,0,564,2,GW
2020-05-08,30,0,594,2,GW
2020-05-09,47,1,641,3,GW
2020-05-10,85,0,726,3,GW
2020-05-11,35,0,761,3,GW
2020-05-12,59,0,820,3,GW
2020-05-13,0,0,820,3,GW
2020-05-14,93,0,913,3,GW
2020-05-15,0,0,913,3,GW
2020-05-16,0,0,913,3,GW
2020-05-17,77,1,990,4,GW
2020-05-18,0,0,990,4,GW
2020-05-19,48,2,1038,6,GW
2020-05-20,0,0,1038,6,GW
2020-05-21,51,0,1089,6,GW
2020-05-22,0,0,1089,6,GW
2020-05-23,25,0,1114,6,GW
2020-05-24,59,0,1173,6,GW
2020-05-25,0,0,1173,6,GW
2020-05-26,0,0,1173,6,GW
2020-05-27,5,1,1178,7,GW
2020-05-28,0,0,1178,7,GW
2020-05-29,78,1,1256,8,GW
2020-05-30,0,0,1256,8,GW
2020-05-31,66,0,1322,8,GW
2020-06-01,17,0,1339,8,GW
2020-06-02,0,0,1339,8,GW
2020-06-03,0,0,1339,8,GW
2020-06-04,7,1,1346,9,GW
2020-06-05,22,3,1368,12,GW
2020-06-06,0,0,1368,12,GW
2020-06-07,0,0,1368,12,GW
2020-06-08,21,0,1389,12,GW
2020-06-09,0,0,1389,12,GW
2020-06-10,0,0,1389,12,GW
2020-06-11,0,0,1389,12,GW
2020-06-12,0,0,1389,12,GW
2020-06-13,71,3,1460,15,GW
2020-06-14,0,0,1460,15,GW
2020-06-15,0,0,1460,15,GW
2020-06-16,32,0,1492,15,GW
2020-06-17,0,0,1492,15,GW
2020-06-18,20,0,1512,15,GW
2020-06-19,0,0,1512,15,GW
2020-06-20,29,2,1541,17,GW
2020-06-21,0,0,1541,17,GW
2020-06-22,15,2,1556,19,GW
2020-06-23,0,0,1556,19,GW
2020-06-24,0,0,1556,19,GW
2020-06-25,0,0,1556,19,GW
2020-06-26,0,0,1556,19,GW
2020-03-12,1,1,1,1,GY
2020-03-15,3,0,4,1,GY
2020-03-16,0,0,4,1,GY
2020-03-17,0,0,4,1,GY
2020-03-18,1,0,5,1,GY
2020-03-19,0,0,5,1,GY
2020-03-20,0,0,5,1,GY
2020-03-21,0,0,5,1,GY
2020-03-22,0,0,5,1,GY
2020-03-23,0,0,5,1,GY
2020-03-24,0,0,5,1,GY
2020-03-25,0,0,5,1,GY
2020-03-26,0,0,5,1,GY
2020-03-27,0,0,5,1,GY
2020-03-28,3,0,8,1,GY
2020-03-29,0,0,8,1,GY
2020-03-30,0,0,8,1,GY
2020-03-31,4,1,12,2,GY
2020-04-01,7,2,19,4,GY
2020-04-02,0,0,19,4,GY
2020-04-03,4,0,23,4,GY
2020-04-04,1,0,24,4,GY
2020-04-05,5,0,29,4,GY
2020-04-06,2,1,31,5,GY
2020-04-07,2,0,33,5,GY
2020-04-08,4,1,37,6,GY
2020-04-09,0,0,37,6,GY
2020-04-10,3,0,40,6,GY
2020-04-11,5,0,45,6,GY
2020-04-12,0,0,45,6,GY
2020-04-13,2,0,47,6,GY
2020-04-14,1,0,48,6,GY
2020-04-15,7,0,55,6,GY
2020-04-16,2,0,57,6,GY
2020-04-17,6,0,63,6,GY
2020-04-18,0,1,63,7,GY
2020-04-19,2,0,65,7,GY
2020-04-20,1,0,66,7,GY
2020-04-21,1,0,67,7,GY
2020-04-22,0,0,67,7,GY
2020-04-23,3,0,70,7,GY
2020-04-24,3,1,73,8,GY
2020-04-25,1,0,74,8,GY
2020-04-26,0,0,74,8,GY
2020-04-27,0,0,74,8,GY
2020-04-28,1,0,75,8,GY
2020-04-29,3,0,78,8,GY
2020-04-30,4,1,82,9,GY
2020-05-01,0,0,82,9,GY
2020-05-02,0,0,82,9,GY
2020-05-03,0,0,82,9,GY
2020-05-04,10,0,92,9,GY
2020-05-05,1,1,93,10,GY
2020-05-06,0,0,93,10,GY
2020-05-07,0,0,93,10,GY
2020-05-08,1,0,94,10,GY
2020-05-09,3,0,97,10,GY
2020-05-10,7,0,104,10,GY
2020-05-11,5,0,109,10,GY
2020-05-12,4,0,113,10,GY
2020-05-13,0,0,113,10,GY
2020-05-14,0,0,113,10,GY
2020-05-15,3,0,116,10,GY
2020-05-16,1,0,117,10,GY
2020-05-17,0,0,117,10,GY
2020-05-18,7,0,124,10,GY
2020-05-19,1,0,125,10,GY
2020-05-20,0,0,125,10,GY
2020-05-21,2,0,127,10,GY
2020-05-22,0,0,127,10,GY
2020-05-23,0,0,127,10,GY
2020-05-24,8,0,135,10,GY
2020-05-25,2,1,137,11,GY
2020-05-26,2,0,139,11,GY
2020-05-27,0,0,139,11,GY
2020-05-28,11,0,150,11,GY
2020-05-29,0,0,150,11,GY
2020-05-30,2,1,152,12,GY
2020-05-31,1,0,153,12,GY
2020-06-01,0,0,153,12,GY
2020-06-02,0,0,153,12,GY
2020-06-03,0,0,153,12,GY
2020-06-04,0,0,153,12,GY
2020-06-05,0,0,153,12,GY
2020-06-06,1,0,154,12,GY
2020-06-07,0,0,154,12,GY
2020-06-08,0,0,154,12,GY
2020-06-09,2,0,156,12,GY
2020-06-10,0,0,156,12,GY
2020-06-11,2,0,158,12,GY
2020-06-12,1,0,159,12,GY
2020-06-13,0,0,159,12,GY
2020-06-14,0,0,159,12,GY
2020-06-15,0,0,159,12,GY
2020-06-16,12,0,171,12,GY
2020-06-17,0,0,171,12,GY
2020-06-18,12,0,183,12,GY
2020-06-19,0,0,183,12,GY
2020-06-20,0,0,183,12,GY
2020-06-21,1,0,184,12,GY
2020-06-22,21,0,205,12,GY
2020-06-23,1,0,206,12,GY
2020-06-24,3,0,209,12,GY
2020-06-25,6,0,215,12,GY
2020-06-26,15,0,230,12,GY
2020-03-11,2,0,2,0,HN
2020-03-13,1,0,3,0,HN
2020-03-15,3,0,6,0,HN
2020-03-16,2,0,8,0,HN
2020-03-17,1,0,9,0,HN
2020-03-18,3,0,12,0,HN
2020-03-19,12,0,24,0,HN
2020-03-20,0,0,24,0,HN
2020-03-21,2,0,26,0,HN
2020-03-22,1,0,27,0,HN
2020-03-23,3,0,30,0,HN
2020-03-24,6,0,36,0,HN
2020-03-25,16,0,52,0,HN
2020-03-26,15,1,67,1,HN
2020-03-27,28,0,95,1,HN
2020-03-28,15,1,110,2,HN
2020-03-29,29,1,139,3,HN
2020-03-30,2,4,141,7,HN
2020-03-31,31,3,172,10,HN
2020-04-01,47,4,219,14,HN
2020-04-02,3,1,222,15,HN
2020-04-03,42,0,264,15,HN
2020-04-04,4,7,268,22,HN
2020-04-05,30,0,298,22,HN
2020-04-06,7,0,305,22,HN
2020-04-07,7,0,312,22,HN
2020-04-08,31,1,343,23,HN
2020-04-09,39,0,382,23,HN
2020-04-10,10,1,392,24,HN
2020-04-11,1,1,393,25,HN
2020-04-12,4,0,397,25,HN
2020-04-13,10,1,407,26,HN
2020-04-14,12,5,419,31,HN
2020-04-15,7,4,426,35,HN
2020-04-16,16,6,442,41,HN
2020-04-17,15,5,457,46,HN
2020-04-18,15,0,472,46,HN
2020-04-19,5,0,477,46,HN
2020-04-20,17,0,494,46,HN
2020-04-21,16,0,510,46,HN
2020-04-22,9,1,519,47,HN
2020-04-23,0,0,519,47,HN
2020-04-24,72,0,591,47,HN
2020-04-25,36,12,627,59,HN
2020-04-26,34,2,661,61,HN
2020-04-27,32,0,693,61,HN
2020-04-28,45,5,738,66,HN
2020-04-29,33,5,771,71,HN
2020-04-30,33,4,804,75,HN
2020-05-01,95,0,899,75,HN
2020-05-02,111,1,1010,76,HN
2020-05-03,45,6,1055,82,HN
2020-05-04,123,0,1178,82,HN
2020-05-05,92,11,1270,93,HN
2020-05-06,191,6,1461,99,HN
2020-05-07,224,6,1685,105,HN
2020-05-08,86,2,1771,107,HN
2020-05-09,59,1,1830,108,HN
2020-05-10,142,0,1972,108,HN
2020-05-11,34,8,2006,116,HN
2020-05-12,74,5,2080,121,HN
2020-05-13,175,2,2255,123,HN
2020-05-14,63,10,2318,133,HN
2020-05-15,142,1,2460,134,HN
2020-05-16,105,4,2565,138,HN
2020-05-17,81,4,2646,142,HN
2020-05-18,152,4,2798,146,HN
2020-05-19,157,1,2955,147,HN
2020-05-20,145,4,3100,151,HN
2020-05-21,104,5,3204,156,HN
2020-05-22,273,11,3477,167,HN
2020-05-23,266,7,3743,174,HN
2020-05-24,207,6,3950,180,HN
2020-05-25,239,2,4189,182,HN
2020-05-26,212,6,4401,188,HN
2020-05-27,239,6,4640,194,HN
2020-05-28,112,2,4752,196,HN
2020-05-29,134,3,4886,199,HN
2020-05-30,208,2,5094,201,HN
2020-05-31,108,11,5202,212,HN
2020-06-01,160,5,5362,217,HN
2020-06-02,165,8,5527,225,HN
2020-06-03,163,9,5690,234,HN
2020-06-04,190,9,5880,243,HN
2020-06-05,91,5,5971,248,HN
2020-06-06,184,2,6155,250,HN
2020-06-07,172,8,6327,258,HN
2020-06-08,123,4,6450,262,HN
2020-06-09,485,9,6935,271,HN
2020-06-10,425,19,7360,290,HN
2020-06-11,309,4,7669,294,HN
2020-06-12,463,12,8132,306,HN
2020-06-13,323,4,8455,310,HN
2020-06-14,403,2,8858,312,HN
2020-06-15,320,10,9178,322,HN
2020-06-16,478,8,9656,330,HN
2020-06-17,643,6,10299,336,HN
2020-06-18,440,7,10739,343,HN
2020-06-19,519,6,11258,349,HN
2020-06-20,992,9,12250,358,HN
2020-06-21,519,5,12769,363,HN
2020-06-22,587,32,13356,395,HN
2020-06-23,587,10,13943,405,HN
2020-06-24,628,12,14571,417,HN
2020-06-25,795,9,15366,426,HN
2020-06-26,628,45,15994,471,HN
2019-12-30,0,0,0,0,HR
2019-12-31,0,0,0,0,HR
2020-01-01,0,0,0,0,HR
2020-01-02,0,0,0,0,HR
2020-01-03,0,0,0,0,HR
2020-01-04,0,0,0,0,HR
2020-01-05,0,0,0,0,HR
2020-01-06,0,0,0,0,HR
2020-01-07,0,0,0,0,HR
2020-01-08,0,0,0,0,HR
2020-01-09,0,0,0,0,HR
2020-01-10,0,0,0,0,HR
2020-01-11,0,0,0,0,HR
2020-01-12,0,0,0,0,HR
2020-01-13,0,0,0,0,HR
2020-01-14,0,0,0,0,HR
2020-01-15,0,0,0,0,HR
2020-01-16,0,0,0,0,HR
2020-01-17,0,0,0,0,HR
2020-01-18,0,0,0,0,HR
2020-01-19,0,0,0,0,HR
2020-01-20,0,0,0,0,HR
2020-01-21,0,0,0,0,HR
2020-01-22,0,0,0,0,HR
2020-01-23,0,0,0,0,HR
2020-01-24,0,0,0,0,HR
2020-01-25,0,0,0,0,HR
2020-01-26,0,0,0,0,HR
2020-01-27,0,0,0,0,HR
2020-01-28,0,0,0,0,HR
2020-01-29,0,0,0,0,HR
2020-01-30,0,0,0,0,HR
2020-01-31,0,0,0,0,HR
2020-02-01,0,0,0,0,HR
2020-02-02,0,0,0,0,HR
2020-02-03,0,0,0,0,HR
2020-02-04,0,0,0,0,HR
2020-02-05,0,0,0,0,HR
2020-02-06,0,0,0,0,HR
2020-02-07,0,0,0,0,HR
2020-02-08,0,0,0,0,HR
2020-02-09,0,0,0,0,HR
2020-02-10,0,0,0,0,HR
2020-02-11,0,0,0,0,HR
2020-02-12,0,0,0,0,HR
2020-02-13,0,0,0,0,HR
2020-02-14,0,0,0,0,HR
2020-02-15,0,0,0,0,HR
2020-02-16,0,0,0,0,HR
2020-02-17,0,0,0,0,HR
2020-02-18,0,0,0,0,HR
2020-02-19,0,0,0,0,HR
2020-02-20,0,0,0,0,HR
2020-02-21,0,0,0,0,HR
2020-02-22,0,0,0,0,HR
2020-02-23,0,0,0,0,HR
2020-02-24,0,0,0,0,HR
2020-02-25,1,0,1,0,HR
2020-02-26,1,0,2,0,HR
2020-02-27,1,0,3,0,HR
2020-02-28,2,0,5,0,HR
2020-02-29,0,0,5,0,HR
2020-03-01,2,0,7,0,HR
2020-03-02,1,0,8,0,HR
2020-03-03,1,0,9,0,HR
2020-03-05,1,0,10,0,HR
2020-03-06,1,0,11,0,HR
2020-03-07,1,0,12,0,HR
2020-03-10,1,0,13,0,HR
2020-03-11,3,0,16,0,HR
2020-03-12,9,0,25,0,HR
2020-03-13,6,0,31,0,HR
2020-03-14,6,0,37,0,HR
2020-03-15,11,0,48,0,HR
2020-03-16,8,0,56,0,HR
2020-03-17,13,0,69,0,HR
2020-03-18,12,0,81,0,HR
2020-03-19,23,0,104,0,HR
2020-03-20,22,0,126,0,HR
2020-03-21,80,0,206,0,HR
2020-03-22,29,0,235,0,HR
2020-03-23,71,0,306,0,HR
2020-03-24,76,1,382,1,HR
2020-03-25,36,0,418,1,HR
2020-03-26,77,1,495,2,HR
2020-03-27,91,1,586,3,HR
2020-03-28,71,2,657,5,HR
2020-03-29,56,1,713,6,HR
2020-03-30,77,0,790,6,HR
2020-03-31,77,0,867,6,HR
2020-04-01,96,0,963,6,HR
2020-04-02,48,1,1011,7,HR
2020-04-03,68,1,1079,8,HR
2020-04-04,47,4,1126,12,HR
2020-04-05,56,3,1182,15,HR
2020-04-06,40,1,1222,16,HR
2020-04-07,60,2,1282,18,HR
2020-04-08,61,1,1343,19,HR
2020-04-09,64,1,1407,20,HR
2020-04-10,88,1,1495,21,HR
2020-04-11,39,0,1534,21,HR
2020-04-12,66,2,1600,23,HR
2020-04-13,50,2,1650,25,HR
2020-04-14,54,6,1704,31,HR
2020-04-15,37,3,1741,34,HR
2020-04-16,50,1,1791,35,HR
2020-04-17,23,1,1814,36,HR
2020-04-18,18,3,1832,39,HR
2020-04-19,39,8,1871,47,HR
2020-04-20,10,0,1881,47,HR
2020-04-21,27,1,1908,48,HR
2020-04-22,42,0,1950,48,HR
2020-04-23,31,2,1981,50,HR
2020-04-24,28,1,2009,51,HR
2020-04-25,7,3,2016,54,HR
2020-04-26,14,1,2030,55,HR
2020-04-27,9,4,2039,59,HR
2020-04-28,8,4,2047,63,HR
2020-04-29,15,4,2062,67,HR
2020-04-30,14,2,2076,69,HR
2020-05-01,9,6,2085,75,HR
2020-05-02,3,2,2088,77,HR
2020-05-03,8,2,2096,79,HR
2020-05-04,5,1,2101,80,HR
2020-05-05,11,3,2112,83,HR
2020-05-06,7,2,2119,85,HR
2020-05-07,6,1,2125,86,HR
2020-05-08,36,0,2161,86,HR
2020-05-09,15,1,2176,87,HR
2020-05-10,11,3,2187,90,HR
2020-05-11,9,1,2196,91,HR
2020-05-12,11,0,2207,91,HR
2020-05-13,6,3,2213,94,HR
2020-05-14,8,0,2221,94,HR
2020-05-15,1,1,2222,95,HR
2020-05-16,2,0,2224,95,HR
2020-05-17,2,0,2226,95,HR
2020-05-18,2,0,2228,95,HR
2020-05-19,4,1,2232,96,HR
2020-05-20,2,0,2234,96,HR
2020-05-21,3,1,2237,97,HR
2020-05-22,6,2,2243,99,HR
2020-05-23,0,0,2243,99,HR
2020-05-24,1,0,2244,99,HR
2020-05-25,0,1,2244,100,HR
2020-05-26,0,1,2244,101,HR
2020-05-27,0,0,2244,101,HR
2020-05-28,1,1,2245,102,HR
2020-05-29,0,1,2245,103,HR
2020-05-30,1,0,2246,103,HR
2020-05-31,0,0,2246,103,HR
2020-06-01,0,0,2246,103,HR
2020-06-02,0,0,2246,103,HR
2020-06-03,0,0,2246,103,HR
2020-06-04,1,0,2247,103,HR
2020-06-05,0,0,2247,103,HR
2020-06-06,0,1,2247,104,HR
2020-06-07,0,0,2247,104,HR
2020-06-08,0,0,2247,104,HR
2020-06-09,0,2,2247,106,HR
2020-06-10,2,0,2249,106,HR
2020-06-11,0,0,2249,106,HR
2020-06-12,0,1,2249,107,HR
2020-06-13,2,0,2251,107,HR
2020-06-14,1,0,2252,107,HR
2020-06-15,2,0,2254,107,HR
2020-06-16,1,0,2255,107,HR
2020-06-17,3,0,2258,107,HR
2020-06-18,11,0,2269,107,HR
2020-06-19,11,0,2280,107,HR
2020-06-20,19,0,2299,107,HR
2020-06-21,18,0,2317,107,HR
2020-06-22,19,0,2336,107,HR
2020-06-23,30,0,2366,107,HR
2020-06-24,22,0,2388,107,HR
2020-06-25,95,0,2483,107,HR
2020-06-26,56,0,2539,107,HR
2020-03-19,2,0,2,0,HT
2020-03-20,0,0,2,0,HT
2020-03-21,0,0,2,0,HT
2020-03-22,0,0,2,0,HT
2020-03-23,3,0,5,0,HT
2020-03-24,2,0,7,0,HT
2020-03-25,1,0,8,0,HT
2020-03-26,0,0,8,0,HT
2020-03-27,0,0,8,0,HT
2020-03-28,0,0,8,0,HT
2020-03-29,7,0,15,0,HT
2020-03-30,0,0,15,0,HT
2020-03-31,0,0,15,0,HT
2020-04-01,1,0,16,0,HT
2020-04-02,2,0,18,0,HT
2020-04-03,0,0,18,0,HT
2020-04-04,3,0,21,0,HT
2020-04-05,0,0,21,0,HT
2020-04-06,3,1,24,1,HT
2020-04-07,1,0,25,1,HT
2020-04-08,2,0,27,1,HT
2020-04-09,3,1,30,2,HT
2020-04-10,1,0,31,2,HT
2020-04-11,2,0,33,2,HT
2020-04-12,0,1,33,3,HT
2020-04-13,7,0,40,3,HT
2020-04-14,0,0,40,3,HT
2020-04-15,1,0,41,3,HT
2020-04-16,2,0,43,3,HT
2020-04-17,1,0,44,3,HT
2020-04-18,0,0,44,3,HT
2020-04-19,3,0,47,3,HT
2020-04-20,10,0,57,3,HT
2020-04-21,1,1,58,4,HT
2020-04-22,4,0,62,4,HT
2020-04-23,10,1,72,5,HT
2020-04-24,0,0,72,5,HT
2020-04-25,0,1,72,6,HT
2020-04-26,0,0,72,6,HT
2020-04-27,4,0,76,6,HT
2020-04-28,0,0,76,6,HT
2020-04-29,0,0,76,6,HT
2020-04-30,5,2,81,8,HT
2020-05-01,4,0,85,8,HT
2020-05-02,0,0,85,8,HT
2020-05-03,0,0,85,8,HT
2020-05-04,15,3,100,11,HT
2020-05-05,1,1,101,12,HT
2020-05-06,7,0,108,12,HT
2020-05-07,21,0,129,12,HT
2020-05-08,17,0,146,12,HT
2020-05-09,5,0,151,12,HT
2020-05-10,31,3,182,15,HT
2020-05-11,27,1,209,16,HT
2020-05-12,10,2,219,18,HT
2020-05-13,15,0,234,18,HT
2020-05-14,39,2,273,20,HT
2020-05-15,37,0,310,20,HT
2020-05-16,48,0,358,20,HT
2020-05-17,98,0,456,20,HT
2020-05-18,77,1,533,21,HT
2020-05-19,63,1,596,22,HT
2020-05-20,0,0,596,22,HT
2020-05-21,138,3,734,25,HT
2020-05-22,78,0,812,25,HT
2020-05-23,53,1,865,26,HT
2020-05-24,93,1,958,27,HT
2020-05-25,105,4,1063,31,HT
2020-05-26,111,2,1174,33,HT
2020-05-27,146,1,1320,34,HT
2020-05-28,123,1,1443,35,HT
2020-05-29,141,0,1584,35,HT
2020-05-30,281,6,1865,41,HT
2020-05-31,259,3,2124,44,HT
2020-06-01,102,1,2226,45,HT
2020-06-02,281,3,2507,48,HT
2020-06-03,133,2,2640,50,HT
2020-06-04,0,0,2640,50,HT
2020-06-05,284,0,2924,50,HT
2020-06-06,148,0,3072,50,HT
2020-06-07,262,1,3334,51,HT
2020-06-08,204,3,3538,54,HT
2020-06-09,124,2,3662,56,HT
2020-06-10,134,2,3796,58,HT
2020-06-11,145,6,3941,64,HT
2020-06-12,0,0,3941,64,HT
2020-06-13,224,6,4165,70,HT
2020-06-14,144,3,4309,73,HT
2020-06-15,132,3,4441,76,HT
2020-06-16,106,4,4547,80,HT
2020-06-17,141,2,4688,82,HT
2020-06-18,228,2,4916,84,HT
2020-06-19,64,3,4980,87,HT
2020-06-20,97,1,5077,88,HT
2020-06-21,134,0,5211,88,HT
2020-06-22,0,0,5211,88,HT
2020-06-23,113,1,5324,89,HT
2020-06-24,105,3,5429,92,HT
2020-06-25,114,4,5543,96,HT
2020-06-26,179,2,5722,98,HT
2020-03-04,2,0,2,0,HU
2020-03-06,2,0,4,0,HU
2020-03-07,3,0,7,0,HU
2020-03-08,1,0,8,0,HU
2020-03-09,1,0,9,0,HU
2020-03-10,3,0,12,0,HU
2020-03-11,1,0,13,0,HU
2020-03-12,3,0,16,0,HU
2020-03-13,9,0,25,0,HU
2020-03-14,6,0,31,0,HU
2020-03-15,8,1,39,1,HU
2020-03-16,11,0,50,1,HU
2020-03-17,0,0,50,1,HU
2020-03-18,23,0,73,1,HU
2020-03-19,12,0,85,1,HU
2020-03-20,18,3,103,4,HU
2020-03-21,28,0,131,4,HU
2020-03-22,36,3,167,7,HU
2020-03-23,20,1,187,8,HU
2020-03-24,39,2,226,10,HU
2020-03-25,35,0,261,10,HU
2020-03-26,39,0,300,10,HU
2020-03-27,43,1,343,11,HU
2020-03-28,65,2,408,13,HU
2020-03-29,39,2,447,15,HU
2020-03-30,45,1,492,16,HU
2020-03-31,33,4,525,20,HU
2020-04-01,60,1,585,21,HU
2020-04-02,38,5,623,26,HU
2020-04-03,55,6,678,32,HU
2020-04-04,55,2,733,34,HU
2020-04-05,11,4,744,38,HU
2020-04-06,73,9,817,47,HU
2020-04-07,78,11,895,58,HU
2020-04-08,85,8,980,66,HU
2020-04-09,210,11,1190,77,HU
2020-04-10,120,8,1310,85,HU
2020-04-11,100,14,1410,99,HU
2020-04-12,48,10,1458,109,HU
2020-04-13,54,13,1512,122,HU
2020-04-14,67,12,1579,134,HU
2020-04-15,73,8,1652,142,HU
2020-04-16,111,14,1763,156,HU
2020-04-17,71,16,1834,172,HU
2020-04-18,82,17,1916,189,HU
2020-04-19,68,10,1984,199,HU
2020-04-20,114,14,2098,213,HU
2020-04-21,70,12,2168,225,HU
2020-04-22,116,0,2284,225,HU
2020-04-23,99,25,2383,250,HU
2020-04-24,60,12,2443,262,HU
2020-04-25,57,10,2500,272,HU
2020-04-26,83,8,2583,280,HU
2020-04-27,66,11,2649,291,HU
2020-04-28,78,9,2727,300,HU
2020-04-29,48,12,2775,312,HU
2020-04-30,88,11,2863,323,HU
2020-05-01,79,12,2942,335,HU
2020-05-02,56,5,2998,340,HU
2020-05-03,37,11,3035,351,HU
2020-05-04,30,12,3065,363,HU
2020-05-05,46,10,3111,373,HU
2020-05-06,39,10,3150,383,HU
2020-05-07,28,9,3178,392,HU
2020-05-08,35,13,3213,405,HU
2020-05-09,50,8,3263,413,HU
2020-05-10,21,8,3284,421,HU
2020-05-11,29,4,3313,425,HU
2020-05-12,28,5,3341,430,HU
2020-05-13,39,6,3380,436,HU
2020-05-14,37,6,3417,442,HU
2020-05-15,56,6,3473,448,HU
2020-05-16,36,3,3509,451,HU
2020-05-17,26,11,3535,462,HU
2020-05-18,21,5,3556,467,HU
2020-05-19,42,3,3598,470,HU
2020-05-20,43,3,3641,473,HU
2020-05-21,37,3,3678,476,HU
2020-05-22,35,6,3713,482,HU
2020-05-23,28,4,3741,486,HU
2020-05-24,15,5,3756,491,HU
2020-05-25,15,8,3771,499,HU
2020-05-26,22,6,3793,505,HU
2020-05-27,23,4,3816,509,HU
2020-05-28,25,8,3841,517,HU
2020-05-29,0,0,3841,517,HU
2020-05-30,26,7,3867,524,HU
2020-05-31,9,2,3876,526,HU
2020-06-01,45,6,3921,532,HU
2020-06-02,10,2,3931,534,HU
2020-06-03,0,0,3931,534,HU
2020-06-04,23,5,3954,539,HU
2020-06-05,16,3,3970,542,HU
2020-06-06,0,0,3970,542,HU
2020-06-07,0,0,3970,542,HU
2020-06-08,44,6,4014,548,HU
2020-06-09,3,2,4017,550,HU
2020-06-10,10,1,4027,551,HU
2020-06-11,12,2,4039,553,HU
2020-06-12,14,2,4053,555,HU
2020-06-13,11,4,4064,559,HU
2020-06-14,12,4,4076,563,HU
2020-06-15,1,2,4077,565,HU
2020-06-16,1,2,4078,567,HU
2020-06-17,1,1,4079,568,HU
2020-06-18,2,0,4081,568,HU
2020-06-19,5,2,4086,570,HU
2020-06-20,8,0,4094,570,HU
2020-06-21,8,2,4102,572,HU
2020-06-22,5,1,4107,573,HU
2020-06-23,0,0,4107,573,HU
2020-06-24,7,3,4114,576,HU
2020-06-25,9,1,4123,577,HU
2020-06-26,4,1,4127,578,HU
2019-12-30,0,0,0,0,ID
2019-12-31,0,0,0,0,ID
2020-01-01,0,0,0,0,ID
2020-01-02,0,0,0,0,ID
2020-01-03,0,0,0,0,ID
2020-01-04,0,0,0,0,ID
2020-01-05,0,0,0,0,ID
2020-01-06,0,0,0,0,ID
2020-01-07,0,0,0,0,ID
2020-01-08,0,0,0,0,ID
2020-01-09,0,0,0,0,ID
2020-01-10,0,0,0,0,ID
2020-01-11,0,0,0,0,ID
2020-01-12,0,0,0,0,ID
2020-01-13,0,0,0,0,ID
2020-01-14,0,0,0,0,ID
2020-01-15,0,0,0,0,ID
2020-01-16,0,0,0,0,ID
2020-01-17,0,0,0,0,ID
2020-01-18,0,0,0,0,ID
2020-01-19,0,0,0,0,ID
2020-01-20,0,0,0,0,ID
2020-01-21,0,0,0,0,ID
2020-01-22,0,0,0,0,ID
2020-01-23,0,0,0,0,ID
2020-01-24,0,0,0,0,ID
2020-01-25,0,0,0,0,ID
2020-01-26,0,0,0,0,ID
2020-01-27,0,0,0,0,ID
2020-01-28,0,0,0,0,ID
2020-01-29,0,0,0,0,ID
2020-01-30,0,0,0,0,ID
2020-01-31,0,0,0,0,ID
2020-02-01,0,0,0,0,ID
2020-02-02,0,0,0,0,ID
2020-02-03,0,0,0,0,ID
2020-02-04,0,0,0,0,ID
2020-02-05,0,0,0,0,ID
2020-02-06,0,0,0,0,ID
2020-02-07,0,0,0,0,ID
2020-02-08,0,0,0,0,ID
2020-02-09,0,0,0,0,ID
2020-02-10,0,0,0,0,ID
2020-02-11,0,0,0,0,ID
2020-02-12,0,0,0,0,ID
2020-02-13,0,0,0,0,ID
2020-02-14,0,0,0,0,ID
2020-02-15,0,0,0,0,ID
2020-02-16,0,0,0,0,ID
2020-02-17,0,0,0,0,ID
2020-02-18,0,0,0,0,ID
2020-02-19,0,0,0,0,ID
2020-02-20,0,0,0,0,ID
2020-02-21,0,0,0,0,ID
2020-02-22,0,0,0,0,ID
2020-02-23,0,0,0,0,ID
2020-02-24,0,0,0,0,ID
2020-02-25,0,0,0,0,ID
2020-02-26,0,0,0,0,ID
2020-02-27,0,0,0,0,ID
2020-02-28,0,0,0,0,ID
2020-02-29,0,0,0,0,ID
2020-03-01,2,0,2,0,ID
2020-03-06,2,0,4,0,ID
2020-03-08,2,0,6,0,ID
2020-03-10,13,0,19,0,ID
2020-03-11,15,1,34,1,ID
2020-03-13,35,3,69,4,ID
2020-03-14,27,0,96,4,ID
2020-03-15,21,1,117,5,ID
2020-03-16,17,0,134,5,ID
2020-03-17,38,0,172,5,ID
2020-03-18,0,0,172,5,ID
2020-03-19,55,14,227,19,ID
2020-03-20,82,6,309,25,ID
2020-03-21,141,13,450,38,ID
2020-03-22,64,10,514,48,ID
2020-03-23,65,1,579,49,ID
2020-03-24,107,6,686,55,ID
2020-03-25,104,3,790,58,ID
2020-03-26,103,20,893,78,ID
2020-03-27,153,9,1046,87,ID
2020-03-28,109,15,1155,102,ID
2020-03-29,130,12,1285,114,ID
2020-03-30,129,8,1414,122,ID
2020-03-31,114,14,1528,136,ID
2020-04-01,149,21,1677,157,ID
2020-04-02,113,13,1790,170,ID
2020-04-03,196,11,1986,181,ID
2020-04-04,106,10,2092,191,ID
2020-04-05,181,7,2273,198,ID
2020-04-06,218,11,2491,209,ID
2020-04-07,247,12,2738,221,ID
2020-04-08,218,19,2956,240,ID
2020-04-09,337,40,3293,280,ID
2020-04-10,219,26,3512,306,ID
2020-04-11,330,21,3842,327,ID
2020-04-12,399,46,4241,373,ID
2020-04-13,316,26,4557,399,ID
2020-04-14,282,60,4839,459,ID
2020-04-15,297,10,5136,469,ID
2020-04-16,380,27,5516,496,ID
2020-04-17,407,24,5923,520,ID
2020-04-18,325,15,6248,535,ID
2020-04-19,327,47,6575,582,ID
2020-04-20,185,8,6760,590,ID
2020-04-21,375,26,7135,616,ID
2020-04-22,283,19,7418,635,ID
2020-04-23,357,12,7775,647,ID
2020-04-24,436,42,8211,689,ID
2020-04-25,396,31,8607,720,ID
2020-04-26,275,23,8882,743,ID
2020-04-27,214,22,9096,765,ID
2020-04-28,415,8,9511,773,ID
2020-04-29,260,11,9771,784,ID
2020-04-30,347,8,10118,792,ID
2020-05-01,433,8,10551,800,ID
2020-05-02,292,31,10843,831,ID
2020-05-03,349,14,11192,845,ID
2020-05-04,395,19,11587,864,ID
2020-05-05,484,8,12071,872,ID
2020-05-06,367,23,12438,895,ID
2020-05-07,338,35,12776,930,ID
2020-05-08,336,13,13112,943,ID
2020-05-09,533,16,13645,959,ID
2020-05-10,387,14,14032,973,ID
2020-05-11,233,18,14265,991,ID
2020-05-12,484,16,14749,1007,ID
2020-05-13,689,21,15438,1028,ID
2020-05-14,568,15,16006,1043,ID
2020-05-15,490,33,16496,1076,ID
2020-05-16,529,13,17025,1089,ID
2020-05-17,489,59,17514,1148,ID
2020-05-18,496,43,18010,1191,ID
2020-05-19,486,30,18496,1221,ID
2020-05-20,693,21,19189,1242,ID
2020-05-21,973,36,20162,1278,ID
2020-05-22,634,48,20796,1326,ID
2020-05-23,949,25,21745,1351,ID
2020-05-24,526,21,22271,1372,ID
2020-05-25,479,19,22750,1391,ID
2020-05-26,415,27,23165,1418,ID
2020-05-27,686,55,23851,1473,ID
2020-05-28,687,23,24538,1496,ID
2020-05-29,678,24,25216,1520,ID
2020-05-30,557,53,25773,1573,ID
2020-05-31,700,40,26473,1613,ID
2020-06-01,467,28,26940,1641,ID
2020-06-02,609,22,27549,1663,ID
2020-06-03,684,35,28233,1698,ID
2020-06-04,585,23,28818,1721,ID
2020-06-05,703,49,29521,1770,ID
2020-06-06,993,31,30514,1801,ID
2020-06-07,672,50,31186,1851,ID
2020-06-08,847,32,32033,1883,ID
2020-06-09,1043,40,33076,1923,ID
2020-06-10,1240,36,34316,1959,ID
2020-06-11,979,41,35295,2000,ID
2020-06-12,1111,48,36406,2048,ID
2020-06-13,1014,43,37420,2091,ID
2020-06-14,857,43,38277,2134,ID
2020-06-15,1017,64,39294,2198,ID
2020-06-16,1106,33,40400,2231,ID
2020-06-17,1031,45,41431,2276,ID
2020-06-18,1331,63,42762,2339,ID
2020-06-19,1041,34,43803,2373,ID
2020-06-20,1226,56,45029,2429,ID
2020-06-21,862,36,45891,2465,ID
2020-06-22,954,35,46845,2500,ID
2020-06-23,1051,35,47896,2535,ID
2020-06-24,1113,38,49009,2573,ID
2020-06-25,1178,47,50187,2620,ID
2020-06-26,1240,63,51427,2683,ID
2019-12-30,0,0,0,0,IE
2019-12-31,0,0,0,0,IE
2020-01-01,0,0,0,0,IE
2020-01-02,0,0,0,0,IE
2020-01-03,0,0,0,0,IE
2020-01-04,0,0,0,0,IE
2020-01-05,0,0,0,0,IE
2020-01-06,0,0,0,0,IE
2020-01-07,0,0,0,0,IE
2020-01-08,0,0,0,0,IE
2020-01-09,0,0,0,0,IE
2020-01-10,0,0,0,0,IE
2020-01-11,0,0,0,0,IE
2020-01-12,0,0,0,0,IE
2020-01-13,0,0,0,0,IE
2020-01-14,0,0,0,0,IE
2020-01-15,0,0,0,0,IE
2020-01-16,0,0,0,0,IE
2020-01-17,0,0,0,0,IE
2020-01-18,0,0,0,0,IE
2020-01-19,0,0,0,0,IE
2020-01-20,0,0,0,0,IE
2020-01-21,0,0,0,0,IE
2020-01-22,0,0,0,0,IE
2020-01-23,0,0,0,0,IE
2020-01-24,0,0,0,0,IE
2020-01-25,0,0,0,0,IE
2020-01-26,0,0,0,0,IE
2020-01-27,0,0,0,0,IE
2020-01-28,0,0,0,0,IE
2020-01-29,0,0,0,0,IE
2020-01-30,0,0,0,0,IE
2020-01-31,0,0,0,0,IE
2020-02-01,0,0,0,0,IE
2020-02-02,0,0,0,0,IE
2020-02-03,0,0,0,0,IE
2020-02-04,0,0,0,0,IE
2020-02-05,0,0,0,0,IE
2020-02-06,0,0,0,0,IE
2020-02-07,0,0,0,0,IE
2020-02-08,0,0,0,0,IE
2020-02-09,0,0,0,0,IE
2020-02-10,0,0,0,0,IE
2020-02-11,0,0,0,0,IE
2020-02-12,0,0,0,0,IE
2020-02-13,0,0,0,0,IE
2020-02-14,0,0,0,0,IE
2020-02-15,0,0,0,0,IE
2020-02-16,0,0,0,0,IE
2020-02-17,0,0,0,0,IE
2020-02-18,0,0,0,0,IE
2020-02-19,0,0,0,0,IE
2020-02-20,0,0,0,0,IE
2020-02-21,0,0,0,0,IE
2020-02-22,0,0,0,0,IE
2020-02-23,0,0,0,0,IE
2020-02-24,0,0,0,0,IE
2020-02-25,0,0,0,0,IE
2020-02-26,0,0,0,0,IE
2020-02-27,0,0,0,0,IE
2020-02-28,0,0,0,0,IE
2020-02-29,1,0,1,0,IE
2020-03-01,0,0,1,0,IE
2020-03-03,1,0,2,0,IE
2020-03-04,4,0,6,0,IE
2020-03-05,7,0,13,0,IE
2020-03-06,5,0,18,0,IE
2020-03-07,1,0,19,0,IE
2020-03-08,2,0,21,0,IE
2020-03-10,14,0,35,0,IE
2020-03-11,8,1,43,1,IE
2020-03-12,27,0,70,1,IE
2020-03-13,21,0,91,1,IE
2020-03-14,38,1,129,2,IE
2020-03-15,40,0,169,2,IE
2020-03-16,54,0,223,2,IE
2020-03-17,69,0,292,2,IE
2020-03-18,74,0,366,2,IE
2020-03-19,191,1,557,3,IE
2020-03-20,126,0,683,3,IE
2020-03-21,102,0,785,3,IE
2020-03-22,121,1,906,4,IE
2020-03-23,219,2,1125,6,IE
2020-03-24,204,1,1329,7,IE
2020-03-25,235,2,1564,9,IE
2020-03-26,255,10,1819,19,IE
2020-03-27,302,3,2121,22,IE
2020-03-28,294,14,2415,36,IE
2020-03-29,200,10,2615,46,IE
2020-03-30,295,8,2910,54,IE
2020-03-31,325,17,3235,71,IE
2020-04-01,212,14,3447,85,IE
2020-04-02,402,13,3849,98,IE
2020-04-03,424,22,4273,120,IE
2020-04-04,331,17,4604,137,IE
2020-04-05,507,21,5111,158,IE
2020-04-06,253,16,5364,174,IE
2020-04-07,345,36,5709,210,IE
2020-04-08,515,25,6224,235,IE
2020-04-09,1169,28,7393,263,IE
2020-04-10,696,24,8089,287,IE
2020-04-11,839,33,8928,320,IE
2020-04-12,727,14,9655,334,IE
2020-04-13,992,31,10647,365,IE
2020-04-14,832,41,11479,406,IE
2020-04-15,1068,38,12547,444,IE
2020-04-16,724,42,13271,486,IE
2020-04-17,709,44,13980,530,IE
2020-04-18,778,41,14758,571,IE
2020-04-19,493,39,15251,610,IE
2020-04-20,401,77,15652,687,IE
2020-04-21,388,43,16040,730,IE
2020-04-22,631,39,16671,769,IE
2020-04-23,936,25,17607,794,IE
2020-04-24,577,35,18184,829,IE
2020-04-25,377,234,18561,1063,IE
2020-04-26,701,24,19262,1087,IE
2020-04-27,386,15,19648,1102,IE
2020-04-28,229,57,19877,1159,IE
2020-04-29,376,31,20253,1190,IE
2020-04-30,359,42,20612,1232,IE
2020-05-01,221,33,20833,1265,IE
2020-05-02,343,0,21176,1265,IE
2020-05-03,330,38,21506,1303,IE
2020-05-04,216,16,21722,1319,IE
2020-05-05,261,20,21983,1339,IE
2020-05-06,265,36,22248,1375,IE
2020-05-07,137,28,22385,1403,IE
2020-05-08,156,26,22541,1429,IE
2020-05-09,219,17,22760,1446,IE
2020-05-10,236,12,22996,1458,IE
2020-05-11,139,9,23135,1467,IE
2020-05-12,107,21,23242,1488,IE
2020-05-13,159,9,23401,1497,IE
2020-05-14,426,9,23827,1506,IE
2020-05-15,129,12,23956,1518,IE
2020-05-16,92,15,24048,1533,IE
2020-05-17,64,10,24112,1543,IE
2020-05-18,88,4,24200,1547,IE
2020-05-19,51,14,24251,1561,IE
2020-05-20,64,10,24315,1571,IE
2020-05-21,76,12,24391,1583,IE
2020-05-22,115,9,24506,1592,IE
2020-05-23,76,12,24582,1604,IE
2020-05-24,57,2,24639,1606,IE
2020-05-25,59,0,24698,1606,IE
2020-05-26,37,9,24735,1615,IE
2020-05-27,68,16,24803,1631,IE
2020-05-28,38,8,24841,1639,IE
2020-05-29,35,6,24876,1645,IE
2020-05-30,53,5,24929,1650,IE
2020-05-31,61,0,24990,1650,IE
2020-06-01,72,0,25062,1650,IE
2020-06-02,4,8,25066,1658,IE
2020-06-03,45,1,25111,1659,IE
2020-06-04,31,5,25142,1664,IE
2020-06-05,21,6,25163,1670,IE
2020-06-06,20,0,25183,1670,IE
2020-06-07,18,9,25201,1679,IE
2020-06-08,6,4,25207,1683,IE
2020-06-09,8,8,25215,1691,IE
2020-06-10,16,4,25231,1695,IE
2020-06-11,7,8,25238,1703,IE
2020-06-12,12,2,25250,1705,IE
2020-06-13,45,0,25295,1705,IE
2020-06-14,8,1,25303,1706,IE
2020-06-15,18,0,25321,1706,IE
2020-06-16,13,3,25334,1709,IE
2020-06-17,7,1,25341,1710,IE
2020-06-18,14,4,25355,1714,IE
2020-06-19,13,0,25368,1714,IE
2020-06-20,6,1,25374,1715,IE
2020-06-21,5,0,25379,1715,IE
2020-06-22,4,2,25383,1717,IE
2020-06-23,8,3,25391,1720,IE
2020-06-24,5,6,25396,1726,IE
2020-06-25,9,1,25405,1727,IE
2020-06-26,9,3,25414,1730,IE
2019-12-30,0,0,0,0,IL
2019-12-31,0,0,0,0,IL
2020-01-01,0,0,0,0,IL
2020-01-02,0,0,0,0,IL
2020-01-03,0,0,0,0,IL
2020-01-04,0,0,0,0,IL
2020-01-05,0,0,0,0,IL
2020-01-06,0,0,0,0,IL
2020-01-07,0,0,0,0,IL
2020-01-08,0,0,0,0,IL
2020-01-09,0,0,0,0,IL
2020-01-10,0,0,0,0,IL
2020-01-11,0,0,0,0,IL
2020-01-12,0,0,0,0,IL
2020-01-13,0,0,0,0,IL
2020-01-14,0,0,0,0,IL
2020-01-15,0,0,0,0,IL
2020-01-16,0,0,0,0,IL
2020-01-17,0,0,0,0,IL
2020-01-18,0,0,0,0,IL
2020-01-19,0,0,0,0,IL
2020-01-20,0,0,0,0,IL
2020-01-21,0,0,0,0,IL
2020-01-22,0,0,0,0,IL
2020-01-23,0,0,0,0,IL
2020-01-24,0,0,0,0,IL
2020-01-25,0,0,0,0,IL
2020-01-26,0,0,0,0,IL
2020-01-27,0,0,0,0,IL
2020-01-28,0,0,0,0,IL
2020-01-29,0,0,0,0,IL
2020-01-30,0,0,0,0,IL
2020-01-31,0,0,0,0,IL
2020-02-01,0,0,0,0,IL
2020-02-02,0,0,0,0,IL
2020-02-03,0,0,0,0,IL
2020-02-04,0,0,0,0,IL
2020-02-05,0,0,0,0,IL
2020-02-06,0,0,0,0,IL
2020-02-07,0,0,0,0,IL
2020-02-08,0,0,0,0,IL
2020-02-09,0,0,0,0,IL
2020-02-10,0,0,0,0,IL
2020-02-11,0,0,0,0,IL
2020-02-12,0,0,0,0,IL
2020-02-13,0,0,0,0,IL
2020-02-14,0,0,0,0,IL
2020-02-15,0,0,0,0,IL
2020-02-16,0,0,0,0,IL
2020-02-17,0,0,0,0,IL
2020-02-18,0,0,0,0,IL
2020-02-19,0,0,0,0,IL
2020-02-20,0,0,0,0,IL
2020-02-21,1,0,1,0,IL
2020-02-22,0,0,1,0,IL
2020-02-23,1,0,2,0,IL
2020-02-24,0,0,2,0,IL
2020-02-25,0,0,2,0,IL
2020-02-26,0,0,2,0,IL
2020-02-27,1,0,3,0,IL
2020-02-28,4,0,7,0,IL
2020-02-29,0,0,7,0,IL
2020-03-01,3,0,10,0,IL
2020-03-04,5,0,15,0,IL
2020-03-05,2,0,17,0,IL
2020-03-06,2,0,19,0,IL
2020-03-07,6,0,25,0,IL
2020-03-08,14,0,39,0,IL
2020-03-10,31,0,70,0,IL
2020-03-11,12,0,82,0,IL
2020-03-12,14,0,96,0,IL
2020-03-13,20,0,116,0,IL
2020-03-14,62,0,178,0,IL
2020-03-15,72,0,250,0,IL
2020-03-16,10,0,260,0,IL
2020-03-17,167,0,427,0,IL
2020-03-18,6,0,433,0,IL
2020-03-19,244,0,677,0,IL
2020-03-20,35,1,712,1,IL
2020-03-21,171,0,883,1,IL
2020-03-22,188,0,1071,1,IL
2020-03-23,371,0,1442,1,IL
2020-03-24,488,2,1930,3,IL
2020-03-25,439,2,2369,5,IL
2020-03-26,297,3,2666,8,IL
2020-03-27,369,2,3035,10,IL
2020-03-28,584,2,3619,12,IL
2020-03-29,628,3,4247,15,IL
2020-03-30,226,2,4473,17,IL
2020-03-31,443,3,4916,20,IL
2020-04-01,675,1,5591,21,IL
2020-04-02,661,13,6252,34,IL
2020-04-03,1176,5,7428,39,IL
2020-04-04,590,7,8018,46,IL
2020-04-05,412,3,8430,49,IL
2020-04-06,474,8,8904,57,IL
2020-04-07,344,8,9248,65,IL
2020-04-08,156,6,9404,71,IL
2020-04-09,564,15,9968,86,IL
2020-04-10,440,9,10408,95,IL
2020-04-11,335,6,10743,101,IL
2020-04-12,402,2,11145,103,IL
2020-04-13,441,13,11586,116,IL
2020-04-14,460,7,12046,123,IL
2020-04-15,455,7,12501,130,IL
2020-04-16,257,12,12758,142,IL
2020-04-17,224,9,12982,151,IL
2020-04-18,283,13,13265,164,IL
2020-04-19,226,8,13491,172,IL
2020-04-20,222,5,13713,177,IL
2020-04-21,229,7,13942,184,IL
2020-04-22,650,7,14592,191,IL
2020-04-23,290,2,14882,193,IL
2020-04-24,176,1,15058,194,IL
2020-04-25,240,5,15298,199,IL
2020-04-26,100,0,15398,199,IL
2020-04-27,68,3,15466,202,IL
2020-04-28,123,6,15589,208,IL
2020-04-29,245,7,15834,215,IL
2020-04-30,112,7,15946,222,IL
2020-05-01,155,3,16101,225,IL
2020-05-02,84,4,16185,229,IL
2020-05-03,23,3,16208,232,IL
2020-05-04,38,3,16246,235,IL
2020-05-05,43,3,16289,238,IL
2020-05-06,21,1,16310,239,IL
2020-05-07,71,1,16381,240,IL
2020-05-08,55,5,16436,245,IL
2020-05-09,18,2,16454,247,IL
2020-05-10,23,5,16477,252,IL
2020-05-11,29,6,16506,258,IL
2020-05-12,23,2,16529,260,IL
2020-05-13,19,4,16548,264,IL
2020-05-14,31,1,16579,265,IL
2020-05-15,10,1,16589,266,IL
2020-05-16,19,2,16608,268,IL
2020-05-17,9,4,16617,272,IL
2020-05-18,4,0,16621,272,IL
2020-05-19,29,5,16650,277,IL
2020-05-20,20,2,16670,279,IL
2020-05-21,20,0,16690,279,IL
2020-05-22,0,0,16690,279,IL
2020-05-23,0,0,16690,279,IL
2020-05-24,30,1,16720,280,IL
2020-05-25,14,1,16734,281,IL
2020-05-26,23,0,16757,281,IL
2020-05-27,36,0,16793,281,IL
2020-05-28,79,3,16872,284,IL
2020-05-29,115,0,16987,284,IL
2020-05-30,25,0,17012,284,IL
2020-05-31,59,1,17071,285,IL
2020-06-01,148,2,17219,287,IL
2020-06-02,123,3,17342,290,IL
2020-06-03,87,1,17429,291,IL
2020-06-04,133,0,17562,291,IL
2020-06-05,144,1,17706,292,IL
2020-06-06,77,5,17783,297,IL
2020-06-07,132,1,17915,298,IL
2020-06-08,174,0,18089,298,IL
2020-06-09,179,1,18268,299,IL
2020-06-10,87,0,18355,299,IL
2020-06-11,346,1,18701,300,IL
2020-06-12,175,0,18876,300,IL
2020-06-13,132,0,19008,300,IL
2020-06-14,113,2,19121,302,IL
2020-06-15,217,0,19338,302,IL
2020-06-16,299,1,19637,303,IL
2020-06-17,257,0,19894,303,IL
2020-06-18,142,0,20036,303,IL
2020-06-19,303,1,20339,304,IL
2020-06-20,294,1,20633,305,IL
2020-06-21,145,1,20778,306,IL
2020-06-22,304,1,21082,307,IL
2020-06-23,430,1,21512,308,IL
2020-06-24,532,0,22044,308,IL
2020-06-25,356,1,22400,309,IL
2020-06-26,400,5,22800,314,IL
2020-03-20,1,0,1,0,IM
2020-03-21,1,0,2,0,IM
2020-03-22,0,0,2,0,IM
2020-03-23,11,0,13,0,IM
2020-03-24,10,0,23,0,IM
2020-03-25,0,0,23,0,IM
2020-03-26,3,0,26,0,IM
2020-03-27,3,0,29,0,IM
2020-03-28,3,0,32,0,IM
2020-03-29,10,0,42,0,IM
2020-03-30,0,0,42,0,IM
2020-03-31,10,0,52,0,IM
2020-04-01,13,0,65,0,IM
2020-04-02,6,1,71,1,IM
2020-04-03,43,0,114,1,IM
2020-04-04,12,0,126,1,IM
2020-04-05,1,0,127,1,IM
2020-04-06,12,0,139,1,IM
2020-04-07,11,0,150,1,IM
2020-04-08,8,0,158,1,IM
2020-04-09,32,0,190,1,IM
2020-04-10,11,0,201,1,IM
2020-04-11,25,0,226,1,IM
2020-04-12,2,1,228,2,IM
2020-04-13,14,0,242,2,IM
2020-04-14,0,0,242,2,IM
2020-04-15,12,0,254,2,IM
2020-04-16,30,2,284,4,IM
2020-04-17,5,0,289,4,IM
2020-04-18,8,2,297,6,IM
2020-04-19,1,0,298,6,IM
2020-04-20,2,3,300,9,IM
2020-04-21,7,1,307,10,IM
2020-04-22,0,5,307,15,IM
2020-04-23,0,1,307,16,IM
2020-04-24,1,2,308,18,IM
2020-04-25,0,0,308,18,IM
2020-04-26,0,0,308,18,IM
2020-04-27,0,0,308,18,IM
2020-04-28,1,3,309,21,IM
2020-04-29,4,0,313,21,IM
2020-04-30,2,0,315,21,IM
2020-05-01,1,1,316,22,IM
2020-05-02,4,0,320,22,IM
2020-05-03,1,0,321,22,IM
2020-05-04,4,1,325,23,IM
2020-05-05,1,0,326,23,IM
2020-05-06,1,0,327,23,IM
2020-05-07,2,0,329,23,IM
2020-05-08,0,0,329,23,IM
2020-05-09,1,0,330,23,IM
2020-05-10,0,0,330,23,IM
2020-05-11,0,0,330,23,IM
2020-05-12,1,0,331,23,IM
2020-05-13,1,0,332,23,IM
2020-05-14,0,0,332,23,IM
2020-05-15,2,1,334,24,IM
2020-05-16,1,0,335,24,IM
2020-05-17,0,0,335,24,IM
2020-05-18,0,0,335,24,IM
2020-05-19,0,0,335,24,IM
2020-05-20,1,0,336,24,IM
2020-05-21,0,0,336,24,IM
2020-05-22,0,0,336,24,IM
2020-05-23,0,0,336,24,IM
2020-05-24,0,0,336,24,IM
2020-05-25,0,0,336,24,IM
2020-05-26,0,0,336,24,IM
2020-05-27,0,0,336,24,IM
2020-05-28,0,0,336,24,IM
2020-05-29,0,0,336,24,IM
2020-05-30,0,0,336,24,IM
2020-05-31,0,0,336,24,IM
2020-06-01,0,0,336,24,IM
2020-06-02,0,0,336,24,IM
2020-06-03,0,0,336,24,IM
2020-06-04,0,0,336,24,IM
2020-06-05,0,0,336,24,IM
2020-06-06,0,0,336,24,IM
2020-06-07,0,0,336,24,IM
2020-06-08,0,0,336,24,IM
2020-06-09,0,0,336,24,IM
2020-06-10,0,0,336,24,IM
2020-06-11,0,0,336,24,IM
2020-06-12,0,0,336,24,IM
2020-06-13,0,0,336,24,IM
2020-06-14,0,0,336,24,IM
2020-06-15,0,0,336,24,IM
2020-06-16,0,0,336,24,IM
2020-06-17,0,0,336,24,IM
2020-06-18,0,0,336,24,IM
2020-06-19,0,0,336,24,IM
2020-06-20,0,0,336,24,IM
2020-06-21,0,0,336,24,IM
2020-06-22,0,0,336,24,IM
2020-06-23,0,0,336,24,IM
2020-06-24,0,0,336,24,IM
2020-06-25,0,0,336,24,IM
2020-06-26,0,0,336,24,IM
2019-12-30,0,0,0,0,IN
2019-12-31,0,0,0,0,IN
2020-01-01,0,0,0,0,IN
2020-01-02,0,0,0,0,IN
2020-01-03,0,0,0,0,IN
2020-01-04,0,0,0,0,IN
2020-01-05,0,0,0,0,IN
2020-01-06,0,0,0,0,IN
2020-01-07,0,0,0,0,IN
2020-01-08,0,0,0,0,IN
2020-01-09,0,0,0,0,IN
2020-01-10,0,0,0,0,IN
2020-01-11,0,0,0,0,IN
2020-01-12,0,0,0,0,IN
2020-01-13,0,0,0,0,IN
2020-01-14,0,0,0,0,IN
2020-01-15,0,0,0,0,IN
2020-01-16,0,0,0,0,IN
2020-01-17,0,0,0,0,IN
2020-01-18,0,0,0,0,IN
2020-01-19,0,0,0,0,IN
2020-01-20,0,0,0,0,IN
2020-01-21,0,0,0,0,IN
2020-01-22,0,0,0,0,IN
2020-01-23,0,0,0,0,IN
2020-01-24,0,0,0,0,IN
2020-01-25,0,0,0,0,IN
2020-01-26,0,0,0,0,IN
2020-01-27,0,0,0,0,IN
2020-01-28,0,0,0,0,IN
2020-01-29,1,0,1,0,IN
2020-01-30,0,0,1,0,IN
2020-01-31,0,0,1,0,IN
2020-02-01,1,0,2,0,IN
2020-02-02,0,0,2,0,IN
2020-02-03,1,0,3,0,IN
2020-02-04,0,0,3,0,IN
2020-02-05,0,0,3,0,IN
2020-02-06,0,0,3,0,IN
2020-02-07,0,0,3,0,IN
2020-02-08,0,0,3,0,IN
2020-02-09,0,0,3,0,IN
2020-02-10,0,0,3,0,IN
2020-02-11,0,0,3,0,IN
2020-02-12,0,0,3,0,IN
2020-02-13,0,0,3,0,IN
2020-02-14,0,0,3,0,IN
2020-02-15,0,0,3,0,IN
2020-02-16,0,0,3,0,IN
2020-02-17,0,0,3,0,IN
2020-02-18,0,0,3,0,IN
2020-02-19,0,0,3,0,IN
2020-02-20,0,0,3,0,IN
2020-02-21,0,0,3,0,IN
2020-02-22,0,0,3,0,IN
2020-02-23,0,0,3,0,IN
2020-02-24,0,0,3,0,IN
2020-02-25,0,0,3,0,IN
2020-02-26,0,0,3,0,IN
2020-02-27,0,0,3,0,IN
2020-02-28,0,0,3,0,IN
2020-02-29,0,0,3,0,IN
2020-03-01,0,0,3,0,IN
2020-03-02,2,0,5,0,IN
2020-03-03,1,0,6,0,IN
2020-03-04,22,0,28,0,IN
2020-03-05,1,0,29,0,IN
2020-03-06,2,0,31,0,IN
2020-03-07,3,0,34,0,IN
2020-03-09,10,0,44,0,IN
2020-03-10,6,0,50,0,IN
2020-03-11,23,0,73,0,IN
2020-03-12,2,1,75,1,IN
2020-03-13,8,1,83,2,IN
2020-03-14,7,0,90,2,IN
2020-03-15,3,0,93,2,IN
2020-03-16,32,1,125,3,IN
2020-03-17,12,0,137,3,IN
2020-03-18,28,0,165,3,IN
2020-03-19,26,1,191,4,IN
2020-03-20,40,0,231,4,IN
2020-03-21,89,0,320,4,IN
2020-03-22,119,3,439,7,IN
2020-03-23,53,2,492,9,IN
2020-03-24,70,0,562,9,IN
2020-03-25,87,4,649,13,IN
2020-03-26,75,4,724,17,IN
2020-03-27,149,2,873,19,IN
2020-03-28,106,6,979,25,IN
2020-03-29,92,4,1071,29,IN
2020-03-30,180,3,1251,32,IN
2020-03-31,146,3,1397,35,IN
2020-04-01,568,15,1965,50,IN
2020-04-02,336,6,2301,56,IN
2020-04-03,601,12,2902,68,IN
2020-04-04,472,9,3374,77,IN
2020-04-05,693,32,4067,109,IN
2020-04-06,354,5,4421,114,IN
2020-04-07,773,35,5194,149,IN
2020-04-08,540,17,5734,166,IN
2020-04-09,678,33,6412,199,IN
2020-04-10,1035,40,7447,239,IN
2020-04-11,909,34,8356,273,IN
2020-04-12,796,35,9152,308,IN
2020-04-13,1211,31,10363,339,IN
2020-04-14,1075,38,11438,377,IN
2020-04-15,942,37,12380,414,IN
2020-04-16,1007,23,13387,437,IN
2020-04-17,991,43,14378,480,IN
2020-04-18,1334,27,15712,507,IN
2020-04-19,1553,36,17265,543,IN
2020-04-20,1335,47,18600,590,IN
2020-04-21,1384,50,19984,640,IN
2020-04-22,1409,41,21393,681,IN
2020-04-23,1684,37,23077,718,IN
2020-04-24,1429,57,24506,775,IN
2020-04-25,1990,49,26496,824,IN
2020-04-26,1396,48,27892,872,IN
2020-04-27,1543,62,29435,934,IN
2020-04-28,1897,73,31332,1007,IN
2020-04-29,1718,67,33050,1074,IN
2020-04-30,1993,73,35043,1147,IN
2020-05-01,2293,71,37336,1218,IN
2020-05-02,2644,83,39980,1301,IN
2020-05-03,2553,72,42533,1373,IN
2020-05-04,3900,195,46433,1568,IN
2020-05-05,2958,126,49391,1694,IN
2020-05-06,3561,89,52952,1783,IN
2020-05-07,3390,103,56342,1886,IN
2020-05-08,3320,95,59662,1981,IN
2020-05-09,3277,128,62939,2109,IN
2020-05-10,4213,97,67152,2206,IN
2020-05-11,3604,87,70756,2293,IN
2020-05-12,3525,122,74281,2415,IN
2020-05-13,3722,134,78003,2549,IN
2020-05-14,3967,100,81970,2649,IN
2020-05-15,3970,103,85940,2752,IN
2020-05-16,4987,120,90927,2872,IN
2020-05-17,5242,157,96169,3029,IN
2020-05-18,4970,134,101139,3163,IN
2020-05-19,5611,140,106750,3303,IN
2020-05-20,5609,132,112359,3435,IN
2020-05-21,6088,148,118447,3583,IN
2020-05-22,6654,137,125101,3720,IN
2020-05-23,6767,147,131868,3867,IN
2020-05-24,6977,154,138845,4021,IN
2020-05-25,6535,146,145380,4167,IN
2020-05-26,6387,170,151767,4337,IN
2020-05-27,6566,194,158333,4531,IN
2020-05-28,7466,175,165799,4706,IN
2020-05-29,7964,265,173763,4971,IN
2020-05-30,8380,193,182143,5164,IN
2020-05-31,8392,230,190535,5394,IN
2020-06-01,8171,204,198706,5598,IN
2020-06-02,8909,217,207615,5815,IN
2020-06-03,9304,260,216919,6075,IN
2020-06-04,9851,273,226770,6348,IN
2020-06-05,9887,294,236657,6642,IN
2020-06-06,9971,287,246628,6929,IN
2020-06-07,9983,206,256611,7135,IN
2020-06-08,9987,331,266598,7466,IN
2020-06-09,9985,279,276583,7745,IN
2020-06-10,9996,357,286579,8102,IN
2020-06-11,10956,396,297535,8498,IN
2020-06-12,11458,386,308993,8884,IN
2020-06-13,11929,311,320922,9195,IN
2020-06-14,11502,325,332424,9520,IN
2020-06-15,10667,380,343091,9900,IN
2020-06-16,10974,2003,354065,11903,IN
2020-06-17,12881,334,366946,12237,IN
2020-06-18,13586,336,380532,12573,IN
2020-06-19,14516,375,395048,12948,IN
2020-06-20,15413,306,410461,13254,IN
2020-06-21,14821,445,425282,13699,IN
2020-06-22,14933,312,440215,14011,IN
2020-06-23,15968,465,456183,14476,IN
2020-06-24,16922,418,473105,14894,IN
2020-06-25,17296,407,490401,15301,IN
2020-06-26,18552,384,508953,15685,IN
2019-12-30,0,0,0,0,IQ
2019-12-31,0,0,0,0,IQ
2020-01-01,0,0,0,0,IQ
2020-01-02,0,0,0,0,IQ
2020-01-03,0,0,0,0,IQ
2020-01-04,0,0,0,0,IQ
2020-01-05,0,0,0,0,IQ
2020-01-06,0,0,0,0,IQ
2020-01-07,0,0,0,0,IQ
2020-01-08,0,0,0,0,IQ
2020-01-09,0,0,0,0,IQ
2020-01-10,0,0,0,0,IQ
2020-01-11,0,0,0,0,IQ
2020-01-12,0,0,0,0,IQ
2020-01-13,0,0,0,0,IQ
2020-01-14,0,0,0,0,IQ
2020-01-15,0,0,0,0,IQ
2020-01-16,0,0,0,0,IQ
2020-01-17,0,0,0,0,IQ
2020-01-18,0,0,0,0,IQ
2020-01-19,0,0,0,0,IQ
2020-01-20,0,0,0,0,IQ
2020-01-21,0,0,0,0,IQ
2020-01-22,0,0,0,0,IQ
2020-01-23,0,0,0,0,IQ
2020-01-24,0,0,0,0,IQ
2020-01-25,0,0,0,0,IQ
2020-01-26,0,0,0,0,IQ
2020-01-27,0,0,0,0,IQ
2020-01-28,0,0,0,0,IQ
2020-01-29,0,0,0,0,IQ
2020-01-30,0,0,0,0,IQ
2020-01-31,0,0,0,0,IQ
2020-02-01,0,0,0,0,IQ
2020-02-02,0,0,0,0,IQ
2020-02-03,0,0,0,0,IQ
2020-02-04,0,0,0,0,IQ
2020-02-05,0,0,0,0,IQ
2020-02-06,0,0,0,0,IQ
2020-02-07,0,0,0,0,IQ
2020-02-08,0,0,0,0,IQ
2020-02-09,0,0,0,0,IQ
2020-02-10,0,0,0,0,IQ
2020-02-11,0,0,0,0,IQ
2020-02-12,0,0,0,0,IQ
2020-02-13,0,0,0,0,IQ
2020-02-14,0,0,0,0,IQ
2020-02-15,0,0,0,0,IQ
2020-02-16,0,0,0,0,IQ
2020-02-17,0,0,0,0,IQ
2020-02-18,0,0,0,0,IQ
2020-02-19,0,0,0,0,IQ
2020-02-20,0,0,0,0,IQ
2020-02-21,0,0,0,0,IQ
2020-02-22,0,0,0,0,IQ
2020-02-23,0,0,0,0,IQ
2020-02-24,1,0,1,0,IQ
2020-02-25,4,0,5,0,IQ
2020-02-26,0,0,5,0,IQ
2020-02-27,1,0,6,0,IQ
2020-02-28,1,0,7,0,IQ
2020-02-29,6,0,13,0,IQ
2020-03-01,6,0,19,0,IQ
2020-03-02,2,0,21,0,IQ
2020-03-03,5,0,26,0,IQ
2020-03-04,5,0,31,0,IQ
2020-03-05,7,2,38,2,IQ
2020-03-07,16,0,54,2,IQ
2020-03-08,7,4,61,6,IQ
2020-03-10,0,0,61,6,IQ
2020-03-11,9,2,70,8,IQ
2020-03-12,4,0,74,8,IQ
2020-03-13,11,1,85,9,IQ
2020-03-14,0,0,85,9,IQ
2020-03-15,39,0,124,9,IQ
2020-03-16,0,0,124,9,IQ
2020-03-17,30,2,154,11,IQ
2020-03-18,10,1,164,12,IQ
2020-03-19,13,0,177,12,IQ
2020-03-20,16,2,193,14,IQ
2020-03-21,21,3,214,17,IQ
2020-03-22,19,3,233,20,IQ
2020-03-23,33,3,266,23,IQ
2020-03-24,50,4,316,27,IQ
2020-03-25,30,2,346,29,IQ
2020-03-26,36,7,382,36,IQ
2020-03-27,76,4,458,40,IQ
2020-03-28,48,2,506,42,IQ
2020-03-29,41,0,547,42,IQ
2020-03-30,83,4,630,46,IQ
2020-03-31,64,4,694,50,IQ
2020-04-01,0,0,694,50,IQ
2020-04-02,78,4,772,54,IQ
2020-04-03,0,0,772,54,IQ
2020-04-04,106,2,878,56,IQ
2020-04-05,83,5,961,61,IQ
2020-04-06,70,3,1031,64,IQ
2020-04-07,0,0,1031,64,IQ
2020-04-08,171,5,1202,69,IQ
2020-04-09,30,0,1232,69,IQ
2020-04-10,47,1,1279,70,IQ
2020-04-11,39,2,1318,72,IQ
2020-04-12,34,4,1352,76,IQ
2020-04-13,26,2,1378,78,IQ
2020-04-14,22,0,1400,78,IQ
2020-04-15,15,1,1415,79,IQ
2020-04-16,19,1,1434,80,IQ
2020-04-17,48,1,1482,81,IQ
2020-04-18,0,0,1482,81,IQ
2020-04-19,57,1,1539,82,IQ
2020-04-20,35,0,1574,82,IQ
2020-04-21,28,1,1602,83,IQ
2020-04-22,0,0,1602,83,IQ
2020-04-23,75,0,1677,83,IQ
2020-04-24,31,3,1708,86,IQ
2020-04-25,55,0,1763,86,IQ
2020-04-26,57,1,1820,87,IQ
2020-04-27,27,1,1847,88,IQ
2020-04-28,0,0,1847,88,IQ
2020-04-29,156,4,2003,92,IQ
2020-04-30,82,1,2085,93,IQ
2020-05-01,68,1,2153,94,IQ
2020-05-02,66,1,2219,95,IQ
2020-05-03,77,2,2296,97,IQ
2020-05-04,50,1,2346,98,IQ
2020-05-05,85,4,2431,102,IQ
2020-05-06,49,0,2480,102,IQ
2020-05-07,63,0,2543,102,IQ
2020-05-08,60,2,2603,104,IQ
2020-05-09,76,3,2679,107,IQ
2020-05-10,88,2,2767,109,IQ
2020-05-11,51,1,2818,110,IQ
2020-05-12,95,2,2913,112,IQ
2020-05-13,119,3,3032,115,IQ
2020-05-14,111,0,3143,115,IQ
2020-05-15,50,2,3193,117,IQ
2020-05-16,67,4,3260,121,IQ
2020-05-17,144,2,3404,123,IQ
2020-05-18,150,4,3554,127,IQ
2020-05-19,57,4,3611,131,IQ
2020-05-20,113,3,3724,134,IQ
2020-05-21,153,6,3877,140,IQ
2020-05-22,87,7,3964,147,IQ
2020-05-23,308,5,4272,152,IQ
2020-05-24,197,8,4469,160,IQ
2020-05-25,163,3,4632,163,IQ
2020-05-26,216,6,4848,169,IQ
2020-05-27,287,6,5135,175,IQ
2020-05-28,322,4,5457,179,IQ
2020-05-29,416,6,5873,185,IQ
2020-05-30,306,10,6179,195,IQ
2020-05-31,260,10,6439,205,IQ
2020-06-01,429,10,6868,215,IQ
2020-06-02,519,20,7387,235,IQ
2020-06-03,781,21,8168,256,IQ
2020-06-04,672,15,8840,271,IQ
2020-06-05,1006,14,9846,285,IQ
2020-06-06,1252,33,11098,318,IQ
2020-06-07,1268,28,12366,346,IQ
2020-06-08,1115,24,13481,370,IQ
2020-06-09,787,22,14268,392,IQ
2020-06-10,1146,34,15414,426,IQ
2020-06-11,1261,31,16675,457,IQ
2020-06-12,1095,39,17770,496,IQ
2020-06-13,1180,53,18950,549,IQ
2020-06-14,1259,58,20209,607,IQ
2020-06-15,1106,45,21315,652,IQ
2020-06-16,1385,60,22700,712,IQ
2020-06-17,1554,61,24254,773,IQ
2020-06-18,1463,83,25717,856,IQ
2020-06-19,0,0,25717,856,IQ
2020-06-20,3505,157,29222,1013,IQ
2020-06-21,1646,87,30868,1100,IQ
2020-06-22,1808,67,32676,1167,IQ
2020-06-23,1826,84,34502,1251,IQ
2020-06-24,2200,79,36702,1330,IQ
2020-06-25,2437,107,39139,1437,IQ
2020-06-26,2054,122,41193,1559,IQ
2019-12-30,0,0,0,0,IR
2019-12-31,0,0,0,0,IR
2020-01-01,0,0,0,0,IR
2020-01-02,0,0,0,0,IR
2020-01-03,0,0,0,0,IR
2020-01-04,0,0,0,0,IR
2020-01-05,0,0,0,0,IR
2020-01-06,0,0,0,0,IR
2020-01-07,0,0,0,0,IR
2020-01-08,0,0,0,0,IR
2020-01-09,0,0,0,0,IR
2020-01-10,0,0,0,0,IR
2020-01-11,0,0,0,0,IR
2020-01-12,0,0,0,0,IR
2020-01-13,0,0,0,0,IR
2020-01-14,0,0,0,0,IR
2020-01-15,0,0,0,0,IR
2020-01-16,0,0,0,0,IR
2020-01-17,0,0,0,0,IR
2020-01-18,0,0,0,0,IR
2020-01-19,0,0,0,0,IR
2020-01-20,0,0,0,0,IR
2020-01-21,0,0,0,0,IR
2020-01-22,0,0,0,0,IR
2020-01-23,0,0,0,0,IR
2020-01-24,0,0,0,0,IR
2020-01-25,0,0,0,0,IR
2020-01-26,0,0,0,0,IR
2020-01-27,0,0,0,0,IR
2020-01-28,0,0,0,0,IR
2020-01-29,0,0,0,0,IR
2020-01-30,0,0,0,0,IR
2020-01-31,0,0,0,0,IR
2020-02-01,0,0,0,0,IR
2020-02-02,0,0,0,0,IR
2020-02-03,0,0,0,0,IR
2020-02-04,0,0,0,0,IR
2020-02-05,0,0,0,0,IR
2020-02-06,0,0,0,0,IR
2020-02-07,0,0,0,0,IR
2020-02-08,0,0,0,0,IR
2020-02-09,0,0,0,0,IR
2020-02-10,0,0,0,0,IR
2020-02-11,0,0,0,0,IR
2020-02-12,0,0,0,0,IR
2020-02-13,0,0,0,0,IR
2020-02-14,0,0,0,0,IR
2020-02-15,0,0,0,0,IR
2020-02-16,0,0,0,0,IR
2020-02-17,0,0,0,0,IR
2020-02-18,0,0,0,0,IR
2020-02-19,2,2,2,2,IR
2020-02-20,3,0,5,2,IR
2020-02-21,13,2,18,4,IR
2020-02-22,10,1,28,5,IR
2020-02-23,15,3,43,8,IR
2020-02-24,18,4,61,12,IR
2020-02-25,34,3,95,15,IR
2020-02-26,44,4,139,19,IR
2020-02-27,106,7,245,26,IR
2020-02-28,143,8,388,34,IR
2020-02-29,205,9,593,43,IR
2020-03-01,385,11,978,54,IR
2020-03-02,523,12,1501,66,IR
2020-03-03,835,11,2336,77,IR
2020-03-04,586,15,2922,92,IR
2020-03-05,591,15,3513,107,IR
2020-03-06,1234,17,4747,124,IR
2020-03-07,1076,21,5823,145,IR
2020-03-08,743,49,6566,194,IR
2020-03-09,595,43,7161,237,IR
2020-03-10,881,54,8042,291,IR
2020-03-11,958,63,9000,354,IR
2020-03-12,1075,75,10075,429,IR
2020-03-13,1289,85,11364,514,IR
2020-03-14,1365,97,12729,611,IR
2020-03-15,1209,113,13938,724,IR
2020-03-16,1053,129,14991,853,IR
2020-03-17,1178,135,16169,988,IR
2020-03-18,1192,147,17361,1135,IR
2020-03-19,1046,149,18407,1284,IR
2020-03-20,1237,149,19644,1433,IR
2020-03-21,966,123,20610,1556,IR
2020-03-22,1028,129,21638,1685,IR
2020-03-23,1411,127,23049,1812,IR
2020-03-24,1762,122,24811,1934,IR
2020-03-25,2206,143,27017,2077,IR
2020-03-26,2389,157,29406,2234,IR
2020-03-27,2926,144,32332,2378,IR
2020-03-28,3076,139,35408,2517,IR
2020-03-29,2901,123,38309,2640,IR
2020-03-30,3186,117,41495,2757,IR
2020-03-31,3111,141,44606,2898,IR
2020-04-01,2987,138,47593,3036,IR
2020-04-02,2875,124,50468,3160,IR
2020-04-03,0,0,50468,3160,IR
2020-04-04,5275,292,55743,3452,IR
2020-04-05,2483,151,58226,3603,IR
2020-04-06,2274,136,60500,3739,IR
2020-04-07,2089,133,62589,3872,IR
2020-04-08,1997,121,64586,3993,IR
2020-04-09,1634,117,66220,4110,IR
2020-04-10,1972,122,68192,4232,IR
2020-04-11,1837,125,70029,4357,IR
2020-04-12,1657,117,71686,4474,IR
2020-04-13,1617,111,73303,4585,IR
2020-04-14,1574,98,74877,4683,IR
2020-04-15,1512,94,76389,4777,IR
2020-04-16,1606,92,77995,4869,IR
2020-04-17,1499,89,79494,4958,IR
2020-04-18,1374,73,80868,5031,IR
2020-04-19,1343,87,82211,5118,IR
2020-04-20,1294,91,83505,5209,IR
2020-04-21,1297,88,84802,5297,IR
2020-04-22,1194,94,85996,5391,IR
2020-04-23,1030,90,87026,5481,IR
2020-04-24,1168,93,88194,5574,IR
2020-04-25,1134,76,89328,5650,IR
2020-04-26,1153,60,90481,5710,IR
2020-04-27,991,96,91472,5806,IR
2020-04-28,1112,71,92584,5877,IR
2020-04-29,1073,80,93657,5957,IR
2020-04-30,983,71,94640,6028,IR
2020-05-01,1006,63,95646,6091,IR
2020-05-02,802,65,96448,6156,IR
2020-05-03,976,47,97424,6203,IR
2020-05-04,1223,74,98647,6277,IR
2020-05-05,1323,63,99970,6340,IR
2020-05-06,1680,78,101650,6418,IR
2020-05-07,1485,68,103135,6486,IR
2020-05-08,1556,55,104691,6541,IR
2020-05-09,1529,48,106220,6589,IR
2020-05-10,1383,51,107603,6640,IR
2020-05-11,1683,45,109286,6685,IR
2020-05-12,1481,48,110767,6733,IR
2020-05-13,1958,50,112725,6783,IR
2020-05-14,1808,71,114533,6854,IR
2020-05-15,2102,48,116635,6902,IR
2020-05-16,1757,35,118392,6937,IR
2020-05-17,1806,51,120198,6988,IR
2020-05-18,2294,69,122492,7057,IR
2020-05-19,2111,62,124603,7119,IR
2020-05-20,2346,64,126949,7183,IR
2020-05-21,2392,66,129341,7249,IR
2020-05-22,2311,51,131652,7300,IR
2020-05-23,1869,59,133521,7359,IR
2020-05-24,2180,58,135701,7417,IR
2020-05-25,2023,34,137724,7451,IR
2020-05-26,1787,57,139511,7508,IR
2020-05-27,2080,56,141591,7564,IR
2020-05-28,2258,63,143849,7627,IR
2020-05-29,2819,50,146668,7677,IR
2020-05-30,2282,57,148950,7734,IR
2020-05-31,2516,63,151466,7797,IR
2020-06-01,2979,81,154445,7878,IR
2020-06-02,3117,64,157562,7942,IR
2020-06-03,3134,70,160696,8012,IR
2020-06-04,3574,59,164270,8071,IR
2020-06-05,2886,63,167156,8134,IR
2020-06-06,2269,75,169425,8209,IR
2020-06-07,2364,72,171789,8281,IR
2020-06-08,2043,70,173832,8351,IR
2020-06-09,2095,74,175927,8425,IR
2020-06-10,2011,81,177938,8506,IR
2020-06-11,2238,78,180176,8584,IR
2020-06-12,2369,75,182545,8659,IR
2020-06-13,2410,71,184955,8730,IR
2020-06-14,2472,107,187427,8837,IR
2020-06-15,2449,113,189876,8950,IR
2020-06-16,2563,115,192439,9065,IR
2020-06-17,2612,120,195051,9185,IR
2020-06-18,2596,87,197647,9272,IR
2020-06-19,2615,120,200262,9392,IR
2020-06-20,2322,115,202584,9507,IR
2020-06-21,2368,116,204952,9623,IR
2020-06-22,2573,119,207525,9742,IR
2020-06-23,2445,121,209970,9863,IR
2020-06-24,2531,133,212501,9996,IR
2020-06-25,2595,134,215096,10130,IR
2020-06-26,2628,0,217724,10130,IR
2019-12-30,0,0,0,0,IS
2019-12-31,0,0,0,0,IS
2020-01-01,0,0,0,0,IS
2020-01-02,0,0,0,0,IS
2020-01-03,0,0,0,0,IS
2020-01-04,0,0,0,0,IS
2020-01-05,0,0,0,0,IS
2020-01-06,0,0,0,0,IS
2020-01-07,0,0,0,0,IS
2020-01-08,0,0,0,0,IS
2020-01-09,0,0,0,0,IS
2020-01-10,0,0,0,0,IS
2020-01-11,0,0,0,0,IS
2020-01-12,0,0,0,0,IS
2020-01-13,0,0,0,0,IS
2020-01-14,0,0,0,0,IS
2020-01-15,0,0,0,0,IS
2020-01-16,0,0,0,0,IS
2020-01-17,0,0,0,0,IS
2020-01-18,0,0,0,0,IS
2020-01-19,0,0,0,0,IS
2020-01-20,0,0,0,0,IS
2020-01-21,0,0,0,0,IS
2020-01-22,0,0,0,0,IS
2020-01-23,0,0,0,0,IS
2020-01-24,0,0,0,0,IS
2020-01-25,0,0,0,0,IS
2020-01-26,0,0,0,0,IS
2020-01-27,0,0,0,0,IS
2020-01-28,0,0,0,0,IS
2020-01-29,0,0,0,0,IS
2020-01-30,0,0,0,0,IS
2020-01-31,0,0,0,0,IS
2020-02-01,0,0,0,0,IS
2020-02-02,0,0,0,0,IS
2020-02-03,0,0,0,0,IS
2020-02-04,0,0,0,0,IS
2020-02-05,0,0,0,0,IS
2020-02-06,0,0,0,0,IS
2020-02-07,0,0,0,0,IS
2020-02-08,0,0,0,0,IS
2020-02-09,0,0,0,0,IS
2020-02-10,0,0,0,0,IS
2020-02-11,0,0,0,0,IS
2020-02-12,0,0,0,0,IS
2020-02-13,0,0,0,0,IS
2020-02-14,0,0,0,0,IS
2020-02-15,0,0,0,0,IS
2020-02-16,0,0,0,0,IS
2020-02-17,0,0,0,0,IS
2020-02-18,0,0,0,0,IS
2020-02-19,0,0,0,0,IS
2020-02-20,0,0,0,0,IS
2020-02-21,0,0,0,0,IS
2020-02-22,0,0,0,0,IS
2020-02-23,0,0,0,0,IS
2020-02-24,0,0,0,0,IS
2020-02-25,0,0,0,0,IS
2020-02-26,0,0,0,0,IS
2020-02-27,0,0,0,0,IS
2020-02-28,1,0,1,0,IS
2020-02-29,0,0,1,0,IS
2020-03-01,2,0,3,0,IS
2020-03-02,3,0,6,0,IS
2020-03-03,10,0,16,0,IS
2020-03-04,10,0,26,0,IS
2020-03-05,9,0,35,0,IS
2020-03-06,8,0,43,0,IS
2020-03-07,10,0,53,0,IS
2020-03-08,2,0,55,0,IS
2020-03-09,10,0,65,0,IS
2020-03-10,5,0,70,0,IS
2020-03-11,15,0,85,0,IS
2020-03-12,32,0,117,0,IS
2020-03-13,0,0,117,0,IS
2020-03-14,21,0,138,0,IS
2020-03-15,40,0,178,0,IS
2020-03-16,21,0,199,0,IS
2020-03-17,48,0,247,0,IS
2020-03-18,3,0,250,0,IS
2020-03-19,80,1,330,1,IS
2020-03-20,79,0,409,1,IS
2020-03-21,64,0,473,1,IS
2020-03-22,95,0,568,1,IS
2020-03-23,20,1,588,2,IS
2020-03-24,60,0,648,2,IS
2020-03-25,89,0,737,2,IS
2020-03-26,65,0,802,2,IS
2020-03-27,88,0,890,2,IS
2020-03-28,73,0,963,2,IS
2020-03-29,57,0,1020,2,IS
2020-03-30,66,0,1086,2,IS
2020-03-31,49,0,1135,2,IS
2020-04-01,85,0,1220,2,IS
2020-04-02,99,2,1319,4,IS
2020-04-03,45,0,1364,4,IS
2020-04-04,53,0,1417,4,IS
2020-04-05,69,0,1486,4,IS
2020-04-06,76,2,1562,6,IS
2020-04-07,24,0,1586,6,IS
2020-04-08,30,0,1616,6,IS
2020-04-09,32,0,1648,6,IS
2020-04-10,27,1,1675,7,IS
2020-04-11,14,1,1689,8,IS
2020-04-12,12,0,1701,8,IS
2020-04-13,10,0,1711,8,IS
2020-04-14,9,0,1720,8,IS
2020-04-15,7,0,1727,8,IS
2020-04-16,12,0,1739,8,IS
2020-04-17,15,0,1754,8,IS
2020-04-18,6,1,1760,9,IS
2020-04-19,11,0,1771,9,IS
2020-04-20,2,1,1773,10,IS
2020-04-21,5,0,1778,10,IS
2020-04-22,7,0,1785,10,IS
2020-04-23,4,0,1789,10,IS
2020-04-24,0,0,1789,10,IS
2020-04-25,1,0,1790,10,IS
2020-04-26,2,0,1792,10,IS
2020-04-27,0,0,1792,10,IS
2020-04-28,3,0,1795,10,IS
2020-04-29,2,0,1797,10,IS
2020-04-30,0,0,1797,10,IS
2020-05-01,1,0,1798,10,IS
2020-05-02,0,0,1798,10,IS
2020-05-03,1,0,1799,10,IS
2020-05-04,0,0,1799,10,IS
2020-05-05,0,0,1799,10,IS
2020-05-06,0,0,1799,10,IS
2020-05-07,2,0,1801,10,IS
2020-05-08,0,0,1801,10,IS
2020-05-09,0,0,1801,10,IS
2020-05-10,0,0,1801,10,IS
2020-05-11,0,0,1801,10,IS
2020-05-12,0,0,1801,10,IS
2020-05-13,1,0,1802,10,IS
2020-05-14,0,0,1802,10,IS
2020-05-15,0,0,1802,10,IS
2020-05-16,0,0,1802,10,IS
2020-05-17,0,0,1802,10,IS
2020-05-18,0,0,1802,10,IS
2020-05-19,0,0,1802,10,IS
2020-05-20,1,0,1803,10,IS
2020-05-21,0,0,1803,10,IS
2020-05-22,0,0,1803,10,IS
2020-05-23,1,0,1804,10,IS
2020-05-24,0,0,1804,10,IS
2020-05-25,0,0,1804,10,IS
2020-05-26,0,0,1804,10,IS
2020-05-27,1,0,1805,10,IS
2020-05-28,0,0,1805,10,IS
2020-05-29,0,0,1805,10,IS
2020-05-30,1,0,1806,10,IS
2020-05-31,0,0,1806,10,IS
2020-06-01,0,0,1806,10,IS
2020-06-02,0,0,1806,10,IS
2020-06-03,0,0,1806,10,IS
2020-06-04,0,0,1806,10,IS
2020-06-05,0,0,1806,10,IS
2020-06-06,0,0,1806,10,IS
2020-06-07,1,0,1807,10,IS
2020-06-08,0,0,1807,10,IS
2020-06-09,0,0,1807,10,IS
2020-06-10,0,0,1807,10,IS
2020-06-11,0,0,1807,10,IS
2020-06-12,0,0,1807,10,IS
2020-06-13,1,0,1808,10,IS
2020-06-14,2,0,1810,10,IS
2020-06-15,0,0,1810,10,IS
2020-06-16,2,0,1812,10,IS
2020-06-17,3,0,1815,10,IS
2020-06-18,1,0,1816,10,IS
2020-06-19,3,0,1819,10,IS
2020-06-20,3,0,1822,10,IS
2020-06-21,1,0,1823,10,IS
2020-06-22,0,0,1823,10,IS
2020-06-23,1,0,1824,10,IS
2020-06-24,3,0,1827,10,IS
2020-06-25,3,0,1830,10,IS
2020-06-26,2,0,1832,10,IS
2019-12-31,0,0,0,0,IT
2020-01-01,0,0,0,0,IT
2020-01-02,0,0,0,0,IT
2020-01-03,0,0,0,0,IT
2020-01-04,0,0,0,0,IT
2020-01-05,0,0,0,0,IT
2020-01-06,0,0,0,0,IT
2020-01-07,0,0,0,0,IT
2020-01-08,0,0,0,0,IT
2020-01-09,0,0,0,0,IT
2020-01-10,0,0,0,0,IT
2020-01-11,0,0,0,0,IT
2020-01-12,0,0,0,0,IT
2020-01-13,0,0,0,0,IT
2020-01-14,0,0,0,0,IT
2020-01-15,0,0,0,0,IT
2020-01-16,0,0,0,0,IT
2020-01-17,0,0,0,0,IT
2020-01-18,0,0,0,0,IT
2020-01-19,0,0,0,0,IT
2020-01-20,0,0,0,0,IT
2020-01-21,0,0,0,0,IT
2020-01-22,0,0,0,0,IT
2020-01-23,0,0,0,0,IT
2020-01-24,0,0,0,0,IT
2020-01-25,0,0,0,0,IT
2020-01-26,0,0,0,0,IT
2020-01-27,0,0,0,0,IT
2020-01-28,0,0,0,0,IT
2020-01-29,0,0,0,0,IT
2020-01-30,0,0,0,0,IT
2020-01-31,3,0,3,0,IT
2020-02-01,0,0,3,0,IT
2020-02-02,0,0,3,0,IT
2020-02-03,0,0,3,0,IT
2020-02-04,0,0,3,0,IT
2020-02-05,0,0,3,0,IT
2020-02-06,0,0,3,0,IT
2020-02-07,0,0,3,0,IT
2020-02-08,0,0,3,0,IT
2020-02-09,0,0,3,0,IT
2020-02-10,0,0,3,0,IT
2020-02-11,0,0,3,0,IT
2020-02-12,0,0,3,0,IT
2020-02-13,0,0,3,0,IT
2020-02-14,0,0,3,0,IT
2020-02-15,0,0,3,0,IT
2020-02-16,0,0,3,0,IT
2020-02-17,0,0,3,0,IT
2020-02-18,0,0,3,0,IT
2020-02-19,0,0,3,0,IT
2020-02-20,0,0,3,0,IT
2020-02-21,0,0,3,0,IT
2020-02-22,14,0,17,0,IT
2020-02-23,62,2,79,2,IT
2020-02-24,53,0,132,2,IT
2020-02-25,97,4,229,6,IT
2020-02-26,93,5,322,11,IT
2020-02-27,78,1,400,12,IT
2020-02-28,250,5,650,17,IT
2020-02-29,238,4,888,21,IT
2020-03-01,240,8,1128,29,IT
2020-03-02,561,6,1689,35,IT
2020-03-03,347,17,2036,52,IT
2020-03-04,466,28,2502,80,IT
2020-03-05,587,27,3089,107,IT
2020-03-06,769,41,3858,148,IT
2020-03-07,778,49,4636,197,IT
2020-03-08,1247,36,5883,233,IT
2020-03-09,1492,133,7375,366,IT
2020-03-10,1797,98,9172,464,IT
2020-03-11,977,167,10149,631,IT
2020-03-12,2313,196,12462,827,IT
2020-03-13,2651,189,15113,1016,IT
2020-03-14,2547,252,17660,1268,IT
2020-03-15,3497,173,21157,1441,IT
2020-03-16,2823,370,23980,1811,IT
2020-03-17,4000,347,27980,2158,IT
2020-03-18,3526,347,31506,2505,IT
2020-03-19,4207,473,35713,2978,IT
2020-03-20,5322,429,41035,3407,IT
2020-03-21,5986,625,47021,4032,IT
2020-03-22,6557,795,53578,4827,IT
2020-03-23,5560,649,59138,5476,IT
2020-03-24,4789,601,63927,6077,IT
2020-03-25,5249,743,69176,6820,IT
2020-03-26,5210,685,74386,7505,IT
2020-03-27,6153,660,80539,8165,IT
2020-03-28,5959,971,86498,9136,IT
2020-03-29,5974,887,92472,10023,IT
2020-03-30,5217,758,97689,10781,IT
2020-03-31,4050,810,101739,11591,IT
2020-04-01,4053,839,105792,12430,IT
2020-04-02,4782,727,110574,13157,IT
2020-04-03,4668,760,115242,13917,IT
2020-04-04,4585,764,119827,14681,IT
2020-04-05,4805,681,124632,15362,IT
2020-04-06,4316,527,128948,15889,IT
2020-04-07,3599,636,132547,16525,IT
2020-04-08,3039,604,135586,17129,IT
2020-04-09,3836,540,139422,17669,IT
2020-04-10,4204,612,143626,18281,IT
2020-04-11,3951,570,147577,18851,IT
2020-04-12,4694,619,152271,19470,IT
2020-04-13,4092,431,156363,19901,IT
2020-04-14,3153,564,159516,20465,IT
2020-04-15,2972,604,162488,21069,IT
2020-04-16,2667,578,165155,21647,IT
2020-04-17,3786,525,168941,22172,IT
2020-04-18,3493,575,172434,22747,IT
2020-04-19,3491,480,175925,23227,IT
2020-04-20,3047,433,178972,23660,IT
2020-04-21,2256,454,181228,24114,IT
2020-04-22,2729,534,183957,24648,IT
2020-04-23,3370,437,187327,25085,IT
2020-04-24,2646,464,189973,25549,IT
2020-04-25,3021,420,192994,25969,IT
2020-04-26,2357,415,195351,26384,IT
2020-04-27,2324,260,197675,26644,IT
2020-04-28,1739,333,199414,26977,IT
2020-04-29,2091,382,201505,27359,IT
2020-04-30,2086,323,203591,27682,IT
2020-05-01,1872,285,205463,27967,IT
2020-05-02,1965,269,207428,28236,IT
2020-05-03,1900,474,209328,28710,IT
2020-05-04,1389,174,210717,28884,IT
2020-05-05,1221,195,211938,29079,IT
2020-05-06,1075,236,213013,29315,IT
2020-05-07,1444,369,214457,29684,IT
2020-05-08,1401,274,215858,29958,IT
2020-05-09,1327,243,217185,30201,IT
2020-05-10,1083,194,218268,30395,IT
2020-05-11,802,165,219070,30560,IT
2020-05-12,744,179,219814,30739,IT
2020-05-13,1402,172,221216,30911,IT
2020-05-14,888,195,222104,31106,IT
2020-05-15,992,262,223096,31368,IT
2020-05-16,789,242,223885,31610,IT
2020-05-17,875,153,224760,31763,IT
2020-05-18,675,145,225435,31908,IT
2020-05-19,451,99,225886,32007,IT
2020-05-20,813,162,226699,32169,IT
2020-05-21,665,161,227364,32330,IT
2020-05-22,642,156,228006,32486,IT
2020-05-23,652,130,228658,32616,IT
2020-05-24,669,119,229327,32735,IT
2020-05-25,531,50,229858,32785,IT
2020-05-26,300,92,230158,32877,IT
2020-05-27,397,78,230555,32955,IT
2020-05-28,584,117,231139,33072,IT
2020-05-29,593,70,231732,33142,IT
2020-05-30,516,87,232248,33229,IT
2020-05-31,416,111,232664,33340,IT
2020-06-01,355,75,233019,33415,IT
2020-06-02,178,60,233197,33475,IT
2020-06-03,318,55,233515,33530,IT
2020-06-04,321,71,233836,33601,IT
2020-06-05,177,88,234013,33689,IT
2020-06-06,518,85,234531,33774,IT
2020-06-07,270,72,234801,33846,IT
2020-06-08,197,53,234998,33899,IT
2020-06-09,280,65,235278,33964,IT
2020-06-10,283,79,235561,34043,IT
2020-06-11,202,71,235763,34114,IT
2020-06-12,379,53,236142,34167,IT
2020-06-13,163,56,236305,34223,IT
2020-06-14,346,78,236651,34301,IT
2020-06-15,338,44,236989,34345,IT
2020-06-16,301,26,237290,34371,IT
2020-06-17,210,34,237500,34405,IT
2020-06-18,328,43,237828,34448,IT
2020-06-19,331,66,238159,34514,IT
2020-06-20,-148,47,238011,34561,IT
2020-06-21,264,49,238275,34610,IT
2020-06-22,224,24,238499,34634,IT
2020-06-23,221,23,238720,34657,IT
2020-06-24,113,18,238833,34675,IT
2020-06-25,577,-31,239410,34644,IT
2020-06-26,296,34,239706,34678,IT
2020-06-27,255,30,239961,34708,IT
2020-03-19,5,0,5,0,JE
2020-03-20,7,0,12,0,JE
2020-03-21,0,0,12,0,JE
2020-03-22,3,0,15,0,JE
2020-03-23,3,0,18,0,JE
2020-03-24,0,0,18,0,JE
2020-03-25,0,0,18,0,JE
2020-03-26,14,1,32,1,JE
2020-03-27,20,0,52,1,JE
2020-03-28,9,0,61,1,JE
2020-03-29,2,1,63,2,JE
2020-03-30,0,0,63,2,JE
2020-03-31,18,0,81,2,JE
2020-04-01,0,0,81,2,JE
2020-04-02,0,0,81,2,JE
2020-04-03,37,0,118,2,JE
2020-04-04,5,1,123,3,JE
2020-04-05,32,0,155,3,JE
2020-04-06,14,0,169,3,JE
2020-04-07,1,0,170,3,JE
2020-04-08,0,0,170,3,JE
2020-04-09,13,0,183,3,JE
2020-04-10,15,1,198,4,JE
2020-04-11,0,0,198,4,JE
2020-04-12,15,0,213,4,JE
2020-04-13,4,0,217,4,JE
2020-04-14,0,0,217,4,JE
2020-04-15,0,2,217,6,JE
2020-04-16,6,4,223,10,JE
2020-04-17,1,1,224,11,JE
2020-04-18,21,1,245,12,JE
2020-04-19,4,0,249,12,JE
2020-04-20,0,2,249,14,JE
2020-04-21,6,0,255,14,JE
2020-04-22,0,4,255,18,JE
2020-04-23,21,1,276,19,JE
2020-04-24,2,0,278,19,JE
2020-04-25,2,0,280,19,JE
2020-04-26,1,0,281,19,JE
2020-04-27,2,0,283,19,JE
2020-04-28,1,1,284,20,JE
2020-04-29,2,1,286,21,JE
2020-04-30,0,2,286,23,JE
2020-05-01,0,1,286,24,JE
2020-05-02,5,0,291,24,JE
2020-05-03,1,0,292,24,JE
2020-05-04,1,0,293,24,JE
2020-05-05,0,0,293,24,JE
2020-05-06,0,1,293,25,JE
2020-05-07,0,0,293,25,JE
2020-05-08,0,0,293,25,JE
2020-05-09,0,0,293,25,JE
2020-05-10,1,0,294,25,JE
2020-05-11,0,0,294,25,JE
2020-05-12,1,1,295,26,JE
2020-05-13,1,1,296,27,JE
2020-05-14,1,0,297,27,JE
2020-05-15,0,0,297,27,JE
2020-05-16,5,0,302,27,JE
2020-05-17,0,0,302,27,JE
2020-05-18,1,0,303,27,JE
2020-05-19,0,1,303,28,JE
2020-05-20,3,1,306,29,JE
2020-05-21,0,0,306,29,JE
2020-05-22,0,0,306,29,JE
2020-05-23,0,0,306,29,JE
2020-05-24,0,0,306,29,JE
2020-05-25,1,0,307,29,JE
2020-05-26,0,0,307,29,JE
2020-05-27,1,0,308,29,JE
2020-05-28,0,0,308,29,JE
2020-05-29,0,0,308,29,JE
2020-05-30,0,0,308,29,JE
2020-05-31,0,0,308,29,JE
2020-06-01,0,0,308,29,JE
2020-06-02,0,1,308,30,JE
2020-06-03,1,0,309,30,JE
2020-06-04,0,0,309,30,JE
2020-06-05,0,0,309,30,JE
2020-06-06,2,0,311,30,JE
2020-06-07,0,0,311,30,JE
2020-06-08,1,0,312,30,JE
2020-06-09,1,0,313,30,JE
2020-06-10,0,0,313,30,JE
2020-06-11,0,0,313,30,JE
2020-06-12,0,0,313,30,JE
2020-06-13,0,0,313,30,JE
2020-06-14,0,0,313,30,JE
2020-06-15,3,0,316,30,JE
2020-06-16,0,0,316,30,JE
2020-06-17,2,0,318,30,JE
2020-06-18,0,0,318,30,JE
2020-06-19,0,1,318,31,JE
2020-06-20,0,0,318,31,JE
2020-06-21,0,0,318,31,JE
2020-06-22,0,0,318,31,JE
2020-06-23,0,0,318,31,JE
2020-06-24,1,0,319,31,JE
2020-06-25,0,0,319,31,JE
2020-06-26,0,0,319,31,JE
2020-03-11,2,0,2,0,JM
2020-03-12,4,0,6,0,JM
2020-03-13,2,0,8,0,JM
2020-03-15,2,0,10,0,JM
2020-03-16,0,0,10,0,JM
2020-03-17,3,0,13,0,JM
2020-03-18,2,0,15,0,JM
2020-03-19,1,0,16,0,JM
2020-03-20,3,0,19,0,JM
2020-03-21,0,0,19,0,JM
2020-03-22,0,0,19,0,JM
2020-03-23,0,0,19,0,JM
2020-03-24,2,1,21,1,JM
2020-03-25,4,0,25,1,JM
2020-03-26,1,0,26,1,JM
2020-03-27,0,0,26,1,JM
2020-03-28,6,0,32,1,JM
2020-03-29,2,0,34,1,JM
2020-03-30,4,0,38,1,JM
2020-03-31,0,0,38,1,JM
2020-04-01,6,2,44,3,JM
2020-04-02,3,0,47,3,JM
2020-04-03,6,0,53,3,JM
2020-04-04,2,0,55,3,JM
2020-04-05,3,0,58,3,JM
2020-04-06,1,0,59,3,JM
2020-04-07,4,0,63,3,JM
2020-04-08,0,1,63,4,JM
2020-04-09,0,0,63,4,JM
2020-04-10,2,0,65,4,JM
2020-04-11,4,0,69,4,JM
2020-04-12,3,0,72,4,JM
2020-04-13,1,0,73,4,JM
2020-04-14,32,1,105,5,JM
2020-04-15,20,0,125,5,JM
2020-04-16,18,0,143,5,JM
2020-04-17,20,0,163,5,JM
2020-04-18,10,0,173,5,JM
2020-04-19,23,0,196,5,JM
2020-04-20,27,1,223,6,JM
2020-04-21,10,0,233,6,JM
2020-04-22,19,0,252,6,JM
2020-04-23,0,0,252,6,JM
2020-04-24,36,1,288,7,JM
2020-04-25,17,0,305,7,JM
2020-04-26,45,0,350,7,JM
2020-04-27,14,0,364,7,JM
2020-04-28,17,0,381,7,JM
2020-04-29,15,0,396,7,JM
2020-04-30,26,1,422,8,JM
2020-05-01,10,0,432,8,JM
2020-05-02,31,0,463,8,JM
2020-05-03,6,1,469,9,JM
2020-05-04,2,0,471,9,JM
2020-05-05,2,0,473,9,JM
2020-05-06,5,0,478,9,JM
2020-05-07,10,0,488,9,JM
2020-05-08,2,0,490,9,JM
2020-05-09,8,0,498,9,JM
2020-05-10,4,0,502,9,JM
2020-05-11,3,0,505,9,JM
2020-05-12,2,0,507,9,JM
2020-05-13,2,0,509,9,JM
2020-05-14,0,0,509,9,JM
2020-05-15,2,0,511,9,JM
2020-05-16,6,0,517,9,JM
2020-05-17,3,0,520,9,JM
2020-05-18,0,0,520,9,JM
2020-05-19,0,0,520,9,JM
2020-05-20,9,0,529,9,JM
2020-05-21,5,0,534,9,JM
2020-05-22,10,0,544,9,JM
2020-05-23,6,0,550,9,JM
2020-05-24,2,0,552,9,JM
2020-05-25,4,0,556,9,JM
2020-05-26,8,0,564,9,JM
2020-05-27,5,0,569,9,JM
2020-05-28,0,0,569,9,JM
2020-05-29,6,0,575,9,JM
2020-05-30,6,0,581,9,JM
2020-05-31,5,0,586,9,JM
2020-06-01,2,0,588,9,JM
2020-06-02,2,0,590,9,JM
2020-06-03,0,0,590,9,JM
2020-06-04,1,1,591,10,JM
2020-06-05,4,0,595,10,JM
2020-06-06,1,0,596,10,JM
2020-06-07,2,0,598,10,JM
2020-06-08,1,0,599,10,JM
2020-06-09,6,0,605,10,JM
2020-06-10,0,0,605,10,JM
2020-06-11,6,0,611,10,JM
2020-06-12,3,0,614,10,JM
2020-06-13,1,0,615,10,JM
2020-06-14,2,0,617,10,JM
2020-06-15,4,0,621,10,JM
2020-06-16,0,0,621,10,JM
2020-06-17,5,0,626,10,JM
2020-06-18,0,0,626,10,JM
2020-06-19,26,0,652,10,JM
2020-06-20,5,0,657,10,JM
2020-06-21,2,0,659,10,JM
2020-06-22,6,0,665,10,JM
2020-06-23,5,0,670,10,JM
2020-06-24,8,0,678,10,JM
2020-06-25,6,0,684,10,JM
2020-06-26,2,0,686,10,JM
2020-03-02,1,0,1,0,JO
2020-03-07,0,0,1,0,JO
2020-03-14,0,0,1,0,JO
2020-03-15,14,0,15,0,JO
2020-03-16,1,0,16,0,JO
2020-03-17,19,0,35,0,JO
2020-03-18,17,0,52,0,JO
2020-03-19,4,0,56,0,JO
2020-03-20,13,0,69,0,JO
2020-03-21,15,0,84,0,JO
2020-03-22,15,0,99,0,JO
2020-03-23,13,0,112,0,JO
2020-03-24,15,0,127,0,JO
2020-03-25,26,0,153,0,JO
2020-03-26,19,0,172,0,JO
2020-03-27,40,0,212,0,JO
2020-03-28,23,1,235,1,JO
2020-03-29,24,0,259,1,JO
2020-03-30,9,4,268,5,JO
2020-03-31,6,0,274,5,JO
2020-04-01,4,0,278,5,JO
2020-04-02,21,0,299,5,JO
2020-04-03,0,0,299,5,JO
2020-04-04,24,0,323,5,JO
2020-04-05,22,0,345,5,JO
2020-04-06,4,1,349,6,JO
2020-04-07,0,0,349,6,JO
2020-04-08,9,0,358,6,JO
2020-04-09,14,1,372,7,JO
2020-04-10,0,0,372,7,JO
2020-04-11,9,0,381,7,JO
2020-04-12,8,0,389,7,JO
2020-04-13,2,0,391,7,JO
2020-04-14,6,0,397,7,JO
2020-04-15,4,0,401,7,JO
2020-04-16,1,0,402,7,JO
2020-04-17,5,0,407,7,JO
2020-04-18,6,0,413,7,JO
2020-04-19,4,0,417,7,JO
2020-04-20,8,0,425,7,JO
2020-04-21,0,0,425,7,JO
2020-04-22,3,0,428,7,JO
2020-04-23,9,0,437,7,JO
2020-04-24,4,0,441,7,JO
2020-04-25,3,0,444,7,JO
2020-04-26,3,0,447,7,JO
2020-04-27,2,0,449,7,JO
2020-04-28,0,1,449,8,JO
2020-04-29,2,0,451,8,JO
2020-04-30,2,0,453,8,JO
2020-05-01,6,0,459,8,JO
2020-05-02,1,1,460,9,JO
2020-05-03,1,0,461,9,JO
2020-05-04,4,0,465,9,JO
2020-05-05,6,0,471,9,JO
2020-05-06,2,0,473,9,JO
2020-05-07,21,0,494,9,JO
2020-05-08,14,0,508,9,JO
2020-05-09,14,0,522,9,JO
2020-05-10,18,0,540,9,JO
2020-05-11,22,0,562,9,JO
2020-05-12,14,0,576,9,JO
2020-05-13,6,0,582,9,JO
2020-05-14,4,0,586,9,JO
2020-05-15,10,0,596,9,JO
2020-05-16,11,0,607,9,JO
2020-05-17,6,0,613,9,JO
2020-05-18,16,0,629,9,JO
2020-05-19,20,0,649,9,JO
2020-05-20,23,0,672,9,JO
2020-05-21,12,0,684,9,JO
2020-05-22,16,0,700,9,JO
2020-05-23,4,0,704,9,JO
2020-05-24,4,0,708,9,JO
2020-05-25,3,0,711,9,JO
2020-05-26,7,0,718,9,JO
2020-05-27,2,0,720,9,JO
2020-05-28,8,0,728,9,JO
2020-05-29,2,0,730,9,JO
2020-05-30,4,0,734,9,JO
2020-05-31,5,0,739,9,JO
2020-06-01,7,0,746,9,JO
2020-06-02,9,0,755,9,JO
2020-06-03,2,0,757,9,JO
2020-06-04,8,0,765,9,JO
2020-06-05,19,0,784,9,JO
2020-06-06,11,0,795,9,JO
2020-06-07,13,0,808,9,JO
2020-06-08,23,0,831,9,JO
2020-06-09,14,0,845,9,JO
2020-06-10,18,0,863,9,JO
2020-06-11,27,0,890,9,JO
2020-06-12,25,0,915,9,JO
2020-06-13,38,0,953,9,JO
2020-06-14,8,0,961,9,JO
2020-06-15,18,0,979,9,JO
2020-06-16,2,0,981,9,JO
2020-06-17,6,0,987,9,JO
2020-06-18,14,0,1001,9,JO
2020-06-19,7,0,1008,9,JO
2020-06-20,7,0,1015,9,JO
2020-06-21,18,0,1033,9,JO
2020-06-22,9,0,1042,9,JO
2020-06-23,5,0,1047,9,JO
2020-06-24,24,0,1071,9,JO
2020-06-25,15,0,1086,9,JO
2020-06-26,18,0,1104,9,JO
2019-12-30,0,0,0,0,JP
2019-12-31,0,0,0,0,JP
2020-01-01,0,0,0,0,JP
2020-01-02,0,0,0,0,JP
2020-01-03,0,0,0,0,JP
2020-01-04,0,0,0,0,JP
2020-01-05,0,0,0,0,JP
2020-01-06,0,0,0,0,JP
2020-01-07,0,0,0,0,JP
2020-01-08,0,0,0,0,JP
2020-01-09,0,0,0,0,JP
2020-01-10,0,0,0,0,JP
2020-01-11,0,0,0,0,JP
2020-01-12,0,0,0,0,JP
2020-01-13,0,0,0,0,JP
2020-01-14,1,0,1,0,JP
2020-01-15,0,0,1,0,JP
2020-01-16,0,0,1,0,JP
2020-01-17,0,0,1,0,JP
2020-01-18,0,0,1,0,JP
2020-01-19,0,0,1,0,JP
2020-01-20,0,0,1,0,JP
2020-01-21,0,0,1,0,JP
2020-01-22,0,0,1,0,JP
2020-01-23,1,0,2,0,JP
2020-01-24,0,0,2,0,JP
2020-01-25,1,0,3,0,JP
2020-01-26,0,0,3,0,JP
2020-01-27,1,0,4,0,JP
2020-01-28,3,0,7,0,JP
2020-01-29,4,0,11,0,JP
2020-01-30,3,0,14,0,JP
2020-01-31,1,0,15,0,JP
2020-02-01,4,0,19,0,JP
2020-02-02,1,0,20,0,JP
2020-02-03,0,0,20,0,JP
2020-02-04,5,0,25,0,JP
2020-02-05,0,0,25,0,JP
2020-02-06,0,0,25,0,JP
2020-02-07,0,0,25,0,JP
2020-02-08,0,0,25,0,JP
2020-02-09,0,0,25,0,JP
2020-02-10,0,0,25,0,JP
2020-02-11,0,0,25,0,JP
2020-02-12,4,1,29,1,JP
2020-02-13,1,0,30,1,JP
2020-02-14,8,0,38,1,JP
2020-02-15,14,0,52,1,JP
2020-02-16,7,0,59,1,JP
2020-02-17,0,0,59,1,JP
2020-02-18,7,0,66,1,JP
2020-02-19,18,0,84,1,JP
2020-02-20,9,0,93,1,JP
2020-02-21,12,0,105,1,JP
2020-02-22,27,0,132,1,JP
2020-02-23,12,0,144,1,JP
2020-02-24,0,0,144,1,JP
2020-02-25,20,0,164,1,JP
2020-02-26,22,2,186,3,JP
2020-02-27,24,0,210,3,JP
2020-02-28,20,0,230,3,JP
2020-02-29,9,2,239,5,JP
2020-03-01,15,1,254,6,JP
2020-03-02,0,0,254,6,JP
2020-03-03,14,0,268,6,JP
2020-03-04,49,0,317,6,JP
2020-03-05,32,0,349,6,JP
2020-03-06,59,0,408,6,JP
2020-03-07,47,0,455,6,JP
2020-03-08,33,1,488,7,JP
2020-03-09,26,2,514,9,JP
2020-03-10,54,3,568,12,JP
2020-03-11,51,3,619,15,JP
2020-03-12,56,4,675,19,JP
2020-03-13,62,2,737,21,JP
2020-03-14,43,1,780,22,JP
2020-03-15,34,2,814,24,JP
2020-03-16,10,4,824,28,JP
2020-03-17,5,0,829,28,JP
2020-03-18,44,1,873,29,JP
2020-03-19,77,4,950,33,JP
2020-03-20,57,2,1007,35,JP
2020-03-21,39,1,1046,36,JP
2020-03-22,43,5,1089,41,JP
2020-03-23,39,1,1128,42,JP
2020-03-24,65,1,1193,43,JP
2020-03-25,75,2,1268,45,JP
2020-03-26,96,1,1364,46,JP
2020-03-27,135,3,1499,49,JP
2020-03-28,194,3,1693,52,JP
2020-03-29,173,2,1866,54,JP
2020-03-30,87,2,1953,56,JP
2020-03-31,0,0,1953,56,JP
2020-04-01,225,1,2178,57,JP
2020-04-02,439,6,2617,63,JP
2020-04-03,318,6,2935,69,JP
2020-04-04,336,1,3271,70,JP
2020-04-05,383,3,3654,73,JP
2020-04-06,163,7,3817,80,JP
2020-04-07,89,0,3906,80,JP
2020-04-08,351,1,4257,81,JP
2020-04-09,410,4,4667,85,JP
2020-04-10,680,3,5347,88,JP
2020-04-11,1401,10,6748,98,JP
2020-04-12,507,4,7255,102,JP
2020-04-13,390,7,7645,109,JP
2020-04-14,455,10,8100,119,JP
2020-04-15,482,17,8582,136,JP
2020-04-16,585,12,9167,148,JP
2020-04-17,628,6,9795,154,JP
2020-04-18,566,7,10361,161,JP
2020-04-19,390,10,10751,171,JP
2020-04-20,367,15,11118,186,JP
2020-04-21,378,0,11496,186,JP
2020-04-22,276,101,11772,287,JP
2020-04-23,468,30,12240,317,JP
2020-04-24,652,17,12892,334,JP
2020-04-25,290,14,13182,348,JP
2020-04-26,203,3,13385,351,JP
2020-04-27,191,25,13576,376,JP
2020-04-28,276,13,13852,389,JP
2020-04-29,236,26,14088,415,JP
2020-04-30,193,17,14281,432,JP
2020-05-01,263,26,14544,458,JP
2020-05-02,295,34,14839,492,JP
2020-05-03,218,18,15057,510,JP
2020-05-04,174,11,15231,521,JP
2020-05-05,123,22,15354,543,JP
2020-05-06,109,8,15463,551,JP
2020-05-07,84,6,15547,557,JP
2020-05-08,81,44,15628,601,JP
2020-05-09,119,12,15747,613,JP
2020-05-10,51,8,15798,621,JP
2020-05-11,76,22,15874,643,JP
2020-05-12,150,25,16024,668,JP
2020-05-13,55,19,16079,687,JP
2020-05-14,114,23,16193,710,JP
2020-05-15,44,15,16237,725,JP
2020-05-16,48,19,16285,744,JP
2020-05-17,20,5,16305,749,JP
2020-05-18,60,14,16365,763,JP
2020-05-19,20,8,16385,771,JP
2020-05-20,39,6,16424,777,JP
2020-05-21,89,19,16513,796,JP
2020-05-22,23,12,16536,808,JP
2020-05-23,14,12,16550,820,JP
2020-05-24,31,10,16581,830,JP
2020-05-25,42,16,16623,846,JP
2020-05-26,28,12,16651,858,JP
2020-05-27,0,0,16651,858,JP
2020-05-28,68,16,16719,874,JP
2020-05-29,85,12,16804,886,JP
2020-05-30,47,5,16851,891,JP
2020-05-31,33,1,16884,892,JP
2020-06-01,46,2,16930,894,JP
2020-06-02,56,6,16986,900,JP
2020-06-03,32,3,17018,903,JP
2020-06-04,46,4,17064,907,JP
2020-06-05,39,7,17103,914,JP
2020-06-06,38,2,17141,916,JP
2020-06-07,33,0,17174,916,JP
2020-06-08,36,0,17210,916,JP
2020-06-09,41,3,17251,919,JP
2020-06-10,41,1,17292,920,JP
2020-06-11,40,2,17332,922,JP
2020-06-12,50,2,17382,924,JP
2020-06-13,47,1,17429,925,JP
2020-06-14,73,0,17502,925,JP
2020-06-15,85,2,17587,927,JP
2020-06-16,41,4,17628,931,JP
2020-06-17,40,4,17668,935,JP
2020-06-18,72,0,17740,935,JP
2020-06-19,59,17,17799,952,JP
2020-06-20,0,0,17799,952,JP
2020-06-21,117,1,17916,953,JP
2020-06-22,52,2,17968,955,JP
2020-06-23,59,8,18027,963,JP
2020-06-24,83,5,18110,968,JP
2020-06-25,87,1,18197,969,JP
2020-06-26,100,2,18297,971,JP
2020-03-13,1,0,1,0,KE
2020-03-14,0,0,1,0,KE
2020-03-15,2,0,3,0,KE
2020-03-16,0,0,3,0,KE
2020-03-17,1,0,4,0,KE
2020-03-18,3,0,7,0,KE
2020-03-19,0,0,7,0,KE
2020-03-20,0,0,7,0,KE
2020-03-21,0,0,7,0,KE
2020-03-22,8,0,15,0,KE
2020-03-23,1,0,16,0,KE
2020-03-24,9,0,25,0,KE
2020-03-25,0,0,25,0,KE
2020-03-26,6,1,31,1,KE
2020-03-27,0,0,31,1,KE
2020-03-28,7,0,38,1,KE
2020-03-29,4,0,42,1,KE
2020-03-30,8,0,50,1,KE
2020-03-31,9,0,59,1,KE
2020-04-01,22,0,81,1,KE
2020-04-02,29,2,110,3,KE
2020-04-03,12,1,122,4,KE
2020-04-04,4,0,126,4,KE
2020-04-05,16,0,142,4,KE
2020-04-06,16,0,158,4,KE
2020-04-07,14,2,172,6,KE
2020-04-08,7,0,179,6,KE
2020-04-09,5,1,184,7,KE
2020-04-10,5,0,189,7,KE
2020-04-11,2,0,191,7,KE
2020-04-12,6,1,197,8,KE
2020-04-13,11,1,208,9,KE
2020-04-14,8,0,216,9,KE
2020-04-15,9,1,225,10,KE
2020-04-16,9,1,234,11,KE
2020-04-17,12,0,246,11,KE
2020-04-18,16,1,262,12,KE
2020-04-19,8,2,270,14,KE
2020-04-20,11,0,281,14,KE
2020-04-21,0,0,281,14,KE
2020-04-22,22,0,303,14,KE
2020-04-23,17,0,320,14,KE
2020-04-24,16,0,336,14,KE
2020-04-25,7,0,343,14,KE
2020-04-26,12,0,355,14,KE
2020-04-27,8,0,363,14,KE
2020-04-28,11,0,374,14,KE
2020-04-29,10,1,384,15,KE
2020-04-30,12,2,396,17,KE
2020-05-01,15,4,411,21,KE
2020-05-02,24,1,435,22,KE
2020-05-03,30,2,465,24,KE
2020-05-04,25,0,490,24,KE
2020-05-05,45,0,535,24,KE
2020-05-06,47,2,582,26,KE
2020-05-07,25,3,607,29,KE
2020-05-08,14,0,621,29,KE
2020-05-09,28,1,649,30,KE
2020-05-10,23,2,672,32,KE
2020-05-11,28,1,700,33,KE
2020-05-12,15,3,715,36,KE
2020-05-13,22,4,737,40,KE
2020-05-14,21,2,758,42,KE
2020-05-15,23,3,781,45,KE
2020-05-16,49,5,830,50,KE
2020-05-17,57,0,887,50,KE
2020-05-18,25,0,912,50,KE
2020-05-19,51,0,963,50,KE
2020-05-20,66,0,1029,50,KE
2020-05-21,80,0,1109,50,KE
2020-05-22,52,0,1161,50,KE
2020-05-23,31,0,1192,50,KE
2020-05-24,22,1,1214,51,KE
2020-05-25,72,1,1286,52,KE
2020-05-26,62,0,1348,52,KE
2020-05-27,123,3,1471,55,KE
2020-05-28,147,3,1618,58,KE
2020-05-29,127,4,1745,62,KE
2020-05-30,143,1,1888,63,KE
2020-05-31,74,1,1962,64,KE
2020-06-01,59,5,2021,69,KE
2020-06-02,72,2,2093,71,KE
2020-06-03,123,3,2216,74,KE
2020-06-04,124,4,2340,78,KE
2020-06-05,134,1,2474,79,KE
2020-06-06,126,4,2600,83,KE
2020-06-07,167,1,2767,84,KE
2020-06-08,95,1,2862,85,KE
2020-06-09,127,3,2989,88,KE
2020-06-10,105,1,3094,89,KE
2020-06-11,121,3,3215,92,KE
2020-06-12,90,4,3305,96,KE
2020-06-13,152,4,3457,100,KE
2020-06-14,137,3,3594,103,KE
2020-06-15,133,1,3727,104,KE
2020-06-16,133,1,3860,105,KE
2020-06-17,184,2,4044,107,KE
2020-06-18,213,10,4257,117,KE
2020-06-19,117,2,4374,119,KE
2020-06-20,104,2,4478,121,KE
2020-06-21,260,2,4738,123,KE
2020-06-22,59,2,4797,125,KE
2020-06-23,155,3,4952,128,KE
2020-06-24,254,2,5206,130,KE
2020-06-25,178,2,5384,132,KE
2020-06-26,149,5,5533,137,KE
2020-03-18,3,0,3,0,KG
2020-03-19,3,0,6,0,KG
2020-03-20,0,0,6,0,KG
2020-03-21,8,0,14,0,KG
2020-03-22,0,0,14,0,KG
2020-03-23,2,0,16,0,KG
2020-03-24,26,0,42,0,KG
2020-03-25,2,0,44,0,KG
2020-03-26,0,0,44,0,KG
2020-03-27,14,0,58,0,KG
2020-03-28,26,0,84,0,KG
2020-03-29,0,0,84,0,KG
2020-03-30,0,0,84,0,KG
2020-03-31,23,0,107,0,KG
2020-04-01,5,1,112,1,KG
2020-04-02,13,0,125,1,KG
2020-04-03,19,0,144,1,KG
2020-04-04,0,0,144,1,KG
2020-04-05,72,3,216,4,KG
2020-04-06,12,0,228,4,KG
2020-04-07,42,0,270,4,KG
2020-04-08,10,0,280,4,KG
2020-04-09,18,1,298,5,KG
2020-04-10,41,0,339,5,KG
2020-04-11,38,0,377,5,KG
2020-04-12,42,0,419,5,KG
2020-04-13,11,0,430,5,KG
2020-04-14,19,0,449,5,KG
2020-04-15,17,0,466,5,KG
2020-04-16,23,0,489,5,KG
2020-04-17,17,0,506,5,KG
2020-04-18,48,0,554,5,KG
2020-04-19,14,2,568,7,KG
2020-04-20,22,0,590,7,KG
2020-04-21,22,0,612,7,KG
2020-04-22,19,1,631,8,KG
2020-04-23,25,0,656,8,KG
2020-04-24,9,0,665,8,KG
2020-04-25,17,0,682,8,KG
2020-04-26,13,0,695,8,KG
2020-04-27,13,0,708,8,KG
2020-04-28,21,0,729,8,KG
2020-04-29,17,0,746,8,KG
2020-04-30,0,0,746,8,KG
2020-05-01,23,0,769,8,KG
2020-05-02,26,2,795,10,KG
2020-05-03,35,0,830,10,KG
2020-05-04,13,1,843,11,KG
2020-05-05,28,1,871,12,KG
2020-05-06,24,0,895,12,KG
2020-05-07,11,0,906,12,KG
2020-05-08,25,0,931,12,KG
2020-05-09,71,0,1002,12,KG
2020-05-10,14,0,1016,12,KG
2020-05-11,21,0,1037,12,KG
2020-05-12,7,0,1044,12,KG
2020-05-13,38,0,1082,12,KG
2020-05-14,29,2,1111,14,KG
2020-05-15,6,0,1117,14,KG
2020-05-16,21,0,1138,14,KG
2020-05-17,78,0,1216,14,KG
2020-05-18,27,0,1243,14,KG
2020-05-19,27,0,1270,14,KG
2020-05-20,43,0,1313,14,KG
2020-05-21,37,0,1350,14,KG
2020-05-22,14,0,1364,14,KG
2020-05-23,39,0,1403,14,KG
2020-05-24,30,2,1433,16,KG
2020-05-25,35,0,1468,16,KG
2020-05-26,52,0,1520,16,KG
2020-05-27,74,0,1594,16,KG
2020-05-28,68,0,1662,16,KG
2020-05-29,60,0,1722,16,KG
2020-05-30,26,0,1748,16,KG
2020-05-31,69,0,1817,16,KG
2020-06-01,28,1,1845,17,KG
2020-06-02,26,3,1871,20,KG
2020-06-03,28,0,1899,20,KG
2020-06-04,37,2,1936,22,KG
2020-06-05,38,0,1974,22,KG
2020-06-06,33,0,2007,22,KG
2020-06-07,25,1,2032,23,KG
2020-06-08,23,1,2055,24,KG
2020-06-09,38,2,2093,26,KG
2020-06-10,36,0,2129,26,KG
2020-06-11,37,0,2166,26,KG
2020-06-12,41,1,2207,27,KG
2020-06-13,78,0,2285,27,KG
2020-06-14,87,0,2372,27,KG
2020-06-15,100,1,2472,28,KG
2020-06-16,90,2,2562,30,KG
2020-06-17,95,1,2657,31,KG
2020-06-18,132,1,2789,32,KG
2020-06-19,192,3,2981,35,KG
2020-06-20,170,2,3151,37,KG
2020-06-21,205,3,3356,40,KG
2020-06-22,163,1,3519,41,KG
2020-06-23,207,1,3726,42,KG
2020-06-24,228,1,3954,43,KG
2020-06-25,250,0,4204,43,KG
2020-06-26,309,3,4513,46,KG
2019-12-30,0,0,0,0,KH
2019-12-31,0,0,0,0,KH
2020-01-01,0,0,0,0,KH
2020-01-02,0,0,0,0,KH
2020-01-03,0,0,0,0,KH
2020-01-04,0,0,0,0,KH
2020-01-05,0,0,0,0,KH
2020-01-06,0,0,0,0,KH
2020-01-07,0,0,0,0,KH
2020-01-08,0,0,0,0,KH
2020-01-09,0,0,0,0,KH
2020-01-10,0,0,0,0,KH
2020-01-11,0,0,0,0,KH
2020-01-12,0,0,0,0,KH
2020-01-13,0,0,0,0,KH
2020-01-14,0,0,0,0,KH
2020-01-15,0,0,0,0,KH
2020-01-16,0,0,0,0,KH
2020-01-17,0,0,0,0,KH
2020-01-18,0,0,0,0,KH
2020-01-19,0,0,0,0,KH
2020-01-20,0,0,0,0,KH
2020-01-21,0,0,0,0,KH
2020-01-22,0,0,0,0,KH
2020-01-23,0,0,0,0,KH
2020-01-24,0,0,0,0,KH
2020-01-25,0,0,0,0,KH
2020-01-26,0,0,0,0,KH
2020-01-27,1,0,1,0,KH
2020-01-28,0,0,1,0,KH
2020-01-29,0,0,1,0,KH
2020-01-30,0,0,1,0,KH
2020-01-31,0,0,1,0,KH
2020-02-01,0,0,1,0,KH
2020-02-02,0,0,1,0,KH
2020-02-03,0,0,1,0,KH
2020-02-04,0,0,1,0,KH
2020-02-05,0,0,1,0,KH
2020-02-06,0,0,1,0,KH
2020-02-07,0,0,1,0,KH
2020-02-08,0,0,1,0,KH
2020-02-09,0,0,1,0,KH
2020-02-10,0,0,1,0,KH
2020-02-11,0,0,1,0,KH
2020-02-12,0,0,1,0,KH
2020-02-13,0,0,1,0,KH
2020-02-14,0,0,1,0,KH
2020-02-15,0,0,1,0,KH
2020-02-16,0,0,1,0,KH
2020-02-17,0,0,1,0,KH
2020-02-18,0,0,1,0,KH
2020-02-19,0,0,1,0,KH
2020-02-20,0,0,1,0,KH
2020-02-21,0,0,1,0,KH
2020-02-22,0,0,1,0,KH
2020-02-23,0,0,1,0,KH
2020-02-24,0,0,1,0,KH
2020-02-25,0,0,1,0,KH
2020-02-26,0,0,1,0,KH
2020-02-27,0,0,1,0,KH
2020-02-28,0,0,1,0,KH
2020-02-29,0,0,1,0,KH
2020-03-01,0,0,1,0,KH
2020-03-07,1,0,2,0,KH
2020-03-11,1,0,3,0,KH
2020-03-12,2,0,5,0,KH
2020-03-14,2,0,7,0,KH
2020-03-15,5,0,12,0,KH
2020-03-16,12,0,24,0,KH
2020-03-17,0,0,24,0,KH
2020-03-18,0,0,24,0,KH
2020-03-19,0,0,24,0,KH
2020-03-20,23,0,47,0,KH
2020-03-21,4,0,51,0,KH
2020-03-22,35,0,86,0,KH
2020-03-23,1,0,87,0,KH
2020-03-24,4,0,91,0,KH
2020-03-25,5,0,96,0,KH
2020-03-26,2,0,98,0,KH
2020-03-27,4,0,102,0,KH
2020-03-28,1,0,103,0,KH
2020-03-29,4,0,107,0,KH
2020-03-30,2,0,109,0,KH
2020-03-31,0,0,109,0,KH
2020-04-01,1,0,110,0,KH
2020-04-02,4,0,114,0,KH
2020-04-03,0,0,114,0,KH
2020-04-04,0,0,114,0,KH
2020-04-05,0,0,114,0,KH
2020-04-06,1,0,115,0,KH
2020-04-07,2,0,117,0,KH
2020-04-08,1,0,118,0,KH
2020-04-09,1,0,119,0,KH
2020-04-10,1,0,120,0,KH
2020-04-11,2,0,122,0,KH
2020-04-12,0,0,122,0,KH
2020-04-13,0,0,122,0,KH
2020-04-14,0,0,122,0,KH
2020-04-15,0,0,122,0,KH
2020-04-16,0,0,122,0,KH
2020-04-17,0,0,122,0,KH
2020-04-18,0,0,122,0,KH
2020-04-19,0,0,122,0,KH
2020-04-20,0,0,122,0,KH
2020-04-21,0,0,122,0,KH
2020-04-22,0,0,122,0,KH
2020-04-23,0,0,122,0,KH
2020-04-24,0,0,122,0,KH
2020-04-25,0,0,122,0,KH
2020-04-26,0,0,122,0,KH
2020-04-27,0,0,122,0,KH
2020-04-28,0,0,122,0,KH
2020-04-29,0,0,122,0,KH
2020-04-30,0,0,122,0,KH
2020-05-01,0,0,122,0,KH
2020-05-02,0,0,122,0,KH
2020-05-03,0,0,122,0,KH
2020-05-04,0,0,122,0,KH
2020-05-05,0,0,122,0,KH
2020-05-06,0,0,122,0,KH
2020-05-07,0,0,122,0,KH
2020-05-08,0,0,122,0,KH
2020-05-09,0,0,122,0,KH
2020-05-10,0,0,122,0,KH
2020-05-11,0,0,122,0,KH
2020-05-12,0,0,122,0,KH
2020-05-13,0,0,122,0,KH
2020-05-14,0,0,122,0,KH
2020-05-15,0,0,122,0,KH
2020-05-16,0,0,122,0,KH
2020-05-17,0,0,122,0,KH
2020-05-18,0,0,122,0,KH
2020-05-19,0,0,122,0,KH
2020-05-20,0,0,122,0,KH
2020-05-21,1,0,123,0,KH
2020-05-22,1,0,124,0,KH
2020-05-23,0,0,124,0,KH
2020-05-24,0,0,124,0,KH
2020-05-25,0,0,124,0,KH
2020-05-26,0,0,124,0,KH
2020-05-27,0,0,124,0,KH
2020-05-28,0,0,124,0,KH
2020-05-29,1,0,125,0,KH
2020-05-30,0,0,125,0,KH
2020-05-31,0,0,125,0,KH
2020-06-01,0,0,125,0,KH
2020-06-02,0,0,125,0,KH
2020-06-03,0,0,125,0,KH
2020-06-04,0,0,125,0,KH
2020-06-05,0,0,125,0,KH
2020-06-06,0,0,125,0,KH
2020-06-07,1,0,126,0,KH
2020-06-08,0,0,126,0,KH
2020-06-09,0,0,126,0,KH
2020-06-10,0,0,126,0,KH
2020-06-11,0,0,126,0,KH
2020-06-12,0,0,126,0,KH
2020-06-13,2,0,128,0,KH
2020-06-14,0,0,128,0,KH
2020-06-15,0,0,128,0,KH
2020-06-16,0,0,128,0,KH
2020-06-17,1,0,129,0,KH
2020-06-18,0,0,129,0,KH
2020-06-19,0,0,129,0,KH
2020-06-20,0,0,129,0,KH
2020-06-21,0,0,129,0,KH
2020-06-22,1,0,130,0,KH
2020-06-23,0,0,130,0,KH
2020-06-24,0,0,130,0,KH
2020-06-25,0,0,130,0,KH
2020-06-26,9,0,139,0,KH
2020-05-01,1,0,1,0,KM
2020-05-02,0,0,1,0,KM
2020-05-03,2,0,3,0,KM
2020-05-04,1,1,4,1,KM
2020-05-05,0,0,4,1,KM
2020-05-06,4,0,8,1,KM
2020-05-07,0,0,8,1,KM
2020-05-08,0,0,8,1,KM
2020-05-09,3,0,11,1,KM
2020-05-10,0,0,11,1,KM
2020-05-11,0,0,11,1,KM
2020-05-12,0,0,11,1,KM
2020-05-13,0,0,11,1,KM
2020-05-14,0,0,11,1,KM
2020-05-15,0,0,11,1,KM
2020-05-16,0,0,11,1,KM
2020-05-17,0,0,11,1,KM
2020-05-18,0,0,11,1,KM
2020-05-19,23,0,34,1,KM
2020-05-20,0,0,34,1,KM
2020-05-21,0,0,34,1,KM
2020-05-22,44,0,78,1,KM
2020-05-23,0,0,78,1,KM
2020-05-24,9,0,87,1,KM
2020-05-25,0,0,87,1,KM
2020-05-26,0,0,87,1,KM
2020-05-27,0,1,87,2,KM
2020-05-28,0,0,87,2,KM
2020-05-29,0,0,87,2,KM
2020-05-30,19,0,106,2,KM
2020-05-31,0,0,106,2,KM
2020-06-01,0,0,106,2,KM
2020-06-02,26,0,132,2,KM
2020-06-03,0,0,132,2,KM
2020-06-04,0,0,132,2,KM
2020-06-05,0,0,132,2,KM
2020-06-06,9,0,141,2,KM
2020-06-07,0,0,141,2,KM
2020-06-08,0,0,141,2,KM
2020-06-09,21,0,162,2,KM
2020-06-10,0,0,162,2,KM
2020-06-11,0,0,162,2,KM
2020-06-12,0,0,162,2,KM
2020-06-13,14,0,176,2,KM
2020-06-14,0,0,176,2,KM
2020-06-15,0,0,176,2,KM
2020-06-16,21,1,197,3,KM
2020-06-17,0,0,197,3,KM
2020-06-18,13,2,210,5,KM
2020-06-19,0,0,210,5,KM
2020-06-20,37,0,247,5,KM
2020-06-21,0,0,247,5,KM
2020-06-22,0,0,247,5,KM
2020-06-23,0,2,247,7,KM
2020-06-24,0,0,247,7,KM
2020-06-25,0,0,247,7,KM
2020-06-26,0,0,247,7,KM
2020-03-25,2,0,2,0,KN
2020-03-26,0,0,2,0,KN
2020-03-27,0,0,2,0,KN
2020-03-28,0,0,2,0,KN
2020-03-29,5,0,7,0,KN
2020-03-30,0,0,7,0,KN
2020-03-31,1,0,8,0,KN
2020-04-01,0,0,8,0,KN
2020-04-02,0,0,8,0,KN
2020-04-03,1,0,9,0,KN
2020-04-04,1,0,10,0,KN
2020-04-05,0,0,10,0,KN
2020-04-06,1,0,11,0,KN
2020-04-07,0,0,11,0,KN
2020-04-08,0,0,11,0,KN
2020-04-09,0,0,11,0,KN
2020-04-10,1,0,12,0,KN
2020-04-11,0,0,12,0,KN
2020-04-12,0,0,12,0,KN
2020-04-13,0,0,12,0,KN
2020-04-14,2,0,14,0,KN
2020-04-15,0,0,14,0,KN
2020-04-16,0,0,14,0,KN
2020-04-17,0,0,14,0,KN
2020-04-18,0,0,14,0,KN
2020-04-19,1,0,15,0,KN
2020-04-20,0,0,15,0,KN
2020-04-21,0,0,15,0,KN
2020-04-22,0,0,15,0,KN
2020-04-23,0,0,15,0,KN
2020-04-24,0,0,15,0,KN
2020-04-25,0,0,15,0,KN
2020-04-26,0,0,15,0,KN
2020-04-27,0,0,15,0,KN
2020-04-28,0,0,15,0,KN
2020-04-29,0,0,15,0,KN
2020-04-30,0,0,15,0,KN
2020-05-01,0,0,15,0,KN
2020-05-02,0,0,15,0,KN
2020-05-03,0,0,15,0,KN
2020-05-04,0,0,15,0,KN
2020-05-05,0,0,15,0,KN
2020-05-06,0,0,15,0,KN
2020-05-07,0,0,15,0,KN
2020-05-08,0,0,15,0,KN
2020-05-09,0,0,15,0,KN
2020-05-10,0,0,15,0,KN
2020-05-11,0,0,15,0,KN
2020-05-12,0,0,15,0,KN
2020-05-13,0,0,15,0,KN
2020-05-14,0,0,15,0,KN
2020-05-15,0,0,15,0,KN
2020-05-16,0,0,15,0,KN
2020-05-17,0,0,15,0,KN
2020-05-18,0,0,15,0,KN
2020-05-19,0,0,15,0,KN
2020-05-20,0,0,15,0,KN
2020-05-21,0,0,15,0,KN
2020-05-22,0,0,15,0,KN
2020-05-23,0,0,15,0,KN
2020-05-24,0,0,15,0,KN
2020-05-25,0,0,15,0,KN
2020-05-26,0,0,15,0,KN
2020-05-27,0,0,15,0,KN
2020-05-28,0,0,15,0,KN
2020-05-29,0,0,15,0,KN
2020-05-30,0,0,15,0,KN
2020-05-31,0,0,15,0,KN
2020-06-01,0,0,15,0,KN
2020-06-02,0,0,15,0,KN
2020-06-03,0,0,15,0,KN
2020-06-04,0,0,15,0,KN
2020-06-05,0,0,15,0,KN
2020-06-06,0,0,15,0,KN
2020-06-07,0,0,15,0,KN
2020-06-08,0,0,15,0,KN
2020-06-09,0,0,15,0,KN
2020-06-10,0,0,15,0,KN
2020-06-11,0,0,15,0,KN
2020-06-12,0,0,15,0,KN
2020-06-13,0,0,15,0,KN
2020-06-14,0,0,15,0,KN
2020-06-15,0,0,15,0,KN
2020-06-16,0,0,15,0,KN
2020-06-17,0,0,15,0,KN
2020-06-18,0,0,15,0,KN
2020-06-19,0,0,15,0,KN
2020-06-20,0,0,15,0,KN
2020-06-21,0,0,15,0,KN
2020-06-22,0,0,15,0,KN
2020-06-23,0,0,15,0,KN
2020-06-24,0,0,15,0,KN
2020-06-25,0,0,15,0,KN
2020-06-26,0,0,15,0,KN
2019-12-30,0,0,0,0,KR
2019-12-31,0,0,0,0,KR
2020-01-01,0,0,0,0,KR
2020-01-02,0,0,0,0,KR
2020-01-03,0,0,0,0,KR
2020-01-04,0,0,0,0,KR
2020-01-05,0,0,0,0,KR
2020-01-06,0,0,0,0,KR
2020-01-07,0,0,0,0,KR
2020-01-08,0,0,0,0,KR
2020-01-09,0,0,0,0,KR
2020-01-10,0,0,0,0,KR
2020-01-11,0,0,0,0,KR
2020-01-12,0,0,0,0,KR
2020-01-13,0,0,0,0,KR
2020-01-14,0,0,0,0,KR
2020-01-15,0,0,0,0,KR
2020-01-16,0,0,0,0,KR
2020-01-17,0,0,0,0,KR
2020-01-18,0,0,0,0,KR
2020-01-19,1,0,1,0,KR
2020-01-20,0,0,1,0,KR
2020-01-21,0,0,1,0,KR
2020-01-22,0,0,1,0,KR
2020-01-23,1,0,2,0,KR
2020-01-24,0,0,2,0,KR
2020-01-25,1,0,3,0,KR
2020-01-26,1,0,4,0,KR
2020-01-27,0,0,4,0,KR
2020-01-28,0,0,4,0,KR
2020-01-29,0,0,4,0,KR
2020-01-30,3,0,7,0,KR
2020-01-31,5,0,12,0,KR
2020-02-01,3,0,15,0,KR
2020-02-02,0,0,15,0,KR
2020-02-03,1,0,16,0,KR
2020-02-04,2,0,18,0,KR
2020-02-05,5,0,23,0,KR
2020-02-06,1,0,24,0,KR
2020-02-07,0,0,24,0,KR
2020-02-08,1,0,25,0,KR
2020-02-09,2,0,27,0,KR
2020-02-10,1,0,28,0,KR
2020-02-11,0,0,28,0,KR
2020-02-12,0,0,28,0,KR
2020-02-13,0,0,28,0,KR
2020-02-14,0,0,28,0,KR
2020-02-15,1,0,29,0,KR
2020-02-16,1,0,30,0,KR
2020-02-17,1,0,31,0,KR
2020-02-18,15,0,46,0,KR
2020-02-19,34,0,80,0,KR
2020-02-20,75,1,155,1,KR
2020-02-21,190,1,345,2,KR
2020-02-22,256,3,601,5,KR
2020-02-23,161,2,762,7,KR
2020-02-24,130,1,892,8,KR
2020-02-25,254,3,1146,11,KR
2020-02-26,449,1,1595,12,KR
2020-02-27,427,1,2022,13,KR
2020-02-28,909,3,2931,16,KR
2020-02-29,595,1,3526,17,KR
2020-03-01,686,5,4212,22,KR
2020-03-02,600,6,4812,28,KR
2020-03-03,516,4,5328,32,KR
2020-03-04,438,3,5766,35,KR
2020-03-05,518,7,6284,42,KR
2020-03-06,483,2,6767,44,KR
2020-03-07,367,6,7134,50,KR
2020-03-08,248,1,7382,51,KR
2020-03-09,131,3,7513,54,KR
2020-03-10,242,6,7755,60,KR
2020-03-11,114,6,7869,66,KR
2020-03-12,110,1,7979,67,KR
2020-03-13,107,5,8086,72,KR
2020-03-14,76,3,8162,75,KR
2020-03-15,74,0,8236,75,KR
2020-03-16,84,6,8320,81,KR
2020-03-17,93,5,8413,86,KR
2020-03-18,152,5,8565,91,KR
2020-03-19,87,9,8652,100,KR
2020-03-20,147,3,8799,103,KR
2020-03-21,98,1,8897,104,KR
2020-03-22,64,9,8961,113,KR
2020-03-23,76,7,9037,120,KR
2020-03-24,100,6,9137,126,KR
2020-03-25,104,5,9241,131,KR
2020-03-26,91,8,9332,139,KR
2020-03-27,146,5,9478,144,KR
2020-03-28,105,8,9583,152,KR
2020-03-29,78,6,9661,158,KR
2020-03-30,125,5,9786,163,KR
2020-03-31,0,0,9786,163,KR
2020-04-01,190,6,9976,169,KR
2020-04-02,86,5,10062,174,KR
2020-04-03,94,3,10156,177,KR
2020-04-04,81,6,10237,183,KR
2020-04-05,47,3,10284,186,KR
2020-04-06,47,6,10331,192,KR
2020-04-07,53,8,10384,200,KR
2020-04-08,39,4,10423,204,KR
2020-04-09,27,4,10450,208,KR
2020-04-10,0,0,10450,208,KR
2020-04-11,62,6,10512,214,KR
2020-04-12,25,3,10537,217,KR
2020-04-13,27,5,10564,222,KR
2020-04-14,27,3,10591,225,KR
2020-04-15,22,4,10613,229,KR
2020-04-16,22,1,10635,230,KR
2020-04-17,18,2,10653,232,KR
2020-04-18,8,2,10661,234,KR
2020-04-19,13,2,10674,236,KR
2020-04-20,9,1,10683,237,KR
2020-04-21,11,1,10694,238,KR
2020-04-22,8,2,10702,240,KR
2020-04-23,6,0,10708,240,KR
2020-04-24,10,0,10718,240,KR
2020-04-25,10,2,10728,242,KR
2020-04-26,10,1,10738,243,KR
2020-04-27,14,1,10752,244,KR
2020-04-28,9,2,10761,246,KR
2020-04-29,4,1,10765,247,KR
2020-04-30,9,1,10774,248,KR
2020-05-01,6,2,10780,250,KR
2020-05-02,13,0,10793,250,KR
2020-05-03,8,2,10801,252,KR
2020-05-04,3,2,10804,254,KR
2020-05-05,2,1,10806,255,KR
2020-05-06,4,1,10810,256,KR
2020-05-07,12,0,10822,256,KR
2020-05-08,18,0,10840,256,KR
2020-05-09,34,0,10874,256,KR
2020-05-10,35,0,10909,256,KR
2020-05-11,27,2,10936,258,KR
2020-05-12,26,1,10962,259,KR
2020-05-13,29,1,10991,260,KR
2020-05-14,27,0,11018,260,KR
2020-05-15,19,2,11037,262,KR
2020-05-16,13,0,11050,262,KR
2020-05-17,15,1,11065,263,KR
2020-05-18,13,0,11078,263,KR
2020-05-19,32,0,11110,263,KR
2020-05-20,12,1,11122,264,KR
2020-05-21,20,0,11142,264,KR
2020-05-22,23,2,11165,266,KR
2020-05-23,25,0,11190,266,KR
2020-05-24,16,1,11206,267,KR
2020-05-25,19,2,11225,269,KR
2020-05-26,40,0,11265,269,KR
2020-05-27,79,0,11344,269,KR
2020-05-28,58,0,11402,269,KR
2020-05-29,39,0,11441,269,KR
2020-05-30,27,1,11468,270,KR
2020-05-31,35,1,11503,271,KR
2020-06-01,38,1,11541,272,KR
2020-06-02,49,1,11590,273,KR
2020-06-03,39,0,11629,273,KR
2020-06-04,39,0,11668,273,KR
2020-06-05,51,0,11719,273,KR
2020-06-06,57,0,11776,273,KR
2020-06-07,38,0,11814,273,KR
2020-06-08,38,1,11852,274,KR
2020-06-09,50,2,11902,276,KR
2020-06-10,45,0,11947,276,KR
2020-06-11,56,1,12003,277,KR
2020-06-12,48,0,12051,277,KR
2020-06-13,33,0,12084,277,KR
2020-06-14,37,0,12121,277,KR
2020-06-15,34,1,12155,278,KR
2020-06-16,43,1,12198,279,KR
2020-06-17,59,1,12257,280,KR
2020-06-18,49,0,12306,280,KR
2020-06-19,67,0,12373,280,KR
2020-06-20,48,0,12421,280,KR
2020-06-21,17,0,12438,280,KR
2020-06-22,46,1,12484,281,KR
2020-06-23,51,0,12535,281,KR
2020-06-24,28,1,12563,282,KR
2020-06-25,39,0,12602,282,KR
2020-06-26,51,0,12653,282,KR
2019-12-30,0,0,0,0,KW
2019-12-31,0,0,0,0,KW
2020-01-01,0,0,0,0,KW
2020-01-02,0,0,0,0,KW
2020-01-03,0,0,0,0,KW
2020-01-04,0,0,0,0,KW
2020-01-05,0,0,0,0,KW
2020-01-06,0,0,0,0,KW
2020-01-07,0,0,0,0,KW
2020-01-08,0,0,0,0,KW
2020-01-09,0,0,0,0,KW
2020-01-10,0,0,0,0,KW
2020-01-11,0,0,0,0,KW
2020-01-12,0,0,0,0,KW
2020-01-13,0,0,0,0,KW
2020-01-14,0,0,0,0,KW
2020-01-15,0,0,0,0,KW
2020-01-16,0,0,0,0,KW
2020-01-17,0,0,0,0,KW
2020-01-18,0,0,0,0,KW
2020-01-19,0,0,0,0,KW
2020-01-20,0,0,0,0,KW
2020-01-21,0,0,0,0,KW
2020-01-22,0,0,0,0,KW
2020-01-23,0,0,0,0,KW
2020-01-24,0,0,0,0,KW
2020-01-25,0,0,0,0,KW
2020-01-26,0,0,0,0,KW
2020-01-27,0,0,0,0,KW
2020-01-28,0,0,0,0,KW
2020-01-29,0,0,0,0,KW
2020-01-30,0,0,0,0,KW
2020-01-31,0,0,0,0,KW
2020-02-01,0,0,0,0,KW
2020-02-02,0,0,0,0,KW
2020-02-03,0,0,0,0,KW
2020-02-04,0,0,0,0,KW
2020-02-05,0,0,0,0,KW
2020-02-06,0,0,0,0,KW
2020-02-07,0,0,0,0,KW
2020-02-08,0,0,0,0,KW
2020-02-09,0,0,0,0,KW
2020-02-10,0,0,0,0,KW
2020-02-11,0,0,0,0,KW
2020-02-12,0,0,0,0,KW
2020-02-13,0,0,0,0,KW
2020-02-14,0,0,0,0,KW
2020-02-15,0,0,0,0,KW
2020-02-16,0,0,0,0,KW
2020-02-17,0,0,0,0,KW
2020-02-18,0,0,0,0,KW
2020-02-19,0,0,0,0,KW
2020-02-20,0,0,0,0,KW
2020-02-21,0,0,0,0,KW
2020-02-22,0,0,0,0,KW
2020-02-23,3,0,3,0,KW
2020-02-24,2,0,5,0,KW
2020-02-25,6,0,11,0,KW
2020-02-26,15,0,26,0,KW
2020-02-27,17,0,43,0,KW
2020-02-28,2,0,45,0,KW
2020-02-29,0,0,45,0,KW
2020-03-01,1,0,46,0,KW
2020-03-02,10,0,56,0,KW
2020-03-05,2,0,58,0,KW
2020-03-07,3,0,61,0,KW
2020-03-08,3,0,64,0,KW
2020-03-09,1,0,65,0,KW
2020-03-10,4,0,69,0,KW
2020-03-11,3,0,72,0,KW
2020-03-12,8,0,80,0,KW
2020-03-13,20,0,100,0,KW
2020-03-14,4,0,104,0,KW
2020-03-15,8,0,112,0,KW
2020-03-16,11,0,123,0,KW
2020-03-17,7,0,130,0,KW
2020-03-18,12,0,142,0,KW
2020-03-19,6,0,148,0,KW
2020-03-20,11,0,159,0,KW
2020-03-21,17,0,176,0,KW
2020-03-22,12,0,188,0,KW
2020-03-23,1,0,189,0,KW
2020-03-24,2,0,191,0,KW
2020-03-25,4,0,195,0,KW
2020-03-26,13,0,208,0,KW
2020-03-27,17,0,225,0,KW
2020-03-28,10,0,235,0,KW
2020-03-29,20,0,255,0,KW
2020-03-30,11,0,266,0,KW
2020-03-31,23,0,289,0,KW
2020-04-01,28,0,317,0,KW
2020-04-02,25,0,342,0,KW
2020-04-03,0,0,342,0,KW
2020-04-04,137,1,479,1,KW
2020-04-05,77,0,556,1,KW
2020-04-06,109,0,665,1,KW
2020-04-07,78,0,743,1,KW
2020-04-08,112,0,855,1,KW
2020-04-09,55,0,910,1,KW
2020-04-10,83,0,993,1,KW
2020-04-11,161,0,1154,1,KW
2020-04-12,80,0,1234,1,KW
2020-04-13,66,1,1300,2,KW
2020-04-14,55,1,1355,3,KW
2020-04-15,50,0,1405,3,KW
2020-04-16,119,0,1524,3,KW
2020-04-17,134,2,1658,5,KW
2020-04-18,94,1,1752,6,KW
2020-04-19,163,1,1915,7,KW
2020-04-20,80,2,1995,9,KW
2020-04-21,85,2,2080,11,KW
2020-04-22,168,2,2248,13,KW
2020-04-23,151,1,2399,14,KW
2020-04-24,215,1,2614,15,KW
2020-04-25,278,4,2892,19,KW
2020-04-26,183,1,3075,20,KW
2020-04-27,213,2,3288,22,KW
2020-04-28,152,1,3440,23,KW
2020-04-29,300,1,3740,24,KW
2020-04-30,284,2,4024,26,KW
2020-05-01,353,4,4377,30,KW
2020-05-02,242,3,4619,33,KW
2020-05-03,364,5,4983,38,KW
2020-05-04,295,2,5278,40,KW
2020-05-05,526,0,5804,40,KW
2020-05-06,485,2,6289,42,KW
2020-05-07,278,2,6567,44,KW
2020-05-08,641,3,7208,47,KW
2020-05-09,415,2,7623,49,KW
2020-05-10,1065,9,8688,58,KW
2020-05-11,598,7,9286,65,KW
2020-05-12,991,10,10277,75,KW
2020-05-13,751,7,11028,82,KW
2020-05-14,947,6,11975,88,KW
2020-05-15,885,8,12860,96,KW
2020-05-16,942,11,13802,107,KW
2020-05-17,1048,5,14850,112,KW
2020-05-18,841,6,15691,118,KW
2020-05-19,1073,3,16764,121,KW
2020-05-20,804,3,17568,124,KW
2020-05-21,1041,5,18609,129,KW
2020-05-22,955,9,19564,138,KW
2020-05-23,900,10,20464,148,KW
2020-05-24,838,8,21302,156,KW
2020-05-25,665,9,21967,165,KW
2020-05-26,608,7,22575,172,KW
2020-05-27,692,3,23267,175,KW
2020-05-28,845,10,24112,185,KW
2020-05-29,1072,9,25184,194,KW
2020-05-30,1008,11,26192,205,KW
2020-05-31,851,7,27043,212,KW
2020-06-01,719,8,27762,220,KW
2020-06-02,887,6,28649,226,KW
2020-06-03,710,4,29359,230,KW
2020-06-04,562,6,29921,236,KW
2020-06-05,723,8,30644,244,KW
2020-06-06,487,10,31131,254,KW
2020-06-07,717,10,31848,264,KW
2020-06-08,662,5,32510,269,KW
2020-06-09,630,4,33140,273,KW
2020-06-10,683,2,33823,275,KW
2020-06-11,609,4,34432,279,KW
2020-06-12,520,6,34952,285,KW
2020-06-13,514,4,35466,289,KW
2020-06-14,454,7,35920,296,KW
2020-06-15,511,2,36431,298,KW
2020-06-16,527,5,36958,303,KW
2020-06-17,575,3,37533,306,KW
2020-06-18,541,2,38074,308,KW
2020-06-19,604,5,38678,313,KW
2020-06-20,467,6,39145,319,KW
2020-06-21,505,7,39650,326,KW
2020-06-22,641,4,40291,330,KW
2020-06-23,742,4,41033,334,KW
2020-06-24,846,3,41879,337,KW
2020-06-25,909,2,42788,339,KW
2020-06-26,915,2,43703,341,KW
2020-03-19,1,0,1,0,KY
2020-03-20,2,1,3,1,KY
2020-03-21,0,0,3,1,KY
2020-03-22,0,0,3,1,KY
2020-03-23,0,0,3,1,KY
2020-03-24,0,0,3,1,KY
2020-03-25,0,0,3,1,KY
2020-03-26,3,0,6,1,KY
2020-03-27,2,0,8,1,KY
2020-03-28,0,0,8,1,KY
2020-03-29,0,0,8,1,KY
2020-03-30,4,0,12,1,KY
2020-03-31,2,0,14,1,KY
2020-04-01,8,0,22,1,KY
2020-04-02,6,0,28,1,KY
2020-04-03,1,0,29,1,KY
2020-04-04,6,0,35,1,KY
2020-04-05,4,0,39,1,KY
2020-04-06,0,0,39,1,KY
2020-04-07,6,0,45,1,KY
2020-04-08,0,0,45,1,KY
2020-04-09,0,0,45,1,KY
2020-04-10,0,0,45,1,KY
2020-04-11,8,0,53,1,KY
2020-04-12,0,0,53,1,KY
2020-04-13,0,0,53,1,KY
2020-04-14,1,0,54,1,KY
2020-04-15,6,0,60,1,KY
2020-04-16,1,0,61,1,KY
2020-04-17,0,0,61,1,KY
2020-04-18,0,0,61,1,KY
2020-04-19,0,0,61,1,KY
2020-04-20,5,0,66,1,KY
2020-04-21,0,0,66,1,KY
2020-04-22,0,0,66,1,KY
2020-04-23,0,0,66,1,KY
2020-04-24,0,0,66,1,KY
2020-04-25,4,0,70,1,KY
2020-04-26,0,0,70,1,KY
2020-04-27,0,0,70,1,KY
2020-04-28,0,0,70,1,KY
2020-04-29,3,0,73,1,KY
2020-04-30,0,0,73,1,KY
2020-05-01,1,0,74,1,KY
2020-05-02,0,0,74,1,KY
2020-05-03,0,0,74,1,KY
2020-05-04,1,0,75,1,KY
2020-05-05,0,0,75,1,KY
2020-05-06,3,0,78,1,KY
2020-05-07,0,0,78,1,KY
2020-05-08,3,0,81,1,KY
2020-05-09,0,0,81,1,KY
2020-05-10,0,0,81,1,KY
2020-05-11,3,0,84,1,KY
2020-05-12,1,0,85,1,KY
2020-05-13,0,0,85,1,KY
2020-05-14,8,0,93,1,KY
2020-05-15,0,0,93,1,KY
2020-05-16,1,0,94,1,KY
2020-05-17,0,0,94,1,KY
2020-05-18,0,0,94,1,KY
2020-05-19,17,0,111,1,KY
2020-05-20,0,0,111,1,KY
2020-05-21,0,0,111,1,KY
2020-05-22,10,0,121,1,KY
2020-05-23,8,0,129,1,KY
2020-05-24,0,0,129,1,KY
2020-05-25,5,0,134,1,KY
2020-05-26,3,0,137,1,KY
2020-05-27,3,0,140,1,KY
2020-05-28,0,0,140,1,KY
2020-05-29,1,0,141,1,KY
2020-05-30,0,0,141,1,KY
2020-05-31,0,0,141,1,KY
2020-06-01,9,0,150,1,KY
2020-06-02,1,0,151,1,KY
2020-06-03,5,0,156,1,KY
2020-06-04,4,0,160,1,KY
2020-06-05,4,0,164,1,KY
2020-06-06,0,0,164,1,KY
2020-06-07,0,0,164,1,KY
2020-06-08,7,0,171,1,KY
2020-06-09,5,0,176,1,KY
2020-06-10,4,0,180,1,KY
2020-06-11,0,0,180,1,KY
2020-06-12,7,0,187,1,KY
2020-06-13,0,0,187,1,KY
2020-06-14,0,0,187,1,KY
2020-06-15,0,0,187,1,KY
2020-06-16,6,0,193,1,KY
2020-06-17,0,0,193,1,KY
2020-06-18,0,0,193,1,KY
2020-06-19,2,0,195,1,KY
2020-06-20,0,0,195,1,KY
2020-06-21,0,0,195,1,KY
2020-06-22,0,0,195,1,KY
2020-06-23,0,0,195,1,KY
2020-06-24,1,0,196,1,KY
2020-06-25,0,0,196,1,KY
2020-06-26,0,0,196,1,KY
2020-03-14,6,0,6,0,KZ
2020-03-15,3,0,9,0,KZ
2020-03-16,2,0,11,0,KZ
2020-03-17,22,0,33,0,KZ
2020-03-18,4,0,37,0,KZ
2020-03-19,12,0,49,0,KZ
2020-03-20,4,0,53,0,KZ
2020-03-21,3,0,56,0,KZ
2020-03-22,4,0,60,0,KZ
2020-03-23,2,0,62,0,KZ
2020-03-24,17,0,79,0,KZ
2020-03-25,9,0,88,0,KZ
2020-03-26,32,0,120,0,KZ
2020-03-27,73,0,193,0,KZ
2020-03-28,36,0,229,0,KZ
2020-03-29,55,1,284,1,KZ
2020-03-30,41,0,325,1,KZ
2020-03-31,15,0,340,1,KZ
2020-04-01,8,1,348,2,KZ
2020-04-02,38,1,386,3,KZ
2020-04-03,74,0,460,3,KZ
2020-04-04,0,0,460,3,KZ
2020-04-05,71,2,531,5,KZ
2020-04-06,139,1,670,6,KZ
2020-04-07,34,0,704,6,KZ
2020-04-08,55,1,759,7,KZ
2020-04-09,43,2,802,9,KZ
2020-04-10,38,1,840,10,KZ
2020-04-11,40,0,880,10,KZ
2020-04-12,81,0,961,10,KZ
2020-04-13,218,4,1179,14,KZ
2020-04-14,88,0,1267,14,KZ
2020-04-15,64,2,1331,16,KZ
2020-04-16,139,1,1470,17,KZ
2020-04-17,121,0,1591,17,KZ
2020-04-18,63,0,1654,17,KZ
2020-04-19,81,2,1735,19,KZ
2020-04-20,214,0,1949,19,KZ
2020-04-21,76,0,2025,19,KZ
2020-04-22,166,0,2191,19,KZ
2020-04-23,143,3,2334,22,KZ
2020-04-24,148,3,2482,25,KZ
2020-04-25,170,0,2652,25,KZ
2020-04-26,65,0,2717,25,KZ
2020-04-27,143,0,2860,25,KZ
2020-04-28,203,0,3063,25,KZ
2020-04-29,142,0,3205,25,KZ
2020-04-30,299,0,3504,25,KZ
2020-05-01,167,0,3671,25,KZ
2020-05-02,206,0,3877,25,KZ
2020-05-03,87,2,3964,27,KZ
2020-05-04,157,2,4121,29,KZ
2020-05-05,156,0,4277,29,KZ
2020-05-06,225,1,4502,30,KZ
2020-05-07,188,1,4690,31,KZ
2020-05-08,144,0,4834,31,KZ
2020-05-09,202,0,5036,31,KZ
2020-05-10,90,0,5126,31,KZ
2020-05-11,114,1,5240,32,KZ
2020-05-12,177,0,5417,32,KZ
2020-05-13,154,0,5571,32,KZ
2020-05-14,0,0,5571,32,KZ
2020-05-15,279,2,5850,34,KZ
2020-05-16,307,0,6157,34,KZ
2020-05-17,283,0,6440,34,KZ
2020-05-18,311,1,6751,35,KZ
2020-05-19,218,0,6969,35,KZ
2020-05-20,265,0,7234,35,KZ
2020-05-21,363,0,7597,35,KZ
2020-05-22,322,0,7919,35,KZ
2020-05-23,403,0,8322,35,KZ
2020-05-24,209,0,8531,35,KZ
2020-05-25,438,0,8969,35,KZ
2020-05-26,335,2,9304,37,KZ
2020-05-27,272,0,9576,37,KZ
2020-05-28,356,0,9932,37,KZ
2020-05-29,450,0,10382,37,KZ
2020-05-30,476,1,10858,38,KZ
2020-05-31,450,3,11308,41,KZ
2020-06-01,263,0,11571,41,KZ
2020-06-02,225,3,11796,44,KZ
2020-06-03,271,4,12067,48,KZ
2020-06-04,245,4,12312,52,KZ
2020-06-05,199,0,12511,52,KZ
2020-06-06,183,1,12694,53,KZ
2020-06-07,165,3,12859,56,KZ
2020-06-08,215,2,13074,58,KZ
2020-06-09,245,3,13319,61,KZ
2020-06-10,239,6,13558,67,KZ
2020-06-11,314,0,13872,67,KZ
2020-06-12,366,3,14238,70,KZ
2020-06-13,258,3,14496,73,KZ
2020-06-14,313,4,14809,77,KZ
2020-06-15,383,4,15192,81,KZ
2020-06-16,350,7,15542,88,KZ
2020-06-17,335,12,15877,100,KZ
2020-06-18,474,5,16351,105,KZ
2020-06-19,428,8,16779,113,KZ
2020-06-20,446,5,17225,118,KZ
2020-06-21,507,2,17732,120,KZ
2020-06-22,499,7,18231,127,KZ
2020-06-23,534,7,18765,134,KZ
2020-06-24,520,2,19285,136,KZ
2020-06-25,465,11,19750,147,KZ
2020-06-26,569,3,20319,150,KZ
2020-03-24,2,0,2,0,LA
2020-03-25,0,0,2,0,LA
2020-03-26,4,0,6,0,LA
2020-03-27,0,0,6,0,LA
2020-03-28,0,0,6,0,LA
2020-03-29,0,0,6,0,LA
2020-03-30,3,0,9,0,LA
2020-03-31,0,0,9,0,LA
2020-04-01,1,0,10,0,LA
2020-04-02,0,0,10,0,LA
2020-04-03,0,0,10,0,LA
2020-04-04,0,0,10,0,LA
2020-04-05,1,0,11,0,LA
2020-04-06,1,0,12,0,LA
2020-04-07,0,0,12,0,LA
2020-04-08,3,0,15,0,LA
2020-04-09,1,0,16,0,LA
2020-04-10,0,0,16,0,LA
2020-04-11,2,0,18,0,LA
2020-04-12,1,0,19,0,LA
2020-04-13,0,0,19,0,LA
2020-04-14,0,0,19,0,LA
2020-04-15,0,0,19,0,LA
2020-04-16,0,0,19,0,LA
2020-04-17,0,0,19,0,LA
2020-04-18,0,0,19,0,LA
2020-04-19,0,0,19,0,LA
2020-04-20,0,0,19,0,LA
2020-04-21,0,0,19,0,LA
2020-04-22,0,0,19,0,LA
2020-04-23,0,0,19,0,LA
2020-04-24,0,0,19,0,LA
2020-04-25,0,0,19,0,LA
2020-04-26,0,0,19,0,LA
2020-04-27,0,0,19,0,LA
2020-04-28,0,0,19,0,LA
2020-04-29,0,0,19,0,LA
2020-04-30,0,0,19,0,LA
2020-05-01,0,0,19,0,LA
2020-05-02,0,0,19,0,LA
2020-05-03,0,0,19,0,LA
2020-05-04,0,0,19,0,LA
2020-05-05,0,0,19,0,LA
2020-05-06,0,0,19,0,LA
2020-05-07,0,0,19,0,LA
2020-05-08,0,0,19,0,LA
2020-05-09,0,0,19,0,LA
2020-05-10,0,0,19,0,LA
2020-05-11,0,0,19,0,LA
2020-05-12,0,0,19,0,LA
2020-05-13,0,0,19,0,LA
2020-05-14,0,0,19,0,LA
2020-05-15,0,0,19,0,LA
2020-05-16,0,0,19,0,LA
2020-05-17,0,0,19,0,LA
2020-05-18,0,0,19,0,LA
2020-05-19,0,0,19,0,LA
2020-05-20,0,0,19,0,LA
2020-05-21,0,0,19,0,LA
2020-05-22,0,0,19,0,LA
2020-05-23,0,0,19,0,LA
2020-05-24,0,0,19,0,LA
2020-05-25,0,0,19,0,LA
2020-05-26,0,0,19,0,LA
2020-05-27,0,0,19,0,LA
2020-05-28,0,0,19,0,LA
2020-05-29,0,0,19,0,LA
2020-05-30,0,0,19,0,LA
2020-05-31,0,0,19,0,LA
2020-06-01,0,0,19,0,LA
2020-06-02,0,0,19,0,LA
2020-06-03,0,0,19,0,LA
2020-06-04,0,0,19,0,LA
2020-06-05,0,0,19,0,LA
2020-06-06,0,0,19,0,LA
2020-06-07,0,0,19,0,LA
2020-06-08,0,0,19,0,LA
2020-06-09,0,0,19,0,LA
2020-06-10,0,0,19,0,LA
2020-06-11,0,0,19,0,LA
2020-06-12,0,0,19,0,LA
2020-06-13,0,0,19,0,LA
2020-06-14,0,0,19,0,LA
2020-06-15,0,0,19,0,LA
2020-06-16,0,0,19,0,LA
2020-06-17,0,0,19,0,LA
2020-06-18,0,0,19,0,LA
2020-06-19,0,0,19,0,LA
2020-06-20,0,0,19,0,LA
2020-06-21,0,0,19,0,LA
2020-06-22,0,0,19,0,LA
2020-06-23,0,0,19,0,LA
2020-06-24,0,0,19,0,LA
2020-06-25,0,0,19,0,LA
2020-06-26,0,0,19,0,LA
2019-12-30,0,0,0,0,LB
2019-12-31,0,0,0,0,LB
2020-01-01,0,0,0,0,LB
2020-01-02,0,0,0,0,LB
2020-01-03,0,0,0,0,LB
2020-01-04,0,0,0,0,LB
2020-01-05,0,0,0,0,LB
2020-01-06,0,0,0,0,LB
2020-01-07,0,0,0,0,LB
2020-01-08,0,0,0,0,LB
2020-01-09,0,0,0,0,LB
2020-01-10,0,0,0,0,LB
2020-01-11,0,0,0,0,LB
2020-01-12,0,0,0,0,LB
2020-01-13,0,0,0,0,LB
2020-01-14,0,0,0,0,LB
2020-01-15,0,0,0,0,LB
2020-01-16,0,0,0,0,LB
2020-01-17,0,0,0,0,LB
2020-01-18,0,0,0,0,LB
2020-01-19,0,0,0,0,LB
2020-01-20,0,0,0,0,LB
2020-01-21,0,0,0,0,LB
2020-01-22,0,0,0,0,LB
2020-01-23,0,0,0,0,LB
2020-01-24,0,0,0,0,LB
2020-01-25,0,0,0,0,LB
2020-01-26,0,0,0,0,LB
2020-01-27,0,0,0,0,LB
2020-01-28,0,0,0,0,LB
2020-01-29,0,0,0,0,LB
2020-01-30,0,0,0,0,LB
2020-01-31,0,0,0,0,LB
2020-02-01,0,0,0,0,LB
2020-02-02,0,0,0,0,LB
2020-02-03,0,0,0,0,LB
2020-02-04,0,0,0,0,LB
2020-02-05,0,0,0,0,LB
2020-02-06,0,0,0,0,LB
2020-02-07,0,0,0,0,LB
2020-02-08,0,0,0,0,LB
2020-02-09,0,0,0,0,LB
2020-02-10,0,0,0,0,LB
2020-02-11,0,0,0,0,LB
2020-02-12,0,0,0,0,LB
2020-02-13,0,0,0,0,LB
2020-02-14,0,0,0,0,LB
2020-02-15,0,0,0,0,LB
2020-02-16,0,0,0,0,LB
2020-02-17,0,0,0,0,LB
2020-02-18,0,0,0,0,LB
2020-02-19,0,0,0,0,LB
2020-02-20,0,0,0,0,LB
2020-02-21,1,0,1,0,LB
2020-02-22,0,0,1,0,LB
2020-02-23,0,0,1,0,LB
2020-02-24,0,0,1,0,LB
2020-02-25,0,0,1,0,LB
2020-02-26,1,0,2,0,LB
2020-02-27,1,0,3,0,LB
2020-02-28,0,0,3,0,LB
2020-02-29,1,0,4,0,LB
2020-03-01,6,0,10,0,LB
2020-03-02,3,0,13,0,LB
2020-03-05,3,0,16,0,LB
2020-03-06,6,0,22,0,LB
2020-03-08,10,0,32,0,LB
2020-03-09,9,0,41,0,LB
2020-03-10,0,1,41,1,LB
2020-03-11,20,1,61,2,LB
2020-03-12,5,0,66,2,LB
2020-03-14,27,1,93,3,LB
2020-03-15,6,0,99,3,LB
2020-03-16,21,0,120,3,LB
2020-03-17,0,0,120,3,LB
2020-03-18,13,1,133,4,LB
2020-03-19,16,0,149,4,LB
2020-03-20,14,0,163,4,LB
2020-03-21,67,0,230,4,LB
2020-03-22,18,0,248,4,LB
2020-03-23,19,0,267,4,LB
2020-03-24,37,0,304,4,LB
2020-03-25,29,0,333,4,LB
2020-03-26,35,2,368,6,LB
2020-03-27,23,1,391,7,LB
2020-03-28,21,1,412,8,LB
2020-03-29,26,2,438,10,LB
2020-03-30,8,1,446,11,LB
2020-03-31,17,1,463,12,LB
2020-04-01,16,0,479,12,LB
2020-04-02,15,4,494,16,LB
2020-04-03,0,0,494,16,LB
2020-04-04,26,1,520,17,LB
2020-04-05,7,1,527,18,LB
2020-04-06,14,1,541,19,LB
2020-04-07,7,0,548,19,LB
2020-04-08,27,0,575,19,LB
2020-04-09,7,0,582,19,LB
2020-04-10,27,1,609,20,LB
2020-04-11,10,0,619,20,LB
2020-04-12,11,0,630,20,LB
2020-04-13,2,0,632,20,LB
2020-04-14,9,1,641,21,LB
2020-04-15,17,0,658,21,LB
2020-04-16,5,0,663,21,LB
2020-04-17,5,0,668,21,LB
2020-04-18,4,0,672,21,LB
2020-04-19,1,0,673,21,LB
2020-04-20,4,0,677,21,LB
2020-04-21,0,0,677,21,LB
2020-04-22,5,1,682,22,LB
2020-04-23,6,0,688,22,LB
2020-04-24,8,0,696,22,LB
2020-04-25,8,2,704,24,LB
2020-04-26,3,0,707,24,LB
2020-04-27,3,0,710,24,LB
2020-04-28,7,0,717,24,LB
2020-04-29,4,0,721,24,LB
2020-04-30,4,0,725,24,LB
2020-05-01,4,0,729,24,LB
2020-05-02,4,1,733,25,LB
2020-05-03,4,0,737,25,LB
2020-05-04,3,0,740,25,LB
2020-05-05,1,0,741,25,LB
2020-05-06,9,0,750,25,LB
2020-05-07,34,0,784,25,LB
2020-05-08,12,1,796,26,LB
2020-05-09,13,0,809,26,LB
2020-05-10,36,0,845,26,LB
2020-05-11,14,0,859,26,LB
2020-05-12,11,0,870,26,LB
2020-05-13,8,0,878,26,LB
2020-05-14,8,0,886,26,LB
2020-05-15,5,0,891,26,LB
2020-05-16,11,0,902,26,LB
2020-05-17,9,0,911,26,LB
2020-05-18,20,0,931,26,LB
2020-05-19,23,0,954,26,LB
2020-05-20,7,0,961,26,LB
2020-05-21,63,0,1024,26,LB
2020-05-22,62,0,1086,26,LB
2020-05-23,11,0,1097,26,LB
2020-05-24,17,0,1114,26,LB
2020-05-25,5,0,1119,26,LB
2020-05-26,21,0,1140,26,LB
2020-05-27,21,0,1161,26,LB
2020-05-28,7,0,1168,26,LB
2020-05-29,4,0,1172,26,LB
2020-05-30,19,0,1191,26,LB
2020-05-31,29,1,1220,27,LB
2020-06-01,13,0,1233,27,LB
2020-06-02,9,0,1242,27,LB
2020-06-03,14,0,1256,27,LB
2020-06-04,50,1,1306,28,LB
2020-06-05,6,0,1312,28,LB
2020-06-06,8,1,1320,29,LB
2020-06-07,11,1,1331,30,LB
2020-06-08,19,0,1350,30,LB
2020-06-09,18,0,1368,30,LB
2020-06-10,20,0,1388,30,LB
2020-06-11,14,1,1402,31,LB
2020-06-12,20,0,1422,31,LB
2020-06-13,20,1,1442,32,LB
2020-06-14,4,0,1446,32,LB
2020-06-15,18,0,1464,32,LB
2020-06-16,9,0,1473,32,LB
2020-06-17,16,0,1489,32,LB
2020-06-18,6,0,1495,32,LB
2020-06-19,15,0,1510,32,LB
2020-06-20,26,0,1536,32,LB
2020-06-21,51,0,1587,32,LB
2020-06-22,16,0,1603,32,LB
2020-06-23,19,0,1622,32,LB
2020-06-24,22,1,1644,33,LB
2020-06-25,18,0,1662,33,LB
2020-06-26,35,0,1697,33,LB
2020-03-14,2,0,2,0,LC
2020-03-15,0,0,2,0,LC
2020-03-16,0,0,2,0,LC
2020-03-17,0,0,2,0,LC
2020-03-18,0,0,2,0,LC
2020-03-19,0,0,2,0,LC
2020-03-20,0,0,2,0,LC
2020-03-21,0,0,2,0,LC
2020-03-22,0,0,2,0,LC
2020-03-23,0,0,2,0,LC
2020-03-24,0,0,2,0,LC
2020-03-25,1,0,3,0,LC
2020-03-26,0,0,3,0,LC
2020-03-27,0,0,3,0,LC
2020-03-28,1,0,4,0,LC
2020-03-29,5,0,9,0,LC
2020-03-30,0,0,9,0,LC
2020-03-31,4,0,13,0,LC
2020-04-01,0,0,13,0,LC
2020-04-02,0,0,13,0,LC
2020-04-03,0,0,13,0,LC
2020-04-04,1,0,14,0,LC
2020-04-05,0,0,14,0,LC
2020-04-06,0,0,14,0,LC
2020-04-07,0,0,14,0,LC
2020-04-08,0,0,14,0,LC
2020-04-09,0,0,14,0,LC
2020-04-10,1,0,15,0,LC
2020-04-11,0,0,15,0,LC
2020-04-12,0,0,15,0,LC
2020-04-13,0,0,15,0,LC
2020-04-14,0,0,15,0,LC
2020-04-15,0,0,15,0,LC
2020-04-16,0,0,15,0,LC
2020-04-17,0,0,15,0,LC
2020-04-18,0,0,15,0,LC
2020-04-19,0,0,15,0,LC
2020-04-20,0,0,15,0,LC
2020-04-21,0,0,15,0,LC
2020-04-22,0,0,15,0,LC
2020-04-23,0,0,15,0,LC
2020-04-24,0,0,15,0,LC
2020-04-25,0,0,15,0,LC
2020-04-26,0,0,15,0,LC
2020-04-27,0,0,15,0,LC
2020-04-28,0,0,15,0,LC
2020-04-29,2,0,17,0,LC
2020-04-30,0,0,17,0,LC
2020-05-01,0,0,17,0,LC
2020-05-02,0,0,17,0,LC
2020-05-03,1,0,18,0,LC
2020-05-04,0,0,18,0,LC
2020-05-05,0,0,18,0,LC
2020-05-06,0,0,18,0,LC
2020-05-07,0,0,18,0,LC
2020-05-08,0,0,18,0,LC
2020-05-09,0,0,18,0,LC
2020-05-10,0,0,18,0,LC
2020-05-11,0,0,18,0,LC
2020-05-12,0,0,18,0,LC
2020-05-13,0,0,18,0,LC
2020-05-14,0,0,18,0,LC
2020-05-15,0,0,18,0,LC
2020-05-16,0,0,18,0,LC
2020-05-17,0,0,18,0,LC
2020-05-18,0,0,18,0,LC
2020-05-19,0,0,18,0,LC
2020-05-20,0,0,18,0,LC
2020-05-21,0,0,18,0,LC
2020-05-22,0,0,18,0,LC
2020-05-23,0,0,18,0,LC
2020-05-24,0,0,18,0,LC
2020-05-25,0,0,18,0,LC
2020-05-26,0,0,18,0,LC
2020-05-27,0,0,18,0,LC
2020-05-28,0,0,18,0,LC
2020-05-29,0,0,18,0,LC
2020-05-30,0,0,18,0,LC
2020-05-31,0,0,18,0,LC
2020-06-01,0,0,18,0,LC
2020-06-02,0,0,18,0,LC
2020-06-03,0,0,18,0,LC
2020-06-04,1,0,19,0,LC
2020-06-05,0,0,19,0,LC
2020-06-06,0,0,19,0,LC
2020-06-07,0,0,19,0,LC
2020-06-08,0,0,19,0,LC
2020-06-09,0,0,19,0,LC
2020-06-10,0,0,19,0,LC
2020-06-11,0,0,19,0,LC
2020-06-12,0,0,19,0,LC
2020-06-13,0,0,19,0,LC
2020-06-14,0,0,19,0,LC
2020-06-15,0,0,19,0,LC
2020-06-16,0,0,19,0,LC
2020-06-17,0,0,19,0,LC
2020-06-18,0,0,19,0,LC
2020-06-19,0,0,19,0,LC
2020-06-20,0,0,19,0,LC
2020-06-21,0,0,19,0,LC
2020-06-22,0,0,19,0,LC
2020-06-23,0,0,19,0,LC
2020-06-24,0,0,19,0,LC
2020-06-25,0,0,19,0,LC
2020-06-26,0,0,19,0,LC
2020-03-04,1,0,1,0,LI
2020-03-11,2,0,3,0,LI
2020-03-12,1,0,4,0,LI
2020-03-13,0,0,4,0,LI
2020-03-14,0,0,4,0,LI
2020-03-15,3,0,7,0,LI
2020-03-16,0,0,7,0,LI
2020-03-17,0,0,7,0,LI
2020-03-18,18,0,25,0,LI
2020-03-19,0,0,25,0,LI
2020-03-20,9,0,34,0,LI
2020-03-21,2,0,36,0,LI
2020-03-22,10,0,46,0,LI
2020-03-23,0,0,46,0,LI
2020-03-24,1,0,47,0,LI
2020-03-25,4,0,51,0,LI
2020-03-26,5,0,56,0,LI
2020-03-27,4,0,60,0,LI
2020-03-28,1,0,61,0,LI
2020-03-29,1,0,62,0,LI
2020-03-30,2,0,64,0,LI
2020-03-31,4,0,68,0,LI
2020-04-01,4,0,72,0,LI
2020-04-02,3,0,75,0,LI
2020-04-03,0,0,75,0,LI
2020-04-04,2,1,77,1,LI
2020-04-05,1,0,78,1,LI
2020-04-06,0,0,78,1,LI
2020-04-07,0,0,78,1,LI
2020-04-08,1,0,79,1,LI
2020-04-09,0,0,79,1,LI
2020-04-10,1,0,80,1,LI
2020-04-11,0,0,80,1,LI
2020-04-12,0,0,80,1,LI
2020-04-13,1,0,81,1,LI
2020-04-14,0,0,81,1,LI
2020-04-15,0,0,81,1,LI
2020-04-16,0,0,81,1,LI
2020-04-17,0,0,81,1,LI
2020-04-18,1,0,82,1,LI
2020-04-19,0,0,82,1,LI
2020-04-20,0,0,82,1,LI
2020-04-21,0,0,82,1,LI
2020-04-22,0,0,82,1,LI
2020-04-23,0,0,82,1,LI
2020-04-24,0,0,82,1,LI
2020-04-25,1,0,83,1,LI
2020-04-26,0,0,83,1,LI
2020-04-27,0,0,83,1,LI
2020-04-28,0,0,83,1,LI
2020-04-29,0,0,83,1,LI
2020-04-30,0,0,83,1,LI
2020-05-01,0,0,83,1,LI
2020-05-02,0,0,83,1,LI
2020-05-03,0,0,83,1,LI
2020-05-04,0,0,83,1,LI
2020-05-05,0,0,83,1,LI
2020-05-06,0,0,83,1,LI
2020-05-07,0,0,83,1,LI
2020-05-08,0,0,83,1,LI
2020-05-09,0,0,83,1,LI
2020-05-10,0,0,83,1,LI
2020-05-11,0,0,83,1,LI
2020-05-12,0,0,83,1,LI
2020-05-13,0,0,83,1,LI
2020-05-14,0,0,83,1,LI
2020-05-15,0,0,83,1,LI
2020-05-16,0,0,83,1,LI
2020-05-17,0,0,83,1,LI
2020-05-18,0,0,83,1,LI
2020-05-19,0,0,83,1,LI
2020-05-20,0,0,83,1,LI
2020-05-21,0,0,83,1,LI
2020-05-22,0,0,83,1,LI
2020-05-23,0,0,83,1,LI
2020-05-24,0,0,83,1,LI
2020-05-25,0,0,83,1,LI
2020-05-26,0,0,83,1,LI
2020-05-27,0,0,83,1,LI
2020-05-28,0,0,83,1,LI
2020-05-29,0,0,83,1,LI
2020-05-30,0,0,83,1,LI
2020-05-31,0,0,83,1,LI
2020-06-01,0,0,83,1,LI
2020-06-02,0,0,83,1,LI
2020-06-03,0,0,83,1,LI
2020-06-04,0,0,83,1,LI
2020-06-05,0,0,83,1,LI
2020-06-06,0,0,83,1,LI
2020-06-07,0,0,83,1,LI
2020-06-08,0,0,83,1,LI
2020-06-09,0,0,83,1,LI
2020-06-10,0,0,83,1,LI
2020-06-11,0,0,83,1,LI
2020-06-12,0,0,83,1,LI
2020-06-13,0,0,83,1,LI
2020-06-14,0,0,83,1,LI
2020-06-15,0,0,83,1,LI
2020-06-16,0,0,83,1,LI
2020-06-17,0,0,83,1,LI
2020-06-18,0,0,83,1,LI
2020-06-19,0,0,83,1,LI
2020-06-20,0,0,83,1,LI
2020-06-21,0,0,83,1,LI
2020-06-22,0,0,83,1,LI
2020-06-23,0,0,83,1,LI
2020-06-24,0,0,83,1,LI
2020-06-25,0,0,83,1,LI
2020-06-26,0,0,83,1,LI
2019-12-30,0,0,0,0,LK
2019-12-31,0,0,0,0,LK
2020-01-01,0,0,0,0,LK
2020-01-02,0,0,0,0,LK
2020-01-03,0,0,0,0,LK
2020-01-04,0,0,0,0,LK
2020-01-05,0,0,0,0,LK
2020-01-06,0,0,0,0,LK
2020-01-07,0,0,0,0,LK
2020-01-08,0,0,0,0,LK
2020-01-09,0,0,0,0,LK
2020-01-10,0,0,0,0,LK
2020-01-11,0,0,0,0,LK
2020-01-12,0,0,0,0,LK
2020-01-13,0,0,0,0,LK
2020-01-14,0,0,0,0,LK
2020-01-15,0,0,0,0,LK
2020-01-16,0,0,0,0,LK
2020-01-17,0,0,0,0,LK
2020-01-18,0,0,0,0,LK
2020-01-19,0,0,0,0,LK
2020-01-20,0,0,0,0,LK
2020-01-21,0,0,0,0,LK
2020-01-22,0,0,0,0,LK
2020-01-23,0,0,0,0,LK
2020-01-24,0,0,0,0,LK
2020-01-25,0,0,0,0,LK
2020-01-26,0,0,0,0,LK
2020-01-27,1,0,1,0,LK
2020-01-28,0,0,1,0,LK
2020-01-29,0,0,1,0,LK
2020-01-30,0,0,1,0,LK
2020-01-31,0,0,1,0,LK
2020-02-01,0,0,1,0,LK
2020-02-02,0,0,1,0,LK
2020-02-03,0,0,1,0,LK
2020-02-04,0,0,1,0,LK
2020-02-05,0,0,1,0,LK
2020-02-06,0,0,1,0,LK
2020-02-07,0,0,1,0,LK
2020-02-08,0,0,1,0,LK
2020-02-09,0,0,1,0,LK
2020-02-10,0,0,1,0,LK
2020-02-11,0,0,1,0,LK
2020-02-12,0,0,1,0,LK
2020-02-13,0,0,1,0,LK
2020-02-14,0,0,1,0,LK
2020-02-15,0,0,1,0,LK
2020-02-16,0,0,1,0,LK
2020-02-17,0,0,1,0,LK
2020-02-18,0,0,1,0,LK
2020-02-19,0,0,1,0,LK
2020-02-20,0,0,1,0,LK
2020-02-21,0,0,1,0,LK
2020-02-22,0,0,1,0,LK
2020-02-23,0,0,1,0,LK
2020-02-24,0,0,1,0,LK
2020-02-25,0,0,1,0,LK
2020-02-26,0,0,1,0,LK
2020-02-27,0,0,1,0,LK
2020-02-28,0,0,1,0,LK
2020-02-29,0,0,1,0,LK
2020-03-01,0,0,1,0,LK
2020-03-11,1,0,2,0,LK
2020-03-12,1,0,3,0,LK
2020-03-13,3,0,6,0,LK
2020-03-14,5,0,11,0,LK
2020-03-15,8,0,19,0,LK
2020-03-16,10,0,29,0,LK
2020-03-17,13,0,42,0,LK
2020-03-18,0,0,42,0,LK
2020-03-19,11,0,53,0,LK
2020-03-20,13,0,66,0,LK
2020-03-21,12,0,78,0,LK
2020-03-22,9,0,87,0,LK
2020-03-23,10,0,97,0,LK
2020-03-24,5,0,102,0,LK
2020-03-25,0,0,102,0,LK
2020-03-26,4,0,106,0,LK
2020-03-27,0,0,106,0,LK
2020-03-28,9,1,115,1,LK
2020-03-29,5,0,120,1,LK
2020-03-30,0,0,120,1,LK
2020-03-31,2,1,122,2,LK
2020-04-01,21,0,143,2,LK
2020-04-02,5,1,148,3,LK
2020-04-03,3,1,151,4,LK
2020-04-04,8,1,159,5,LK
2020-04-05,7,0,166,5,LK
2020-04-06,12,0,178,5,LK
2020-04-07,7,1,185,6,LK
2020-04-08,4,1,189,7,LK
2020-04-09,1,0,190,7,LK
2020-04-10,7,0,197,7,LK
2020-04-11,2,0,199,7,LK
2020-04-12,11,0,210,7,LK
2020-04-13,8,0,218,7,LK
2020-04-14,15,0,233,7,LK
2020-04-15,4,0,237,7,LK
2020-04-16,1,0,238,7,LK
2020-04-17,6,0,244,7,LK
2020-04-18,10,0,254,7,LK
2020-04-19,41,0,295,7,LK
2020-04-20,9,0,304,7,LK
2020-04-21,6,0,310,7,LK
2020-04-22,20,0,330,7,LK
2020-04-23,38,0,368,7,LK
2020-04-24,52,0,420,7,LK
2020-04-25,42,0,462,7,LK
2020-04-26,61,0,523,7,LK
2020-04-27,65,0,588,7,LK
2020-04-28,31,0,619,7,LK
2020-04-29,30,0,649,7,LK
2020-04-30,16,0,665,7,LK
2020-05-01,25,0,690,7,LK
2020-05-02,15,0,705,7,LK
2020-05-03,13,0,718,7,LK
2020-05-04,37,1,755,8,LK
2020-05-05,16,1,771,9,LK
2020-05-06,26,0,797,9,LK
2020-05-07,27,0,824,9,LK
2020-05-08,11,0,835,9,LK
2020-05-09,12,0,847,9,LK
2020-05-10,16,0,863,9,LK
2020-05-11,6,0,869,9,LK
2020-05-12,20,0,889,9,LK
2020-05-13,26,0,915,9,LK
2020-05-14,10,0,925,9,LK
2020-05-15,10,0,935,9,LK
2020-05-16,25,0,960,9,LK
2020-05-17,21,0,981,9,LK
2020-05-18,11,0,992,9,LK
2020-05-19,35,0,1027,9,LK
2020-05-20,1,0,1028,9,LK
2020-05-21,27,0,1055,9,LK
2020-05-22,13,0,1068,9,LK
2020-05-23,21,0,1089,9,LK
2020-05-24,52,0,1141,9,LK
2020-05-25,41,1,1182,10,LK
2020-05-26,137,0,1319,10,LK
2020-05-27,150,0,1469,10,LK
2020-05-28,61,0,1530,10,LK
2020-05-29,28,0,1558,10,LK
2020-05-30,62,0,1620,10,LK
2020-05-31,13,0,1633,10,LK
2020-06-01,10,1,1643,11,LK
2020-06-02,40,0,1683,11,LK
2020-06-03,66,0,1749,11,LK
2020-06-04,48,0,1797,11,LK
2020-06-05,4,0,1801,11,LK
2020-06-06,13,0,1814,11,LK
2020-06-07,21,0,1835,11,LK
2020-06-08,22,0,1857,11,LK
2020-06-09,2,0,1859,11,LK
2020-06-10,10,0,1869,11,LK
2020-06-11,8,0,1877,11,LK
2020-06-12,3,0,1880,11,LK
2020-06-13,4,0,1884,11,LK
2020-06-14,5,0,1889,11,LK
2020-06-15,16,0,1905,11,LK
2020-06-16,10,0,1915,11,LK
2020-06-17,9,0,1924,11,LK
2020-06-18,23,0,1947,11,LK
2020-06-19,3,0,1950,11,LK
2020-06-20,0,0,1950,11,LK
2020-06-21,0,0,1950,11,LK
2020-06-22,1,0,1951,11,LK
2020-06-23,40,0,1991,11,LK
2020-06-24,10,0,2001,11,LK
2020-06-25,9,0,2010,11,LK
2020-06-26,4,0,2014,11,LK
2020-03-16,1,0,1,0,LR
2020-03-17,1,0,2,0,LR
2020-03-18,0,0,2,0,LR
2020-03-19,0,0,2,0,LR
2020-03-20,0,0,2,0,LR
2020-03-21,1,0,3,0,LR
2020-03-22,0,0,3,0,LR
2020-03-23,0,0,3,0,LR
2020-03-24,0,0,3,0,LR
2020-03-25,0,0,3,0,LR
2020-03-26,0,0,3,0,LR
2020-03-27,0,0,3,0,LR
2020-03-28,0,0,3,0,LR
2020-03-29,0,0,3,0,LR
2020-03-30,0,0,3,0,LR
2020-03-31,0,0,3,0,LR
2020-04-01,3,0,6,0,LR
2020-04-02,0,0,6,0,LR
2020-04-03,1,0,7,0,LR
2020-04-04,3,1,10,1,LR
2020-04-05,3,2,13,3,LR
2020-04-06,1,0,14,3,LR
2020-04-07,0,0,14,3,LR
2020-04-08,17,1,31,4,LR
2020-04-09,0,0,31,4,LR
2020-04-10,6,0,37,4,LR
2020-04-11,11,1,48,5,LR
2020-04-12,2,0,50,5,LR
2020-04-13,9,1,59,6,LR
2020-04-14,0,0,59,6,LR
2020-04-15,0,0,59,6,LR
2020-04-16,14,0,73,6,LR
2020-04-17,3,1,76,7,LR
2020-04-18,5,0,81,7,LR
2020-04-19,10,1,91,8,LR
2020-04-20,8,0,99,8,LR
2020-04-21,2,0,101,8,LR
2020-04-22,0,0,101,8,LR
2020-04-23,0,0,101,8,LR
2020-04-24,16,0,117,8,LR
2020-04-25,3,3,120,11,LR
2020-04-26,4,1,124,12,LR
2020-04-27,9,4,133,16,LR
2020-04-28,8,0,141,16,LR
2020-04-29,0,0,141,16,LR
2020-04-30,0,0,141,16,LR
2020-05-01,11,2,152,18,LR
2020-05-02,2,0,154,18,LR
2020-05-03,4,0,158,18,LR
2020-05-04,8,0,166,18,LR
2020-05-05,4,2,170,20,LR
2020-05-06,8,0,178,20,LR
2020-05-07,11,0,189,20,LR
2020-05-08,10,0,199,20,LR
2020-05-09,0,0,199,20,LR
2020-05-10,0,0,199,20,LR
2020-05-11,12,0,211,20,LR
2020-05-12,1,0,212,20,LR
2020-05-13,1,0,213,20,LR
2020-05-14,2,0,215,20,LR
2020-05-15,4,0,219,20,LR
2020-05-16,4,0,223,20,LR
2020-05-17,3,1,226,21,LR
2020-05-18,3,1,229,22,LR
2020-05-19,4,1,233,23,LR
2020-05-20,5,0,238,23,LR
2020-05-21,2,0,240,23,LR
2020-05-22,9,1,249,24,LR
2020-05-23,6,2,255,26,LR
2020-05-24,10,0,265,26,LR
2020-05-25,0,0,265,26,LR
2020-05-26,1,0,266,26,LR
2020-05-27,0,1,266,27,LR
2020-05-28,3,0,269,27,LR
2020-05-29,4,0,273,27,LR
2020-05-30,7,0,280,27,LR
2020-05-31,8,0,288,27,LR
2020-06-01,8,0,296,27,LR
2020-06-02,15,1,311,28,LR
2020-06-03,5,0,316,28,LR
2020-06-04,5,0,321,28,LR
2020-06-05,13,2,334,30,LR
2020-06-06,11,0,345,30,LR
2020-06-07,14,0,359,30,LR
2020-06-08,11,0,370,30,LR
2020-06-09,13,1,383,31,LR
2020-06-10,14,0,397,31,LR
2020-06-11,13,0,410,31,LR
2020-06-12,11,1,421,32,LR
2020-06-13,25,0,446,32,LR
2020-06-14,12,0,458,32,LR
2020-06-15,40,1,498,33,LR
2020-06-16,11,0,509,33,LR
2020-06-17,0,0,509,33,LR
2020-06-18,33,0,542,33,LR
2020-06-19,39,0,581,33,LR
2020-06-20,20,0,601,33,LR
2020-06-21,25,1,626,34,LR
2020-06-22,24,0,650,34,LR
2020-06-23,2,0,652,34,LR
2020-06-24,10,0,662,34,LR
2020-06-25,19,0,681,34,LR
2020-06-26,3,0,684,34,LR
2020-05-14,1,0,1,0,LS
2020-05-15,0,0,1,0,LS
2020-05-16,0,0,1,0,LS
2020-05-17,0,0,1,0,LS
2020-05-18,0,0,1,0,LS
2020-05-19,0,0,1,0,LS
2020-05-20,0,0,1,0,LS
2020-05-21,0,0,1,0,LS
2020-05-22,0,0,1,0,LS
2020-05-23,1,0,2,0,LS
2020-05-24,0,0,2,0,LS
2020-05-25,0,0,2,0,LS
2020-05-26,0,0,2,0,LS
2020-05-27,0,0,2,0,LS
2020-05-28,0,0,2,0,LS
2020-05-29,0,0,2,0,LS
2020-05-30,0,0,2,0,LS
2020-05-31,0,0,2,0,LS
2020-06-01,0,0,2,0,LS
2020-06-02,0,0,2,0,LS
2020-06-03,0,0,2,0,LS
2020-06-04,2,0,4,0,LS
2020-06-05,0,0,4,0,LS
2020-06-06,0,0,4,0,LS
2020-06-07,0,0,4,0,LS
2020-06-08,0,0,4,0,LS
2020-06-09,0,0,4,0,LS
2020-06-10,0,0,4,0,LS
2020-06-11,0,0,4,0,LS
2020-06-12,0,0,4,0,LS
2020-06-13,0,0,4,0,LS
2020-06-14,0,0,4,0,LS
2020-06-15,0,0,4,0,LS
2020-06-16,0,0,4,0,LS
2020-06-17,0,0,4,0,LS
2020-06-18,0,0,4,0,LS
2020-06-19,0,0,4,0,LS
2020-06-20,0,0,4,0,LS
2020-06-21,0,0,4,0,LS
2020-06-22,0,0,4,0,LS
2020-06-23,13,0,17,0,LS
2020-06-24,0,0,17,0,LS
2020-06-25,3,0,20,0,LS
2020-06-26,4,0,24,0,LS
2019-12-30,0,0,0,0,LT
2019-12-31,0,0,0,0,LT
2020-01-01,0,0,0,0,LT
2020-01-02,0,0,0,0,LT
2020-01-03,0,0,0,0,LT
2020-01-04,0,0,0,0,LT
2020-01-05,0,0,0,0,LT
2020-01-06,0,0,0,0,LT
2020-01-07,0,0,0,0,LT
2020-01-08,0,0,0,0,LT
2020-01-09,0,0,0,0,LT
2020-01-10,0,0,0,0,LT
2020-01-11,0,0,0,0,LT
2020-01-12,0,0,0,0,LT
2020-01-13,0,0,0,0,LT
2020-01-14,0,0,0,0,LT
2020-01-15,0,0,0,0,LT
2020-01-16,0,0,0,0,LT
2020-01-17,0,0,0,0,LT
2020-01-18,0,0,0,0,LT
2020-01-19,0,0,0,0,LT
2020-01-20,0,0,0,0,LT
2020-01-21,0,0,0,0,LT
2020-01-22,0,0,0,0,LT
2020-01-23,0,0,0,0,LT
2020-01-24,0,0,0,0,LT
2020-01-25,0,0,0,0,LT
2020-01-26,0,0,0,0,LT
2020-01-27,0,0,0,0,LT
2020-01-28,0,0,0,0,LT
2020-01-29,0,0,0,0,LT
2020-01-30,0,0,0,0,LT
2020-01-31,0,0,0,0,LT
2020-02-01,0,0,0,0,LT
2020-02-02,0,0,0,0,LT
2020-02-03,0,0,0,0,LT
2020-02-04,0,0,0,0,LT
2020-02-05,0,0,0,0,LT
2020-02-06,0,0,0,0,LT
2020-02-07,0,0,0,0,LT
2020-02-08,0,0,0,0,LT
2020-02-09,0,0,0,0,LT
2020-02-10,0,0,0,0,LT
2020-02-11,0,0,0,0,LT
2020-02-12,0,0,0,0,LT
2020-02-13,0,0,0,0,LT
2020-02-14,0,0,0,0,LT
2020-02-15,0,0,0,0,LT
2020-02-16,0,0,0,0,LT
2020-02-17,0,0,0,0,LT
2020-02-18,0,0,0,0,LT
2020-02-19,0,0,0,0,LT
2020-02-20,0,0,0,0,LT
2020-02-21,0,0,0,0,LT
2020-02-22,0,0,0,0,LT
2020-02-23,0,0,0,0,LT
2020-02-24,0,0,0,0,LT
2020-02-25,0,0,0,0,LT
2020-02-26,0,0,0,0,LT
2020-02-27,1,0,1,0,LT
2020-02-28,0,0,1,0,LT
2020-02-29,0,0,1,0,LT
2020-03-01,0,0,1,0,LT
2020-03-10,2,0,3,0,LT
2020-03-11,0,0,3,0,LT
2020-03-13,3,0,6,0,LT
2020-03-14,3,0,9,0,LT
2020-03-15,5,0,14,0,LT
2020-03-16,3,0,17,0,LT
2020-03-17,8,0,25,0,LT
2020-03-18,8,0,33,0,LT
2020-03-19,15,0,48,0,LT
2020-03-20,21,1,69,1,LT
2020-03-21,36,0,105,1,LT
2020-03-22,38,0,143,1,LT
2020-03-23,36,0,179,1,LT
2020-03-24,30,1,209,2,LT
2020-03-25,65,2,274,4,LT
2020-03-26,25,0,299,4,LT
2020-03-27,59,1,358,5,LT
2020-03-28,36,2,394,7,LT
2020-03-29,90,0,484,7,LT
2020-03-30,0,0,484,7,LT
2020-03-31,49,0,533,7,LT
2020-04-01,48,1,581,8,LT
2020-04-02,68,1,649,9,LT
2020-04-03,122,0,771,9,LT
2020-04-04,0,0,771,9,LT
2020-04-05,40,4,811,13,LT
2020-04-06,32,1,843,14,LT
2020-04-07,37,1,880,15,LT
2020-04-08,32,0,912,15,LT
2020-04-09,43,0,955,15,LT
2020-04-10,44,2,999,17,LT
2020-04-11,54,6,1053,23,LT
2020-04-12,9,1,1062,24,LT
2020-04-13,8,0,1070,24,LT
2020-04-14,0,0,1070,24,LT
2020-04-15,21,5,1091,29,LT
2020-04-16,58,3,1149,32,LT
2020-04-17,90,1,1239,33,LT
2020-04-18,59,0,1298,33,LT
2020-04-19,28,3,1326,36,LT
2020-04-20,24,1,1350,37,LT
2020-04-21,20,1,1370,38,LT
2020-04-22,28,0,1398,38,LT
2020-04-23,12,2,1410,40,LT
2020-04-24,0,0,1410,40,LT
2020-04-25,16,1,1426,41,LT
2020-04-26,12,0,1438,41,LT
2020-04-27,11,0,1449,41,LT
2020-04-28,-105,3,1344,44,LT
2020-04-29,31,1,1375,45,LT
2020-04-30,10,0,1385,45,LT
2020-05-01,14,0,1399,45,LT
2020-05-02,7,1,1406,46,LT
2020-05-03,4,0,1410,46,LT
2020-05-04,9,0,1419,46,LT
2020-05-05,4,0,1423,46,LT
2020-05-06,5,2,1428,48,LT
2020-05-07,5,1,1433,49,LT
2020-05-08,3,0,1436,49,LT
2020-05-09,8,1,1444,50,LT
2020-05-10,35,0,1479,50,LT
2020-05-11,6,0,1485,50,LT
2020-05-12,6,0,1491,50,LT
2020-05-13,14,4,1505,54,LT
2020-05-14,6,0,1511,54,LT
2020-05-15,12,0,1523,54,LT
2020-05-16,11,1,1534,55,LT
2020-05-17,7,1,1541,56,LT
2020-05-18,6,3,1547,59,LT
2020-05-19,15,1,1562,60,LT
2020-05-20,15,0,1577,60,LT
2020-05-21,17,1,1594,61,LT
2020-05-22,10,0,1604,61,LT
2020-05-23,12,2,1616,63,LT
2020-05-24,7,0,1623,63,LT
2020-05-25,12,0,1635,63,LT
2020-05-26,4,2,1639,65,LT
2020-05-27,8,1,1647,66,LT
2020-05-28,9,2,1656,68,LT
2020-05-29,6,0,1662,68,LT
2020-05-30,8,2,1670,70,LT
2020-05-31,5,0,1675,70,LT
2020-06-01,3,0,1678,70,LT
2020-06-02,4,1,1682,71,LT
2020-06-03,2,0,1684,71,LT
2020-06-04,3,0,1687,71,LT
2020-06-05,7,0,1694,71,LT
2020-06-06,11,0,1705,71,LT
2020-06-07,9,0,1714,71,LT
2020-06-08,6,0,1720,71,LT
2020-06-09,7,1,1727,72,LT
2020-06-10,6,2,1733,74,LT
2020-06-11,19,0,1752,74,LT
2020-06-12,4,0,1756,74,LT
2020-06-13,7,1,1763,75,LT
2020-06-14,5,0,1768,75,LT
2020-06-15,5,1,1773,76,LT
2020-06-16,3,0,1776,76,LT
2020-06-17,2,0,1778,76,LT
2020-06-18,6,0,1784,76,LT
2020-06-19,8,0,1792,76,LT
2020-06-20,3,0,1795,76,LT
2020-06-21,3,0,1798,76,LT
2020-06-22,3,0,1801,76,LT
2020-06-23,2,1,1803,77,LT
2020-06-24,1,1,1804,78,LT
2020-06-25,2,0,1806,78,LT
2020-06-26,2,0,1808,78,LT
2019-12-30,0,0,0,0,LU
2019-12-31,0,0,0,0,LU
2020-01-01,0,0,0,0,LU
2020-01-02,0,0,0,0,LU
2020-01-03,0,0,0,0,LU
2020-01-04,0,0,0,0,LU
2020-01-05,0,0,0,0,LU
2020-01-06,0,0,0,0,LU
2020-01-07,0,0,0,0,LU
2020-01-08,0,0,0,0,LU
2020-01-09,0,0,0,0,LU
2020-01-10,0,0,0,0,LU
2020-01-11,0,0,0,0,LU
2020-01-12,0,0,0,0,LU
2020-01-13,0,0,0,0,LU
2020-01-14,0,0,0,0,LU
2020-01-15,0,0,0,0,LU
2020-01-16,0,0,0,0,LU
2020-01-17,0,0,0,0,LU
2020-01-18,0,0,0,0,LU
2020-01-19,0,0,0,0,LU
2020-01-20,0,0,0,0,LU
2020-01-21,0,0,0,0,LU
2020-01-22,0,0,0,0,LU
2020-01-23,0,0,0,0,LU
2020-01-24,0,0,0,0,LU
2020-01-25,0,0,0,0,LU
2020-01-26,0,0,0,0,LU
2020-01-27,0,0,0,0,LU
2020-01-28,0,0,0,0,LU
2020-01-29,0,0,0,0,LU
2020-01-30,0,0,0,0,LU
2020-01-31,0,0,0,0,LU
2020-02-01,0,0,0,0,LU
2020-02-02,0,0,0,0,LU
2020-02-03,0,0,0,0,LU
2020-02-04,0,0,0,0,LU
2020-02-05,0,0,0,0,LU
2020-02-06,0,0,0,0,LU
2020-02-07,0,0,0,0,LU
2020-02-08,0,0,0,0,LU
2020-02-09,0,0,0,0,LU
2020-02-10,0,0,0,0,LU
2020-02-11,0,0,0,0,LU
2020-02-12,0,0,0,0,LU
2020-02-13,0,0,0,0,LU
2020-02-14,0,0,0,0,LU
2020-02-15,0,0,0,0,LU
2020-02-16,0,0,0,0,LU
2020-02-17,0,0,0,0,LU
2020-02-18,0,0,0,0,LU
2020-02-19,0,0,0,0,LU
2020-02-20,0,0,0,0,LU
2020-02-21,0,0,0,0,LU
2020-02-22,0,0,0,0,LU
2020-02-23,0,0,0,0,LU
2020-02-24,0,0,0,0,LU
2020-02-25,0,0,0,0,LU
2020-02-26,0,0,0,0,LU
2020-02-27,0,0,0,0,LU
2020-02-28,0,0,0,0,LU
2020-02-29,1,0,1,0,LU
2020-03-01,0,0,1,0,LU
2020-03-06,2,0,3,0,LU
2020-03-08,2,0,5,0,LU
2020-03-10,2,0,7,0,LU
2020-03-11,0,0,7,0,LU
2020-03-12,19,0,26,0,LU
2020-03-13,12,1,38,1,LU
2020-03-15,39,0,77,1,LU
2020-03-16,4,0,81,1,LU
2020-03-17,59,0,140,1,LU
2020-03-18,70,1,210,2,LU
2020-03-19,135,2,345,4,LU
2020-03-20,139,1,484,5,LU
2020-03-21,186,3,670,8,LU
2020-03-22,128,0,798,8,LU
2020-03-23,77,0,875,8,LU
2020-03-24,224,0,1099,8,LU
2020-03-25,234,0,1333,8,LU
2020-03-26,120,1,1453,9,LU
2020-03-27,152,6,1605,15,LU
2020-03-28,226,3,1831,18,LU
2020-03-29,119,3,1950,21,LU
2020-03-30,38,1,1988,22,LU
2020-03-31,190,1,2178,23,LU
2020-04-01,141,6,2319,29,LU
2020-04-02,168,1,2487,30,LU
2020-04-03,125,1,2612,31,LU
2020-04-04,117,0,2729,31,LU
2020-04-05,75,5,2804,36,LU
2020-04-06,39,5,2843,41,LU
2020-04-07,127,3,2970,44,LU
2020-04-08,64,2,3034,46,LU
2020-04-09,81,6,3115,52,LU
2020-04-10,108,2,3223,54,LU
2020-04-11,47,8,3270,62,LU
2020-04-12,11,4,3281,66,LU
2020-04-13,11,1,3292,67,LU
2020-04-14,15,0,3307,67,LU
2020-04-15,66,2,3373,69,LU
2020-04-16,71,0,3444,69,LU
2020-04-17,36,3,3480,72,LU
2020-04-18,57,0,3537,72,LU
2020-04-19,13,1,3550,73,LU
2020-04-20,8,2,3558,75,LU
2020-04-21,60,3,3618,78,LU
2020-04-22,36,2,3654,80,LU
2020-04-23,11,3,3665,83,LU
2020-04-24,30,2,3695,85,LU
2020-04-25,16,0,3711,85,LU
2020-04-26,12,3,3723,88,LU
2020-04-27,6,0,3729,88,LU
2020-04-28,12,1,3741,89,LU
2020-04-29,28,0,3769,89,LU
2020-04-30,15,1,3784,90,LU
2020-05-01,18,2,3802,92,LU
2020-05-02,10,0,3812,92,LU
2020-05-03,12,4,3824,96,LU
2020-05-04,4,0,3828,96,LU
2020-05-05,12,0,3840,96,LU
2020-05-06,11,2,3851,98,LU
2020-05-07,8,2,3859,100,LU
2020-05-08,12,0,3871,100,LU
2020-05-09,6,1,3877,101,LU
2020-05-10,9,0,3886,101,LU
2020-05-11,2,0,3888,101,LU
2020-05-12,6,1,3894,102,LU
2020-05-13,10,1,3904,103,LU
2020-05-14,11,0,3915,103,LU
2020-05-15,8,1,3923,104,LU
2020-05-16,7,0,3930,104,LU
2020-05-17,15,3,3945,107,LU
2020-05-18,2,0,3947,107,LU
2020-05-19,11,2,3958,109,LU
2020-05-20,13,0,3971,109,LU
2020-05-21,9,0,3980,109,LU
2020-05-22,1,0,3981,109,LU
2020-05-23,9,0,3990,109,LU
2020-05-24,2,1,3992,110,LU
2020-05-25,1,0,3993,110,LU
2020-05-26,2,0,3995,110,LU
2020-05-27,6,0,4001,110,LU
2020-05-28,7,0,4008,110,LU
2020-05-29,4,0,4012,110,LU
2020-05-30,4,0,4016,110,LU
2020-05-31,2,0,4018,110,LU
2020-06-01,1,0,4019,110,LU
2020-06-02,1,0,4020,110,LU
2020-06-03,0,0,4020,110,LU
2020-06-04,7,0,4027,110,LU
2020-06-05,5,0,4032,110,LU
2020-06-06,3,0,4035,110,LU
2020-06-07,4,0,4039,110,LU
2020-06-08,1,0,4040,110,LU
2020-06-09,6,0,4046,110,LU
2020-06-10,3,0,4049,110,LU
2020-06-11,3,0,4052,110,LU
2020-06-12,3,0,4055,110,LU
2020-06-13,8,0,4063,110,LU
2020-06-14,7,0,4070,110,LU
2020-06-15,2,0,4072,110,LU
2020-06-16,3,0,4075,110,LU
2020-06-17,10,0,4085,110,LU
2020-06-18,6,0,4091,110,LU
2020-06-19,8,0,4099,110,LU
2020-06-20,6,0,4105,110,LU
2020-06-21,15,0,4120,110,LU
2020-06-22,1,0,4121,110,LU
2020-06-23,12,0,4133,110,LU
2020-06-24,7,0,4140,110,LU
2020-06-25,11,0,4151,110,LU
2020-06-26,22,0,4173,110,LU
2020-03-02,1,0,1,0,LV
2020-03-07,1,0,2,0,LV
2020-03-08,1,0,3,0,LV
2020-03-09,3,0,6,0,LV
2020-03-10,2,0,8,0,LV
2020-03-11,2,0,10,0,LV
2020-03-12,6,0,16,0,LV
2020-03-13,3,0,19,0,LV
2020-03-14,7,0,26,0,LV
2020-03-15,5,0,31,0,LV
2020-03-16,5,0,36,0,LV
2020-03-17,25,0,61,0,LV
2020-03-18,10,0,71,0,LV
2020-03-19,15,0,86,0,LV
2020-03-20,25,0,111,0,LV
2020-03-21,13,0,124,0,LV
2020-03-22,15,0,139,0,LV
2020-03-23,41,0,180,0,LV
2020-03-24,17,0,197,0,LV
2020-03-25,24,0,221,0,LV
2020-03-26,23,0,244,0,LV
2020-03-27,36,0,280,0,LV
2020-03-28,25,0,305,0,LV
2020-03-29,71,0,376,0,LV
2020-03-30,0,0,376,0,LV
2020-03-31,22,0,398,0,LV
2020-04-01,48,0,446,0,LV
2020-04-02,12,0,458,0,LV
2020-04-03,35,1,493,1,LV
2020-04-04,16,0,509,1,LV
2020-04-05,24,0,533,1,LV
2020-04-06,9,0,542,1,LV
2020-04-07,6,1,548,2,LV
2020-04-08,29,0,577,2,LV
2020-04-09,12,0,589,2,LV
2020-04-10,23,0,612,2,LV
2020-04-11,18,1,630,3,LV
2020-04-12,21,2,651,5,LV
2020-04-13,4,0,655,5,LV
2020-04-14,2,0,657,5,LV
2020-04-15,9,0,666,5,LV
2020-04-16,9,0,675,5,LV
2020-04-17,7,0,682,5,LV
2020-04-18,30,0,712,5,LV
2020-04-19,15,0,727,5,LV
2020-04-20,12,0,739,5,LV
2020-04-21,9,4,748,9,LV
2020-04-22,13,2,761,11,LV
2020-04-23,17,0,778,11,LV
2020-04-24,6,1,784,12,LV
2020-04-25,20,0,804,12,LV
2020-04-26,8,0,812,12,LV
2020-04-27,6,1,818,13,LV
2020-04-28,18,0,836,13,LV
2020-04-29,13,2,849,15,LV
2020-04-30,9,0,858,15,LV
2020-05-01,12,1,870,16,LV
2020-05-02,1,0,871,16,LV
2020-05-03,8,0,879,16,LV
2020-05-04,17,0,896,16,LV
2020-05-05,0,1,896,17,LV
2020-05-06,4,0,900,17,LV
2020-05-07,9,1,909,18,LV
2020-05-08,19,0,928,18,LV
2020-05-09,2,0,930,18,LV
2020-05-10,9,0,939,18,LV
2020-05-11,7,0,946,18,LV
2020-05-12,4,0,950,18,LV
2020-05-13,1,1,951,19,LV
2020-05-14,11,0,962,19,LV
2020-05-15,8,0,970,19,LV
2020-05-16,27,0,997,19,LV
2020-05-17,11,0,1008,19,LV
2020-05-18,1,0,1009,19,LV
2020-05-19,3,2,1012,21,LV
2020-05-20,4,0,1016,21,LV
2020-05-21,9,1,1025,22,LV
2020-05-22,5,0,1030,22,LV
2020-05-23,16,0,1046,22,LV
2020-05-24,1,0,1047,22,LV
2020-05-25,2,0,1049,22,LV
2020-05-26,4,0,1053,22,LV
2020-05-27,4,1,1057,23,LV
2020-05-28,4,1,1061,24,LV
2020-05-29,3,0,1064,24,LV
2020-05-30,1,0,1065,24,LV
2020-05-31,1,0,1066,24,LV
2020-06-01,5,0,1071,24,LV
2020-06-02,8,0,1079,24,LV
2020-06-03,0,0,1079,24,LV
2020-06-04,3,1,1082,25,LV
2020-06-05,0,0,1082,25,LV
2020-06-06,4,0,1086,25,LV
2020-06-07,2,0,1088,25,LV
2020-06-08,0,1,1088,26,LV
2020-06-09,1,0,1089,26,LV
2020-06-10,3,0,1092,26,LV
2020-06-11,2,0,1094,26,LV
2020-06-12,2,1,1096,27,LV
2020-06-13,1,1,1097,28,LV
2020-06-14,0,0,1097,28,LV
2020-06-15,0,0,1097,28,LV
2020-06-16,1,0,1098,28,LV
2020-06-17,6,2,1104,30,LV
2020-06-18,4,0,1108,30,LV
2020-06-19,2,0,1110,30,LV
2020-06-20,1,0,1111,30,LV
2020-06-21,0,0,1111,30,LV
2020-06-22,0,0,1111,30,LV
2020-06-23,0,0,1111,30,LV
2020-06-24,0,0,1111,30,LV
2020-06-25,0,0,1111,30,LV
2020-06-26,1,0,1112,30,LV
2020-03-24,1,0,1,0,LY
2020-03-25,0,0,1,0,LY
2020-03-26,0,0,1,0,LY
2020-03-27,0,0,1,0,LY
2020-03-28,0,0,1,0,LY
2020-03-29,7,0,8,0,LY
2020-03-30,0,0,8,0,LY
2020-03-31,2,0,10,0,LY
2020-04-01,0,0,10,0,LY
2020-04-02,1,1,11,1,LY
2020-04-03,0,0,11,1,LY
2020-04-04,7,0,18,1,LY
2020-04-05,0,0,18,1,LY
2020-04-06,0,0,18,1,LY
2020-04-07,1,0,19,1,LY
2020-04-08,2,0,21,1,LY
2020-04-09,3,0,24,1,LY
2020-04-10,0,0,24,1,LY
2020-04-11,1,0,25,1,LY
2020-04-12,0,0,25,1,LY
2020-04-13,1,0,26,1,LY
2020-04-14,9,0,35,1,LY
2020-04-15,13,0,48,1,LY
2020-04-16,1,0,49,1,LY
2020-04-17,0,0,49,1,LY
2020-04-18,0,0,49,1,LY
2020-04-19,0,0,49,1,LY
2020-04-20,2,0,51,1,LY
2020-04-21,0,0,51,1,LY
2020-04-22,8,0,59,1,LY
2020-04-23,1,1,60,2,LY
2020-04-24,1,0,61,2,LY
2020-04-25,0,0,61,2,LY
2020-04-26,0,0,61,2,LY
2020-04-27,0,0,61,2,LY
2020-04-28,0,0,61,2,LY
2020-04-29,0,0,61,2,LY
2020-04-30,0,1,61,3,LY
2020-05-01,2,0,63,3,LY
2020-05-02,0,0,63,3,LY
2020-05-03,0,0,63,3,LY
2020-05-04,0,0,63,3,LY
2020-05-05,0,0,63,3,LY
2020-05-06,1,0,64,3,LY
2020-05-07,0,0,64,3,LY
2020-05-08,0,0,64,3,LY
2020-05-09,0,0,64,3,LY
2020-05-10,0,0,64,3,LY
2020-05-11,0,0,64,3,LY
2020-05-12,0,0,64,3,LY
2020-05-13,0,0,64,3,LY
2020-05-14,0,0,64,3,LY
2020-05-15,0,0,64,3,LY
2020-05-16,1,0,65,3,LY
2020-05-17,0,0,65,3,LY
2020-05-18,0,0,65,3,LY
2020-05-19,3,0,68,3,LY
2020-05-20,1,0,69,3,LY
2020-05-21,2,0,71,3,LY
2020-05-22,1,0,72,3,LY
2020-05-23,3,0,75,3,LY
2020-05-24,0,0,75,3,LY
2020-05-25,0,0,75,3,LY
2020-05-26,2,0,77,3,LY
2020-05-27,22,1,99,4,LY
2020-05-28,6,1,105,5,LY
2020-05-29,13,0,118,5,LY
2020-05-30,12,0,130,5,LY
2020-05-31,26,0,156,5,LY
2020-06-01,12,0,168,5,LY
2020-06-02,14,0,182,5,LY
2020-06-03,14,0,196,5,LY
2020-06-04,0,0,196,5,LY
2020-06-05,43,0,239,5,LY
2020-06-06,17,0,256,5,LY
2020-06-07,0,0,256,5,LY
2020-06-08,14,0,270,5,LY
2020-06-09,62,0,332,5,LY
2020-06-10,46,0,378,5,LY
2020-06-11,15,0,393,5,LY
2020-06-12,16,1,409,6,LY
2020-06-13,9,2,418,8,LY
2020-06-14,0,0,418,8,LY
2020-06-15,49,2,467,10,LY
2020-06-16,0,0,467,10,LY
2020-06-17,0,0,467,10,LY
2020-06-18,33,0,500,10,LY
2020-06-19,10,0,510,10,LY
2020-06-20,10,0,520,10,LY
2020-06-21,24,0,544,10,LY
2020-06-22,27,0,571,10,LY
2020-06-23,68,7,639,17,LY
2020-06-24,0,1,639,18,LY
2020-06-25,59,0,698,18,LY
2020-06-26,0,0,698,18,LY
2020-03-02,1,0,1,0,MA
2020-03-05,1,0,2,0,MA
2020-03-11,3,1,5,1,MA
2020-03-12,1,0,6,1,MA
2020-03-13,1,0,7,1,MA
2020-03-14,11,0,18,1,MA
2020-03-15,10,0,28,1,MA
2020-03-16,9,0,37,1,MA
2020-03-17,7,1,44,2,MA
2020-03-18,10,0,54,2,MA
2020-03-19,9,0,63,2,MA
2020-03-20,23,1,86,3,MA
2020-03-21,10,0,96,3,MA
2020-03-22,19,1,115,4,MA
2020-03-23,19,0,134,4,MA
2020-03-24,36,1,170,5,MA
2020-03-25,55,1,225,6,MA
2020-03-26,50,4,275,10,MA
2020-03-27,70,13,345,23,MA
2020-03-28,13,0,358,23,MA
2020-03-29,121,3,479,26,MA
2020-03-30,77,7,556,33,MA
2020-03-31,61,3,617,36,MA
2020-04-01,37,3,654,39,MA
2020-04-02,54,5,708,44,MA
2020-04-03,0,0,708,44,MA
2020-04-04,211,15,919,59,MA
2020-04-05,102,11,1021,70,MA
2020-04-06,99,10,1120,80,MA
2020-04-07,64,10,1184,90,MA
2020-04-08,91,3,1275,93,MA
2020-04-09,99,4,1374,97,MA
2020-04-10,74,10,1448,107,MA
2020-04-11,97,4,1545,111,MA
2020-04-12,116,7,1661,118,MA
2020-04-13,102,8,1763,126,MA
2020-04-14,125,0,1888,126,MA
2020-04-15,136,1,2024,127,MA
2020-04-16,259,3,2283,130,MA
2020-04-17,281,5,2564,135,MA
2020-04-18,121,2,2685,137,MA
2020-04-19,170,4,2855,141,MA
2020-04-20,191,2,3046,143,MA
2020-04-21,163,2,3209,145,MA
2020-04-22,168,4,3377,149,MA
2020-04-23,191,6,3568,155,MA
2020-04-24,190,3,3758,158,MA
2020-04-25,139,1,3897,159,MA
2020-04-26,168,2,4065,161,MA
2020-04-27,55,1,4120,162,MA
2020-04-28,132,3,4252,165,MA
2020-04-29,69,3,4321,168,MA
2020-04-30,102,2,4423,170,MA
2020-05-01,146,1,4569,171,MA
2020-05-02,160,2,4729,173,MA
2020-05-03,174,1,4903,174,MA
2020-05-04,140,5,5043,179,MA
2020-05-05,176,2,5219,181,MA
2020-05-06,189,2,5408,183,MA
2020-05-07,140,0,5548,183,MA
2020-05-08,163,3,5711,186,MA
2020-05-09,199,0,5910,186,MA
2020-05-10,153,2,6063,188,MA
2020-05-11,218,0,6281,188,MA
2020-05-12,137,0,6418,188,MA
2020-05-13,94,0,6512,188,MA
2020-05-14,95,2,6607,190,MA
2020-05-15,45,0,6652,190,MA
2020-05-16,89,2,6741,192,MA
2020-05-17,129,0,6870,192,MA
2020-05-18,82,0,6952,192,MA
2020-05-19,71,1,7023,193,MA
2020-05-20,110,1,7133,194,MA
2020-05-21,78,2,7211,196,MA
2020-05-22,121,1,7332,197,MA
2020-05-23,74,1,7406,198,MA
2020-05-24,27,1,7433,199,MA
2020-05-25,99,1,7532,200,MA
2020-05-26,45,2,7577,202,MA
2020-05-27,24,0,7601,202,MA
2020-05-28,42,0,7643,202,MA
2020-05-29,71,0,7714,202,MA
2020-05-30,66,2,7780,204,MA
2020-05-31,27,1,7807,205,MA
2020-06-01,26,0,7833,205,MA
2020-06-02,33,1,7866,206,MA
2020-06-03,56,0,7922,206,MA
2020-06-04,81,2,8003,208,MA
2020-06-05,68,0,8071,208,MA
2020-06-06,61,0,8132,208,MA
2020-06-07,92,0,8224,208,MA
2020-06-08,78,0,8302,208,MA
2020-06-09,135,2,8437,210,MA
2020-06-10,18,0,8455,210,MA
2020-06-11,82,1,8537,211,MA
2020-06-12,73,1,8610,212,MA
2020-06-13,82,0,8692,212,MA
2020-06-14,42,0,8734,212,MA
2020-06-15,104,0,8838,212,MA
2020-06-16,83,0,8921,212,MA
2020-06-17,76,1,8997,213,MA
2020-06-18,77,0,9074,213,MA
2020-06-19,539,0,9613,213,MA
2020-06-20,188,0,9801,213,MA
2020-06-21,176,1,9977,214,MA
2020-06-22,195,0,10172,214,MA
2020-06-23,92,0,10264,214,MA
2020-06-24,643,2,10907,216,MA
2020-06-25,431,1,11338,217,MA
2020-06-26,295,1,11633,218,MA
2019-12-30,0,0,0,0,MC
2019-12-31,0,0,0,0,MC
2020-01-01,0,0,0,0,MC
2020-01-02,0,0,0,0,MC
2020-01-03,0,0,0,0,MC
2020-01-04,0,0,0,0,MC
2020-01-05,0,0,0,0,MC
2020-01-06,0,0,0,0,MC
2020-01-07,0,0,0,0,MC
2020-01-08,0,0,0,0,MC
2020-01-09,0,0,0,0,MC
2020-01-10,0,0,0,0,MC
2020-01-11,0,0,0,0,MC
2020-01-12,0,0,0,0,MC
2020-01-13,0,0,0,0,MC
2020-01-14,0,0,0,0,MC
2020-01-15,0,0,0,0,MC
2020-01-16,0,0,0,0,MC
2020-01-17,0,0,0,0,MC
2020-01-18,0,0,0,0,MC
2020-01-19,0,0,0,0,MC
2020-01-20,0,0,0,0,MC
2020-01-21,0,0,0,0,MC
2020-01-22,0,0,0,0,MC
2020-01-23,0,0,0,0,MC
2020-01-24,0,0,0,0,MC
2020-01-25,0,0,0,0,MC
2020-01-26,0,0,0,0,MC
2020-01-27,0,0,0,0,MC
2020-01-28,0,0,0,0,MC
2020-01-29,0,0,0,0,MC
2020-01-30,0,0,0,0,MC
2020-01-31,0,0,0,0,MC
2020-02-01,0,0,0,0,MC
2020-02-02,0,0,0,0,MC
2020-02-03,0,0,0,0,MC
2020-02-04,0,0,0,0,MC
2020-02-05,0,0,0,0,MC
2020-02-06,0,0,0,0,MC
2020-02-07,0,0,0,0,MC
2020-02-08,0,0,0,0,MC
2020-02-09,0,0,0,0,MC
2020-02-10,0,0,0,0,MC
2020-02-11,0,0,0,0,MC
2020-02-12,0,0,0,0,MC
2020-02-13,0,0,0,0,MC
2020-02-14,0,0,0,0,MC
2020-02-15,0,0,0,0,MC
2020-02-16,0,0,0,0,MC
2020-02-17,0,0,0,0,MC
2020-02-18,0,0,0,0,MC
2020-02-19,0,0,0,0,MC
2020-02-20,0,0,0,0,MC
2020-02-21,0,0,0,0,MC
2020-02-22,0,0,0,0,MC
2020-02-23,0,0,0,0,MC
2020-02-24,0,0,0,0,MC
2020-02-25,0,0,0,0,MC
2020-02-26,0,0,0,0,MC
2020-02-27,0,0,0,0,MC
2020-02-28,1,0,1,0,MC
2020-02-29,0,0,1,0,MC
2020-03-01,0,0,1,0,MC
2020-03-14,2,0,3,0,MC
2020-03-15,4,0,7,0,MC
2020-03-16,2,0,9,0,MC
2020-03-17,0,0,9,0,MC
2020-03-18,0,0,9,0,MC
2020-03-19,2,0,11,0,MC
2020-03-20,1,0,12,0,MC
2020-03-21,6,0,18,0,MC
2020-03-22,5,0,23,0,MC
2020-03-23,0,0,23,0,MC
2020-03-24,4,0,27,0,MC
2020-03-25,4,0,31,0,MC
2020-03-26,2,0,33,0,MC
2020-03-27,9,0,42,0,MC
2020-03-28,1,0,43,0,MC
2020-03-29,3,0,46,0,MC
2020-03-30,3,0,49,0,MC
2020-03-31,3,0,52,0,MC
2020-04-01,3,0,55,0,MC
2020-04-02,5,0,60,0,MC
2020-04-03,4,0,64,0,MC
2020-04-04,2,2,66,2,MC
2020-04-05,7,0,73,2,MC
2020-04-06,4,0,77,2,MC
2020-04-07,2,0,79,2,MC
2020-04-08,2,0,81,2,MC
2020-04-09,3,0,84,2,MC
2020-04-10,6,0,90,2,MC
2020-04-11,2,0,92,2,MC
2020-04-12,1,0,93,2,MC
2020-04-13,0,0,93,2,MC
2020-04-14,0,0,93,2,MC
2020-04-15,0,1,93,3,MC
2020-04-16,0,0,93,3,MC
2020-04-17,1,0,94,3,MC
2020-04-18,0,0,94,3,MC
2020-04-19,0,0,94,3,MC
2020-04-20,0,0,94,3,MC
2020-04-21,0,0,94,3,MC
2020-04-22,0,0,94,3,MC
2020-04-23,0,1,94,4,MC
2020-04-24,0,0,94,4,MC
2020-04-25,0,0,94,4,MC
2020-04-26,0,0,94,4,MC
2020-04-27,1,0,95,4,MC
2020-04-28,0,0,95,4,MC
2020-04-29,0,0,95,4,MC
2020-04-30,0,0,95,4,MC
2020-05-01,0,0,95,4,MC
2020-05-02,0,0,95,4,MC
2020-05-03,0,0,95,4,MC
2020-05-04,0,0,95,4,MC
2020-05-05,0,0,95,4,MC
2020-05-06,0,0,95,4,MC
2020-05-07,0,0,95,4,MC
2020-05-08,0,0,95,4,MC
2020-05-09,1,0,96,4,MC
2020-05-10,0,0,96,4,MC
2020-05-11,0,0,96,4,MC
2020-05-12,0,0,96,4,MC
2020-05-13,0,0,96,4,MC
2020-05-14,0,0,96,4,MC
2020-05-15,0,1,96,5,MC
2020-05-16,0,0,96,5,MC
2020-05-17,0,0,96,5,MC
2020-05-18,1,0,97,5,MC
2020-05-19,0,0,97,5,MC
2020-05-20,0,0,97,5,MC
2020-05-21,0,0,97,5,MC
2020-05-22,0,0,97,5,MC
2020-05-23,1,0,98,5,MC
2020-05-24,0,0,98,5,MC
2020-05-25,0,0,98,5,MC
2020-05-26,0,0,98,5,MC
2020-05-27,0,0,98,5,MC
2020-05-28,0,0,98,5,MC
2020-05-29,0,0,98,5,MC
2020-05-30,1,0,99,5,MC
2020-05-31,0,0,99,5,MC
2020-06-01,0,0,99,5,MC
2020-06-02,0,0,99,5,MC
2020-06-03,0,0,99,5,MC
2020-06-04,0,0,99,5,MC
2020-06-05,0,0,99,5,MC
2020-06-06,0,0,99,5,MC
2020-06-07,0,0,99,5,MC
2020-06-08,0,0,99,5,MC
2020-06-09,0,0,99,5,MC
2020-06-10,0,0,99,5,MC
2020-06-11,0,0,99,5,MC
2020-06-12,0,0,99,5,MC
2020-06-13,0,0,99,5,MC
2020-06-14,0,0,99,5,MC
2020-06-15,0,0,99,5,MC
2020-06-16,0,0,99,5,MC
2020-06-17,0,0,99,5,MC
2020-06-18,0,0,99,5,MC
2020-06-19,0,0,99,5,MC
2020-06-20,0,0,99,5,MC
2020-06-21,1,0,100,5,MC
2020-06-22,1,0,101,5,MC
2020-06-23,0,0,101,5,MC
2020-06-24,1,0,102,5,MC
2020-06-25,0,0,102,5,MC
2020-06-26,0,0,102,5,MC
2020-03-07,1,0,1,0,MD
2020-03-10,2,0,3,0,MD
2020-03-11,1,0,4,0,MD
2020-03-12,2,0,6,0,MD
2020-03-13,2,0,8,0,MD
2020-03-14,12,0,20,0,MD
2020-03-15,3,0,23,0,MD
2020-03-16,6,0,29,0,MD
2020-03-17,1,0,30,0,MD
2020-03-18,6,1,36,1,MD
2020-03-19,13,0,49,1,MD
2020-03-20,17,0,66,1,MD
2020-03-21,14,0,80,1,MD
2020-03-22,14,0,94,1,MD
2020-03-23,15,0,109,1,MD
2020-03-24,16,0,125,1,MD
2020-03-25,24,0,149,1,MD
2020-03-26,28,0,177,1,MD
2020-03-27,22,1,199,2,MD
2020-03-28,32,0,231,2,MD
2020-03-29,32,0,263,2,MD
2020-03-30,35,0,298,2,MD
2020-03-31,55,2,353,4,MD
2020-04-01,70,1,423,5,MD
2020-04-02,82,1,505,6,MD
2020-04-03,86,2,591,8,MD
2020-04-04,161,4,752,12,MD
2020-04-05,112,3,864,15,MD
2020-04-06,101,4,965,19,MD
2020-04-07,91,3,1056,22,MD
2020-04-08,118,5,1174,27,MD
2020-04-09,115,2,1289,29,MD
2020-04-10,149,0,1438,29,MD
2020-04-11,122,1,1560,30,MD
2020-04-12,102,2,1662,32,MD
2020-04-13,50,4,1712,36,MD
2020-04-14,222,4,1934,40,MD
2020-04-15,115,6,2049,46,MD
2020-04-16,105,8,2154,54,MD
2020-04-17,110,2,2264,56,MD
2020-04-18,87,4,2351,60,MD
2020-04-19,121,7,2472,67,MD
2020-04-20,76,3,2548,70,MD
2020-04-21,66,3,2614,73,MD
2020-04-22,164,3,2778,76,MD
2020-04-23,148,4,2926,80,MD
2020-04-24,184,7,3110,87,MD
2020-04-25,194,7,3304,94,MD
2020-04-26,104,2,3408,96,MD
2020-04-27,73,6,3481,102,MD
2020-04-28,157,5,3638,107,MD
2020-04-29,133,4,3771,111,MD
2020-04-30,126,8,3897,119,MD
2020-05-01,83,3,3980,122,MD
2020-05-02,72,2,4052,124,MD
2020-05-03,69,1,4121,125,MD
2020-05-04,127,7,4248,132,MD
2020-05-05,115,4,4363,136,MD
2020-05-06,113,7,4476,143,MD
2020-05-07,129,2,4605,145,MD
2020-05-08,123,7,4728,152,MD
2020-05-09,139,9,4867,161,MD
2020-05-10,60,8,4927,169,MD
2020-05-11,68,6,4995,175,MD
2020-05-12,159,7,5154,182,MD
2020-05-13,252,3,5406,185,MD
2020-05-14,147,9,5553,194,MD
2020-05-15,192,3,5745,197,MD
2020-05-16,189,10,5934,207,MD
2020-05-17,126,4,6060,211,MD
2020-05-18,78,4,6138,215,MD
2020-05-19,202,6,6340,221,MD
2020-05-20,213,7,6553,228,MD
2020-05-21,151,5,6704,233,MD
2020-05-22,143,4,6847,237,MD
2020-05-23,147,5,6994,242,MD
2020-05-24,99,8,7093,250,MD
2020-05-25,54,11,7147,261,MD
2020-05-26,158,6,7305,267,MD
2020-05-27,232,7,7537,274,MD
2020-05-28,188,8,7725,282,MD
2020-05-29,171,6,7896,288,MD
2020-05-30,202,3,8098,291,MD
2020-05-31,153,4,8251,295,MD
2020-06-01,109,12,8360,307,MD
2020-06-02,188,0,8548,307,MD
2020-06-03,247,3,8795,310,MD
2020-06-04,223,5,9018,315,MD
2020-06-05,229,8,9247,323,MD
2020-06-06,264,8,9511,331,MD
2020-06-07,189,10,9700,341,MD
2020-06-08,107,12,9807,353,MD
2020-06-09,218,12,10025,365,MD
2020-06-10,296,6,10321,371,MD
2020-06-11,406,4,10727,375,MD
2020-06-12,366,10,11093,385,MD
2020-06-13,366,13,11459,398,MD
2020-06-14,281,8,11740,406,MD
2020-06-15,139,5,11879,411,MD
2020-06-16,375,12,12254,423,MD
2020-06-17,478,10,12732,433,MD
2020-06-18,374,11,13106,444,MD
2020-06-19,450,6,13556,450,MD
2020-06-20,397,14,13953,464,MD
2020-06-21,247,9,14200,473,MD
2020-06-22,163,7,14363,480,MD
2020-06-23,351,10,14714,490,MD
2020-06-24,364,5,15078,495,MD
2020-06-25,375,7,15453,502,MD
2020-06-26,323,13,15776,515,MD
2020-03-17,2,0,2,0,ME
2020-03-18,6,0,8,0,ME
2020-03-19,5,0,13,0,ME
2020-03-20,1,0,14,0,ME
2020-03-21,0,0,14,0,ME
2020-03-22,7,0,21,0,ME
2020-03-23,6,0,27,0,ME
2020-03-24,20,0,47,0,ME
2020-03-25,6,0,53,0,ME
2020-03-26,14,1,67,1,ME
2020-03-27,8,0,75,1,ME
2020-03-28,9,0,84,1,ME
2020-03-29,1,0,85,1,ME
2020-03-30,6,0,91,1,ME
2020-03-31,18,0,109,1,ME
2020-04-01,14,0,123,1,ME
2020-04-02,21,1,144,2,ME
2020-04-03,30,0,174,2,ME
2020-04-04,27,0,201,2,ME
2020-04-05,13,0,214,2,ME
2020-04-06,19,0,233,2,ME
2020-04-07,8,0,241,2,ME
2020-04-08,8,0,249,2,ME
2020-04-09,3,0,252,2,ME
2020-04-10,5,0,257,2,ME
2020-04-11,6,0,263,2,ME
2020-04-12,9,1,272,3,ME
2020-04-13,2,0,274,3,ME
2020-04-14,9,1,283,4,ME
2020-04-15,5,0,288,4,ME
2020-04-16,15,0,303,4,ME
2020-04-17,0,0,303,4,ME
2020-04-18,4,1,307,5,ME
2020-04-19,1,0,308,5,ME
2020-04-20,4,0,312,5,ME
2020-04-21,1,0,313,5,ME
2020-04-22,2,0,315,5,ME
2020-04-23,4,0,319,5,ME
2020-04-24,0,1,319,6,ME
2020-04-25,1,0,320,6,ME
2020-04-26,1,1,321,7,ME
2020-04-27,0,0,321,7,ME
2020-04-28,0,0,321,7,ME
2020-04-29,1,0,322,7,ME
2020-04-30,0,0,322,7,ME
2020-05-01,0,0,322,7,ME
2020-05-02,0,0,322,7,ME
2020-05-03,0,1,322,8,ME
2020-05-04,1,0,323,8,ME
2020-05-05,1,0,324,8,ME
2020-05-06,0,0,324,8,ME
2020-05-07,0,0,324,8,ME
2020-05-08,0,0,324,8,ME
2020-05-09,0,0,324,8,ME
2020-05-10,0,1,324,9,ME
2020-05-11,0,0,324,9,ME
2020-05-12,0,0,324,9,ME
2020-05-13,0,0,324,9,ME
2020-05-14,0,0,324,9,ME
2020-05-15,0,0,324,9,ME
2020-05-16,0,0,324,9,ME
2020-05-17,0,0,324,9,ME
2020-05-18,0,0,324,9,ME
2020-05-19,0,0,324,9,ME
2020-05-20,0,0,324,9,ME
2020-05-21,0,0,324,9,ME
2020-05-22,0,0,324,9,ME
2020-05-23,0,0,324,9,ME
2020-05-24,0,0,324,9,ME
2020-05-25,0,0,324,9,ME
2020-05-26,0,0,324,9,ME
2020-05-27,0,0,324,9,ME
2020-05-28,0,0,324,9,ME
2020-05-29,0,0,324,9,ME
2020-05-30,0,0,324,9,ME
2020-05-31,0,0,324,9,ME
2020-06-01,0,0,324,9,ME
2020-06-02,0,0,324,9,ME
2020-06-03,0,0,324,9,ME
2020-06-04,0,0,324,9,ME
2020-06-05,0,0,324,9,ME
2020-06-06,0,0,324,9,ME
2020-06-07,0,0,324,9,ME
2020-06-08,0,0,324,9,ME
2020-06-09,0,0,324,9,ME
2020-06-10,0,0,324,9,ME
2020-06-11,0,0,324,9,ME
2020-06-12,0,0,324,9,ME
2020-06-13,0,0,324,9,ME
2020-06-14,1,0,325,9,ME
2020-06-15,1,0,326,9,ME
2020-06-16,0,0,326,9,ME
2020-06-17,7,0,333,9,ME
2020-06-18,4,0,337,9,ME
2020-06-19,18,0,355,9,ME
2020-06-20,4,0,359,9,ME
2020-06-21,3,0,362,9,ME
2020-06-22,5,0,367,9,ME
2020-06-23,11,0,378,9,ME
2020-06-24,11,0,389,9,ME
2020-06-25,25,0,414,9,ME
2020-06-26,25,0,439,9,ME
2020-03-20,3,0,3,0,MG
2020-03-21,0,0,3,0,MG
2020-03-22,0,0,3,0,MG
2020-03-23,14,0,17,0,MG
2020-03-24,2,0,19,0,MG
2020-03-25,0,0,19,0,MG
2020-03-26,4,0,23,0,MG
2020-03-27,1,0,24,0,MG
2020-03-28,4,0,28,0,MG
2020-03-29,9,0,37,0,MG
2020-03-30,7,0,44,0,MG
2020-03-31,2,0,46,0,MG
2020-04-01,8,0,54,0,MG
2020-04-02,5,0,59,0,MG
2020-04-03,6,0,65,0,MG
2020-04-04,6,0,71,0,MG
2020-04-05,1,0,72,0,MG
2020-04-06,5,0,77,0,MG
2020-04-07,8,0,85,0,MG
2020-04-08,8,0,93,0,MG
2020-04-09,0,0,93,0,MG
2020-04-10,9,0,102,0,MG
2020-04-11,0,0,102,0,MG
2020-04-12,4,0,106,0,MG
2020-04-13,0,0,106,0,MG
2020-04-14,2,0,108,0,MG
2020-04-15,2,0,110,0,MG
2020-04-16,1,0,111,0,MG
2020-04-17,6,0,117,0,MG
2020-04-18,0,0,117,0,MG
2020-04-19,4,0,121,0,MG
2020-04-20,0,0,121,0,MG
2020-04-21,0,0,121,0,MG
2020-04-22,0,0,121,0,MG
2020-04-23,0,0,121,0,MG
2020-04-24,1,0,122,0,MG
2020-04-25,2,0,124,0,MG
2020-04-26,0,0,124,0,MG
2020-04-27,4,0,128,0,MG
2020-04-28,0,0,128,0,MG
2020-04-29,0,0,128,0,MG
2020-04-30,4,0,132,0,MG
2020-05-01,3,0,135,0,MG
2020-05-02,0,0,135,0,MG
2020-05-03,14,0,149,0,MG
2020-05-04,0,0,149,0,MG
2020-05-05,9,0,158,0,MG
2020-05-06,0,0,158,0,MG
2020-05-07,11,0,169,0,MG
2020-05-08,0,0,169,0,MG
2020-05-09,0,0,169,0,MG
2020-05-10,2,0,171,0,MG
2020-05-11,15,0,186,0,MG
2020-05-12,6,0,192,0,MG
2020-05-13,20,0,212,0,MG
2020-05-14,18,0,230,0,MG
2020-05-15,8,0,238,0,MG
2020-05-16,45,0,283,0,MG
2020-05-17,21,1,304,1,MG
2020-05-18,18,0,322,1,MG
2020-05-19,4,1,326,2,MG
2020-05-20,45,0,371,2,MG
2020-05-21,34,0,405,2,MG
2020-05-22,43,0,448,2,MG
2020-05-23,0,0,448,2,MG
2020-05-24,79,0,527,2,MG
2020-05-25,15,0,542,2,MG
2020-05-26,44,0,586,2,MG
2020-05-27,26,0,612,2,MG
2020-05-28,44,0,656,2,MG
2020-05-29,42,3,698,5,MG
2020-05-30,60,1,758,6,MG
2020-05-31,13,0,771,6,MG
2020-06-01,55,0,826,6,MG
2020-06-02,19,0,845,6,MG
2020-06-03,63,0,908,6,MG
2020-06-04,49,1,957,7,MG
2020-06-05,18,0,975,7,MG
2020-06-06,51,1,1026,8,MG
2020-06-07,26,1,1052,9,MG
2020-06-08,42,0,1094,9,MG
2020-06-09,44,0,1138,9,MG
2020-06-10,24,1,1162,10,MG
2020-06-11,41,0,1203,10,MG
2020-06-12,27,0,1230,10,MG
2020-06-13,22,0,1252,10,MG
2020-06-14,20,0,1272,10,MG
2020-06-15,18,0,1290,10,MG
2020-06-16,27,2,1317,12,MG
2020-06-17,61,0,1378,12,MG
2020-06-18,25,1,1403,13,MG
2020-06-19,40,0,1443,13,MG
2020-06-20,60,0,1503,13,MG
2020-06-21,93,1,1596,14,MG
2020-06-22,44,1,1640,15,MG
2020-06-23,84,0,1724,15,MG
2020-06-24,63,1,1787,16,MG
2020-06-25,42,0,1829,16,MG
2020-06-26,93,0,1922,16,MG
2019-12-30,0,0,0,0,MK
2019-12-31,0,0,0,0,MK
2020-01-01,0,0,0,0,MK
2020-01-02,0,0,0,0,MK
2020-01-03,0,0,0,0,MK
2020-01-04,0,0,0,0,MK
2020-01-05,0,0,0,0,MK
2020-01-06,0,0,0,0,MK
2020-01-07,0,0,0,0,MK
2020-01-08,0,0,0,0,MK
2020-01-09,0,0,0,0,MK
2020-01-10,0,0,0,0,MK
2020-01-11,0,0,0,0,MK
2020-01-12,0,0,0,0,MK
2020-01-13,0,0,0,0,MK
2020-01-14,0,0,0,0,MK
2020-01-15,0,0,0,0,MK
2020-01-16,0,0,0,0,MK
2020-01-17,0,0,0,0,MK
2020-01-18,0,0,0,0,MK
2020-01-19,0,0,0,0,MK
2020-01-20,0,0,0,0,MK
2020-01-21,0,0,0,0,MK
2020-01-22,0,0,0,0,MK
2020-01-23,0,0,0,0,MK
2020-01-24,0,0,0,0,MK
2020-01-25,0,0,0,0,MK
2020-01-26,0,0,0,0,MK
2020-01-27,0,0,0,0,MK
2020-01-28,0,0,0,0,MK
2020-01-29,0,0,0,0,MK
2020-01-30,0,0,0,0,MK
2020-01-31,0,0,0,0,MK
2020-02-01,0,0,0,0,MK
2020-02-02,0,0,0,0,MK
2020-02-03,0,0,0,0,MK
2020-02-04,0,0,0,0,MK
2020-02-05,0,0,0,0,MK
2020-02-06,0,0,0,0,MK
2020-02-07,0,0,0,0,MK
2020-02-08,0,0,0,0,MK
2020-02-09,0,0,0,0,MK
2020-02-10,0,0,0,0,MK
2020-02-11,0,0,0,0,MK
2020-02-12,0,0,0,0,MK
2020-02-13,0,0,0,0,MK
2020-02-14,0,0,0,0,MK
2020-02-15,0,0,0,0,MK
2020-02-16,0,0,0,0,MK
2020-02-17,0,0,0,0,MK
2020-02-18,0,0,0,0,MK
2020-02-19,0,0,0,0,MK
2020-02-20,0,0,0,0,MK
2020-02-21,0,0,0,0,MK
2020-02-22,0,0,0,0,MK
2020-02-23,0,0,0,0,MK
2020-02-24,0,0,0,0,MK
2020-02-25,0,0,0,0,MK
2020-02-26,1,0,1,0,MK
2020-02-27,0,0,1,0,MK
2020-02-28,0,0,1,0,MK
2020-02-29,0,0,1,0,MK
2020-03-01,0,0,1,0,MK
2020-03-06,2,0,3,0,MK
2020-03-10,4,0,7,0,MK
2020-03-12,2,0,9,0,MK
2020-03-13,4,0,13,0,MK
2020-03-15,0,0,13,0,MK
2020-03-16,6,0,19,0,MK
2020-03-17,12,0,31,0,MK
2020-03-18,11,0,42,0,MK
2020-03-19,6,0,48,0,MK
2020-03-20,22,0,70,0,MK
2020-03-21,15,0,85,0,MK
2020-03-22,29,1,114,1,MK
2020-03-23,22,1,136,2,MK
2020-03-24,12,0,148,2,MK
2020-03-25,29,0,177,2,MK
2020-03-26,24,1,201,3,MK
2020-03-27,18,0,219,3,MK
2020-03-28,22,1,241,4,MK
2020-03-29,18,2,259,6,MK
2020-03-30,26,1,285,7,MK
2020-03-31,44,2,329,9,MK
2020-04-01,25,1,354,10,MK
2020-04-02,0,1,354,11,MK
2020-04-03,76,1,430,12,MK
2020-04-04,53,5,483,17,MK
2020-04-05,0,0,483,17,MK
2020-04-06,87,4,570,21,MK
2020-04-07,29,5,599,26,MK
2020-04-08,18,4,617,30,MK
2020-04-09,46,2,663,32,MK
2020-04-10,48,0,711,32,MK
2020-04-11,49,2,760,34,MK
2020-04-12,68,0,828,34,MK
2020-04-13,26,4,854,38,MK
2020-04-14,54,6,908,44,MK
2020-04-15,66,1,974,45,MK
2020-04-16,107,1,1081,46,MK
2020-04-17,36,3,1117,49,MK
2020-04-18,53,0,1170,49,MK
2020-04-19,37,2,1207,51,MK
2020-04-20,18,3,1225,54,MK
2020-04-21,6,1,1231,55,MK
2020-04-22,28,1,1259,56,MK
2020-04-23,41,0,1300,56,MK
2020-04-24,26,1,1326,57,MK
2020-04-25,41,2,1367,59,MK
2020-04-26,19,2,1386,61,MK
2020-04-27,13,4,1399,65,MK
2020-04-28,22,6,1421,71,MK
2020-04-29,21,2,1442,73,MK
2020-04-30,23,4,1465,77,MK
2020-05-01,29,4,1494,81,MK
2020-05-02,12,1,1506,82,MK
2020-05-03,5,2,1511,84,MK
2020-05-04,7,1,1518,85,MK
2020-05-05,8,1,1526,86,MK
2020-05-06,13,2,1539,88,MK
2020-05-07,33,1,1572,89,MK
2020-05-08,14,1,1586,90,MK
2020-05-09,36,1,1622,91,MK
2020-05-10,20,0,1642,91,MK
2020-05-11,22,0,1664,91,MK
2020-05-12,10,1,1674,92,MK
2020-05-13,20,3,1694,95,MK
2020-05-14,29,0,1723,95,MK
2020-05-15,17,2,1740,97,MK
2020-05-16,22,1,1762,98,MK
2020-05-17,30,3,1792,101,MK
2020-05-18,25,3,1817,104,MK
2020-05-19,22,2,1839,106,MK
2020-05-20,19,4,1858,110,MK
2020-05-21,40,1,1898,111,MK
2020-05-22,23,1,1921,112,MK
2020-05-23,20,1,1941,113,MK
2020-05-24,37,0,1978,113,MK
2020-05-25,21,0,1999,113,MK
2020-05-26,16,3,2015,116,MK
2020-05-27,25,3,2040,119,MK
2020-05-28,38,3,2078,122,MK
2020-05-29,52,4,2130,126,MK
2020-05-30,34,5,2164,131,MK
2020-05-31,62,2,2226,133,MK
2020-06-01,89,7,2315,140,MK
2020-06-02,76,1,2391,141,MK
2020-06-03,101,4,2492,145,MK
2020-06-04,120,2,2612,147,MK
2020-06-05,180,2,2792,149,MK
2020-06-06,125,2,2917,151,MK
2020-06-07,111,2,3028,153,MK
2020-06-08,127,3,3155,156,MK
2020-06-09,87,1,3242,157,MK
2020-06-10,125,7,3367,164,MK
2020-06-11,175,5,3542,169,MK
2020-06-12,164,2,3706,171,MK
2020-06-13,196,8,3902,179,MK
2020-06-14,155,9,4057,188,MK
2020-06-15,100,5,4157,193,MK
2020-06-16,132,8,4289,201,MK
2020-06-17,193,9,4482,210,MK
2020-06-18,182,6,4664,216,MK
2020-06-19,156,6,4820,222,MK
2020-06-20,185,11,5005,233,MK
2020-06-21,101,5,5106,238,MK
2020-06-22,90,9,5196,247,MK
2020-06-23,118,4,5314,251,MK
2020-06-24,136,8,5450,259,MK
2020-06-25,153,6,5603,265,MK
2020-06-26,163,3,5766,268,MK
2020-03-25,2,0,2,0,ML
2020-03-26,2,0,4,0,ML
2020-03-27,0,0,4,0,ML
2020-03-28,5,0,9,0,ML
2020-03-29,9,0,18,0,ML
2020-03-30,0,0,18,0,ML
2020-03-31,0,1,18,1,ML
2020-04-01,10,0,28,1,ML
2020-04-02,8,2,36,3,ML
2020-04-03,3,0,39,3,ML
2020-04-04,2,0,41,3,ML
2020-04-05,4,2,45,5,ML
2020-04-06,2,0,47,5,ML
2020-04-07,9,0,56,5,ML
2020-04-08,3,2,59,7,ML
2020-04-09,0,0,59,7,ML
2020-04-10,28,0,87,7,ML
2020-04-11,18,2,105,9,ML
2020-04-12,11,0,116,9,ML
2020-04-13,7,1,123,10,ML
2020-04-14,21,3,144,13,ML
2020-04-15,4,0,148,13,ML
2020-04-16,23,0,171,13,ML
2020-04-17,19,0,190,13,ML
2020-04-18,26,0,216,13,ML
2020-04-19,8,1,224,14,ML
2020-04-20,22,0,246,14,ML
2020-04-21,12,0,258,14,ML
2020-04-22,35,3,293,17,ML
2020-04-23,16,4,309,21,ML
2020-04-24,16,0,325,21,ML
2020-04-25,45,0,370,21,ML
2020-04-26,19,2,389,23,ML
2020-04-27,19,0,408,23,ML
2020-04-28,16,1,424,24,ML
2020-04-29,58,1,482,25,ML
2020-04-30,8,1,490,26,ML
2020-05-01,18,0,508,26,ML
2020-05-02,36,0,544,26,ML
2020-05-03,19,1,563,27,ML
2020-05-04,17,2,580,29,ML
2020-05-05,32,3,612,32,ML
2020-05-06,19,0,631,32,ML
2020-05-07,19,0,650,32,ML
2020-05-08,18,3,668,35,ML
2020-05-09,24,2,692,37,ML
2020-05-10,12,1,704,38,ML
2020-05-11,8,1,712,39,ML
2020-05-12,18,1,730,40,ML
2020-05-13,28,4,758,44,ML
2020-05-14,21,2,779,46,ML
2020-05-15,27,0,806,46,ML
2020-05-16,29,2,835,48,ML
2020-05-17,25,4,860,52,ML
2020-05-18,14,0,874,52,ML
2020-05-19,27,1,901,53,ML
2020-05-20,30,2,931,55,ML
2020-05-21,16,5,947,60,ML
2020-05-22,22,2,969,62,ML
2020-05-23,46,1,1015,63,ML
2020-05-24,15,2,1030,65,ML
2020-05-25,29,2,1059,67,ML
2020-05-26,18,3,1077,70,ML
2020-05-27,39,0,1116,70,ML
2020-05-28,78,2,1194,72,ML
2020-05-29,32,1,1226,73,ML
2020-05-30,24,3,1250,76,ML
2020-05-31,15,1,1265,77,ML
2020-06-01,50,1,1315,78,ML
2020-06-02,36,0,1351,78,ML
2020-06-03,0,0,1351,78,ML
2020-06-04,110,7,1461,85,ML
2020-06-05,24,2,1485,87,ML
2020-06-06,38,3,1523,90,ML
2020-06-07,10,2,1533,92,ML
2020-06-08,14,0,1547,92,ML
2020-06-09,39,2,1586,94,ML
2020-06-10,81,2,1667,96,ML
2020-06-11,55,1,1722,97,ML
2020-06-12,30,4,1752,101,ML
2020-06-13,24,3,1776,104,ML
2020-06-14,33,0,1809,104,ML
2020-06-15,51,0,1860,104,ML
2020-06-16,25,2,1885,106,ML
2020-06-17,5,1,1890,107,ML
2020-06-18,16,0,1906,107,ML
2020-06-19,17,1,1923,108,ML
2020-06-20,10,1,1933,109,ML
2020-06-21,28,2,1961,111,ML
2020-06-22,0,0,1961,111,ML
2020-06-23,17,0,1978,111,ML
2020-06-24,23,1,2001,112,ML
2020-06-25,6,1,2007,113,ML
2020-06-26,32,0,2039,113,ML
2020-03-16,0,0,0,0,MM
2020-03-23,2,0,2,0,MM
2020-03-24,1,0,3,0,MM
2020-03-25,0,0,3,0,MM
2020-03-26,2,0,5,0,MM
2020-03-27,0,0,5,0,MM
2020-03-28,3,0,8,0,MM
2020-03-29,0,0,8,0,MM
2020-03-30,6,0,14,0,MM
2020-03-31,1,1,15,1,MM
2020-04-01,1,0,16,1,MM
2020-04-02,4,0,20,1,MM
2020-04-03,0,0,20,1,MM
2020-04-04,1,0,21,1,MM
2020-04-05,0,0,21,1,MM
2020-04-06,1,0,22,1,MM
2020-04-07,0,0,22,1,MM
2020-04-08,0,2,22,3,MM
2020-04-09,5,0,27,3,MM
2020-04-10,1,0,28,3,MM
2020-04-11,3,0,31,3,MM
2020-04-12,10,1,41,4,MM
2020-04-13,21,0,62,4,MM
2020-04-14,12,0,74,4,MM
2020-04-15,0,0,74,4,MM
2020-04-16,11,0,85,4,MM
2020-04-17,9,1,94,5,MM
2020-04-18,13,0,107,5,MM
2020-04-19,4,0,111,5,MM
2020-04-20,8,0,119,5,MM
2020-04-21,2,0,121,5,MM
2020-04-22,6,0,127,5,MM
2020-04-23,5,0,132,5,MM
2020-04-24,12,0,144,5,MM
2020-04-25,2,0,146,5,MM
2020-04-26,0,0,146,5,MM
2020-04-27,0,0,146,5,MM
2020-04-28,4,0,150,5,MM
2020-04-29,0,1,150,6,MM
2020-04-30,1,0,151,6,MM
2020-05-01,0,0,151,6,MM
2020-05-02,0,0,151,6,MM
2020-05-03,4,0,155,6,MM
2020-05-04,6,0,161,6,MM
2020-05-05,0,0,161,6,MM
2020-05-06,1,0,162,6,MM
2020-05-07,14,0,176,6,MM
2020-05-08,1,0,177,6,MM
2020-05-09,1,0,178,6,MM
2020-05-10,2,0,180,6,MM
2020-05-11,0,0,180,6,MM
2020-05-12,0,0,180,6,MM
2020-05-13,1,0,181,6,MM
2020-05-14,0,0,181,6,MM
2020-05-15,1,0,182,6,MM
2020-05-16,0,0,182,6,MM
2020-05-17,5,0,187,6,MM
2020-05-18,4,0,191,6,MM
2020-05-19,2,0,193,6,MM
2020-05-20,6,0,199,6,MM
2020-05-21,0,0,199,6,MM
2020-05-22,2,0,201,6,MM
2020-05-23,0,0,201,6,MM
2020-05-24,0,0,201,6,MM
2020-05-25,2,0,203,6,MM
2020-05-26,3,0,206,6,MM
2020-05-27,0,0,206,6,MM
2020-05-28,0,0,206,6,MM
2020-05-29,18,0,224,6,MM
2020-05-30,0,0,224,6,MM
2020-05-31,4,0,228,6,MM
2020-06-01,0,0,228,6,MM
2020-06-02,5,0,233,6,MM
2020-06-03,1,0,234,6,MM
2020-06-04,2,0,236,6,MM
2020-06-05,0,0,236,6,MM
2020-06-06,4,0,240,6,MM
2020-06-07,3,0,243,6,MM
2020-06-08,1,0,244,6,MM
2020-06-09,2,0,246,6,MM
2020-06-10,3,0,249,6,MM
2020-06-11,12,0,261,6,MM
2020-06-12,0,0,261,6,MM
2020-06-13,0,0,261,6,MM
2020-06-14,1,0,262,6,MM
2020-06-15,0,0,262,6,MM
2020-06-16,0,0,262,6,MM
2020-06-17,1,0,263,6,MM
2020-06-18,23,0,286,6,MM
2020-06-19,0,0,286,6,MM
2020-06-20,1,0,287,6,MM
2020-06-21,3,0,290,6,MM
2020-06-22,1,0,291,6,MM
2020-06-23,1,0,292,6,MM
2020-06-24,1,0,293,6,MM
2020-06-25,0,0,293,6,MM
2020-06-26,0,0,293,6,MM
2020-03-09,1,0,1,0,MN
2020-03-14,0,0,1,0,MN
2020-03-17,3,0,4,0,MN
2020-03-18,1,0,5,0,MN
2020-03-19,0,0,5,0,MN
2020-03-20,1,0,6,0,MN
2020-03-21,4,0,10,0,MN
2020-03-22,0,0,10,0,MN
2020-03-23,0,0,10,0,MN
2020-03-24,0,0,10,0,MN
2020-03-25,0,0,10,0,MN
2020-03-26,1,0,11,0,MN
2020-03-27,0,0,11,0,MN
2020-03-28,1,0,12,0,MN
2020-03-29,0,0,12,0,MN
2020-03-30,0,0,12,0,MN
2020-03-31,0,0,12,0,MN
2020-04-01,2,0,14,0,MN
2020-04-02,0,0,14,0,MN
2020-04-03,0,0,14,0,MN
2020-04-04,0,0,14,0,MN
2020-04-05,0,0,14,0,MN
2020-04-06,1,0,15,0,MN
2020-04-07,0,0,15,0,MN
2020-04-08,1,0,16,0,MN
2020-04-09,0,0,16,0,MN
2020-04-10,0,0,16,0,MN
2020-04-11,0,0,16,0,MN
2020-04-12,0,0,16,0,MN
2020-04-13,0,0,16,0,MN
2020-04-14,14,0,30,0,MN
2020-04-15,0,0,30,0,MN
2020-04-16,1,0,31,0,MN
2020-04-17,0,0,31,0,MN
2020-04-18,0,0,31,0,MN
2020-04-19,1,0,32,0,MN
2020-04-20,2,0,34,0,MN
2020-04-21,1,0,35,0,MN
2020-04-22,0,0,35,0,MN
2020-04-23,1,0,36,0,MN
2020-04-24,0,0,36,0,MN
2020-04-25,2,0,38,0,MN
2020-04-26,0,0,38,0,MN
2020-04-27,0,0,38,0,MN
2020-04-28,0,0,38,0,MN
2020-04-29,0,0,38,0,MN
2020-04-30,0,0,38,0,MN
2020-05-01,1,0,39,0,MN
2020-05-02,0,0,39,0,MN
2020-05-03,1,0,40,0,MN
2020-05-04,1,0,41,0,MN
2020-05-05,0,0,41,0,MN
2020-05-06,0,0,41,0,MN
2020-05-07,1,0,42,0,MN
2020-05-08,0,0,42,0,MN
2020-05-09,0,0,42,0,MN
2020-05-10,0,0,42,0,MN
2020-05-11,0,0,42,0,MN
2020-05-12,0,0,42,0,MN
2020-05-13,19,0,61,0,MN
2020-05-14,0,0,61,0,MN
2020-05-15,74,0,135,0,MN
2020-05-16,1,0,136,0,MN
2020-05-17,4,0,140,0,MN
2020-05-18,0,0,140,0,MN
2020-05-19,0,0,140,0,MN
2020-05-20,0,0,140,0,MN
2020-05-21,1,0,141,0,MN
2020-05-22,0,0,141,0,MN
2020-05-23,0,0,141,0,MN
2020-05-24,0,0,141,0,MN
2020-05-25,0,0,141,0,MN
2020-05-26,7,0,148,0,MN
2020-05-27,13,0,161,0,MN
2020-05-28,18,0,179,0,MN
2020-05-29,0,0,179,0,MN
2020-05-30,0,0,179,0,MN
2020-05-31,6,0,185,0,MN
2020-06-01,0,0,185,0,MN
2020-06-02,0,0,185,0,MN
2020-06-03,1,0,186,0,MN
2020-06-04,5,0,191,0,MN
2020-06-05,0,0,191,0,MN
2020-06-06,2,0,193,0,MN
2020-06-07,1,0,194,0,MN
2020-06-08,0,0,194,0,MN
2020-06-09,0,0,194,0,MN
2020-06-10,0,0,194,0,MN
2020-06-11,3,0,197,0,MN
2020-06-12,0,0,197,0,MN
2020-06-13,0,0,197,0,MN
2020-06-14,0,0,197,0,MN
2020-06-15,0,0,197,0,MN
2020-06-16,0,0,197,0,MN
2020-06-17,4,0,201,0,MN
2020-06-18,3,0,204,0,MN
2020-06-19,0,0,204,0,MN
2020-06-20,2,0,206,0,MN
2020-06-21,7,0,213,0,MN
2020-06-22,2,0,215,0,MN
2020-06-23,0,0,215,0,MN
2020-06-24,1,0,216,0,MN
2020-06-25,3,0,219,0,MN
2020-06-26,0,0,219,0,MN
2020-03-30,2,0,2,0,MP
2020-03-31,4,0,6,0,MP
2020-04-01,0,1,6,1,MP
2020-04-02,2,0,8,1,MP
2020-04-03,0,0,8,1,MP
2020-04-04,0,0,8,1,MP
2020-04-05,0,0,8,1,MP
2020-04-06,0,0,8,1,MP
2020-04-07,0,1,8,2,MP
2020-04-08,3,0,11,2,MP
2020-04-09,0,0,11,2,MP
2020-04-10,0,0,11,2,MP
2020-04-11,0,0,11,2,MP
2020-04-12,0,0,11,2,MP
2020-04-13,0,0,11,2,MP
2020-04-14,2,0,13,2,MP
2020-04-15,0,0,13,2,MP
2020-04-16,0,0,13,2,MP
2020-04-17,1,0,14,2,MP
2020-04-18,0,0,14,2,MP
2020-04-19,0,0,14,2,MP
2020-04-20,0,0,14,2,MP
2020-04-21,0,0,14,2,MP
2020-04-22,0,0,14,2,MP
2020-04-23,0,0,14,2,MP
2020-04-24,0,0,14,2,MP
2020-04-25,0,0,14,2,MP
2020-04-26,0,0,14,2,MP
2020-04-27,0,0,14,2,MP
2020-04-28,0,0,14,2,MP
2020-04-29,0,0,14,2,MP
2020-04-30,0,0,14,2,MP
2020-05-01,0,0,14,2,MP
2020-05-02,0,0,14,2,MP
2020-05-03,0,0,14,2,MP
2020-05-04,0,0,14,2,MP
2020-05-05,0,0,14,2,MP
2020-05-06,1,0,15,2,MP
2020-05-07,0,0,15,2,MP
2020-05-08,0,0,15,2,MP
2020-05-09,1,0,16,2,MP
2020-05-10,0,0,16,2,MP
2020-05-11,3,0,19,2,MP
2020-05-12,0,0,19,2,MP
2020-05-13,0,0,19,2,MP
2020-05-14,0,0,19,2,MP
2020-05-15,0,0,19,2,MP
2020-05-16,2,0,21,2,MP
2020-05-17,0,0,21,2,MP
2020-05-18,0,0,21,2,MP
2020-05-19,0,0,21,2,MP
2020-05-20,1,0,22,2,MP
2020-05-21,0,0,22,2,MP
2020-05-22,0,0,22,2,MP
2020-05-23,0,0,22,2,MP
2020-05-24,0,0,22,2,MP
2020-05-25,0,0,22,2,MP
2020-05-26,0,0,22,2,MP
2020-05-27,0,0,22,2,MP
2020-05-28,0,0,22,2,MP
2020-05-29,0,0,22,2,MP
2020-05-30,0,0,22,2,MP
2020-05-31,0,0,22,2,MP
2020-06-01,0,0,22,2,MP
2020-06-02,1,0,23,2,MP
2020-06-03,1,0,24,2,MP
2020-06-04,2,0,26,2,MP
2020-06-05,0,0,26,2,MP
2020-06-06,1,0,27,2,MP
2020-06-07,0,0,27,2,MP
2020-06-08,1,0,28,2,MP
2020-06-09,2,0,30,2,MP
2020-06-10,0,0,30,2,MP
2020-06-11,0,0,30,2,MP
2020-06-12,0,0,30,2,MP
2020-06-13,0,0,30,2,MP
2020-06-14,0,0,30,2,MP
2020-06-15,0,0,30,2,MP
2020-06-16,0,0,30,2,MP
2020-06-17,0,0,30,2,MP
2020-06-18,0,0,30,2,MP
2020-06-19,0,0,30,2,MP
2020-06-20,0,0,30,2,MP
2020-06-21,0,0,30,2,MP
2020-06-22,0,0,30,2,MP
2020-06-23,0,0,30,2,MP
2020-06-24,0,0,30,2,MP
2020-06-25,0,0,30,2,MP
2020-06-26,0,0,30,2,MP
2020-03-14,1,0,1,0,MR
2020-03-15,0,0,1,0,MR
2020-03-16,0,0,1,0,MR
2020-03-17,0,0,1,0,MR
2020-03-18,0,0,1,0,MR
2020-03-19,1,0,2,0,MR
2020-03-20,0,0,2,0,MR
2020-03-21,0,0,2,0,MR
2020-03-22,0,0,2,0,MR
2020-03-23,0,0,2,0,MR
2020-03-24,0,0,2,0,MR
2020-03-25,0,0,2,0,MR
2020-03-26,1,0,3,0,MR
2020-03-27,0,0,3,0,MR
2020-03-28,2,0,5,0,MR
2020-03-29,0,0,5,0,MR
2020-03-30,0,0,5,0,MR
2020-03-31,0,0,5,0,MR
2020-04-01,0,0,5,0,MR
2020-04-02,1,1,6,1,MR
2020-04-03,0,0,6,1,MR
2020-04-04,0,0,6,1,MR
2020-04-05,0,0,6,1,MR
2020-04-06,0,0,6,1,MR
2020-04-07,0,0,6,1,MR
2020-04-08,0,0,6,1,MR
2020-04-09,1,0,7,1,MR
2020-04-10,0,0,7,1,MR
2020-04-11,0,0,7,1,MR
2020-04-12,0,0,7,1,MR
2020-04-13,0,0,7,1,MR
2020-04-14,0,0,7,1,MR
2020-04-15,0,0,7,1,MR
2020-04-16,0,0,7,1,MR
2020-04-17,0,0,7,1,MR
2020-04-18,0,0,7,1,MR
2020-04-19,0,0,7,1,MR
2020-04-20,0,0,7,1,MR
2020-04-21,0,0,7,1,MR
2020-04-22,0,0,7,1,MR
2020-04-23,0,0,7,1,MR
2020-04-24,0,0,7,1,MR
2020-04-25,0,0,7,1,MR
2020-04-26,0,0,7,1,MR
2020-04-27,0,0,7,1,MR
2020-04-28,0,0,7,1,MR
2020-04-29,0,0,7,1,MR
2020-04-30,1,0,8,1,MR
2020-05-01,0,0,8,1,MR
2020-05-02,0,0,8,1,MR
2020-05-03,0,0,8,1,MR
2020-05-04,0,0,8,1,MR
2020-05-05,0,0,8,1,MR
2020-05-06,0,0,8,1,MR
2020-05-07,0,0,8,1,MR
2020-05-08,0,0,8,1,MR
2020-05-09,0,0,8,1,MR
2020-05-10,0,0,8,1,MR
2020-05-11,0,0,8,1,MR
2020-05-12,0,0,8,1,MR
2020-05-13,1,1,9,2,MR
2020-05-14,7,0,16,2,MR
2020-05-15,13,1,29,3,MR
2020-05-16,0,0,29,3,MR
2020-05-17,33,1,62,4,MR
2020-05-18,19,0,81,4,MR
2020-05-19,0,0,81,4,MR
2020-05-20,50,0,131,4,MR
2020-05-21,42,1,173,5,MR
2020-05-22,0,0,173,5,MR
2020-05-23,54,1,227,6,MR
2020-05-24,10,0,237,6,MR
2020-05-25,0,0,237,6,MR
2020-05-26,25,3,262,9,MR
2020-05-27,30,7,292,16,MR
2020-05-28,0,0,292,16,MR
2020-05-29,131,4,423,20,MR
2020-05-30,60,1,483,21,MR
2020-05-31,47,2,530,23,MR
2020-06-01,0,0,530,23,MR
2020-06-02,138,8,668,31,MR
2020-06-03,0,0,668,31,MR
2020-06-04,116,8,784,39,MR
2020-06-05,99,4,883,43,MR
2020-06-06,64,0,947,43,MR
2020-06-07,0,0,947,43,MR
2020-06-08,0,0,947,43,MR
2020-06-09,215,18,1162,61,MR
2020-06-10,0,0,1162,61,MR
2020-06-11,0,0,1162,61,MR
2020-06-12,277,13,1439,74,MR
2020-06-13,0,0,1439,74,MR
2020-06-14,344,13,1783,87,MR
2020-06-15,104,4,1887,91,MR
2020-06-16,170,2,2057,93,MR
2020-06-17,0,0,2057,93,MR
2020-06-18,166,2,2223,95,MR
2020-06-19,0,0,2223,95,MR
2020-06-20,590,13,2813,108,MR
2020-06-21,0,0,2813,108,MR
2020-06-22,171,3,2984,111,MR
2020-06-23,0,0,2984,111,MR
2020-06-24,308,3,3292,114,MR
2020-06-25,447,5,3739,119,MR
2020-06-26,0,0,3739,119,MR
2020-03-20,1,0,1,0,MS
2020-03-21,0,0,1,0,MS
2020-03-22,0,0,1,0,MS
2020-03-23,0,0,1,0,MS
2020-03-24,0,0,1,0,MS
2020-03-25,0,0,1,0,MS
2020-03-26,4,0,5,0,MS
2020-03-27,0,0,5,0,MS
2020-03-28,0,0,5,0,MS
2020-03-29,0,0,5,0,MS
2020-03-30,0,0,5,0,MS
2020-04-01,0,0,5,0,MS
2020-04-02,0,0,5,0,MS
2020-04-03,0,0,5,0,MS
2020-04-04,1,0,6,0,MS
2020-04-05,0,0,6,0,MS
2020-04-06,0,0,6,0,MS
2020-04-07,0,0,6,0,MS
2020-04-08,3,0,9,0,MS
2020-04-09,0,0,9,0,MS
2020-04-10,0,0,9,0,MS
2020-04-11,0,0,9,0,MS
2020-04-12,2,0,11,0,MS
2020-04-13,0,0,11,0,MS
2020-04-14,0,0,11,0,MS
2020-04-15,0,0,11,0,MS
2020-04-16,0,0,11,0,MS
2020-04-17,0,0,11,0,MS
2020-04-18,0,0,11,0,MS
2020-04-19,0,0,11,0,MS
2020-04-20,0,0,11,0,MS
2020-04-21,0,0,11,0,MS
2020-04-22,0,0,11,0,MS
2020-04-23,0,0,11,0,MS
2020-04-24,0,0,11,0,MS
2020-04-25,0,1,11,1,MS
2020-04-26,0,0,11,1,MS
2020-04-27,0,0,11,1,MS
2020-04-28,0,0,11,1,MS
2020-04-29,0,0,11,1,MS
2020-04-30,0,0,11,1,MS
2020-05-01,0,0,11,1,MS
2020-05-02,0,0,11,1,MS
2020-05-03,0,0,11,1,MS
2020-05-04,0,0,11,1,MS
2020-05-05,0,0,11,1,MS
2020-05-06,0,0,11,1,MS
2020-05-07,0,0,11,1,MS
2020-05-08,0,0,11,1,MS
2020-05-09,0,0,11,1,MS
2020-05-10,0,0,11,1,MS
2020-05-11,0,0,11,1,MS
2020-05-12,0,0,11,1,MS
2020-05-13,0,0,11,1,MS
2020-05-14,0,0,11,1,MS
2020-05-15,0,0,11,1,MS
2020-05-16,0,0,11,1,MS
2020-05-17,0,0,11,1,MS
2020-05-18,0,0,11,1,MS
2020-05-19,0,0,11,1,MS
2020-05-20,0,0,11,1,MS
2020-05-21,0,0,11,1,MS
2020-05-22,0,0,11,1,MS
2020-05-23,0,0,11,1,MS
2020-05-24,0,0,11,1,MS
2020-05-25,0,0,11,1,MS
2020-05-26,0,0,11,1,MS
2020-05-27,0,0,11,1,MS
2020-05-28,0,0,11,1,MS
2020-05-29,0,0,11,1,MS
2020-05-30,0,0,11,1,MS
2020-05-31,0,0,11,1,MS
2020-06-01,0,0,11,1,MS
2020-06-02,0,0,11,1,MS
2020-06-03,0,0,11,1,MS
2020-06-04,0,0,11,1,MS
2020-06-05,0,0,11,1,MS
2020-06-06,0,0,11,1,MS
2020-06-07,0,0,11,1,MS
2020-06-08,0,0,11,1,MS
2020-06-09,0,0,11,1,MS
2020-06-10,0,0,11,1,MS
2020-06-11,0,0,11,1,MS
2020-06-12,0,0,11,1,MS
2020-06-13,0,0,11,1,MS
2020-06-14,0,0,11,1,MS
2020-06-15,0,0,11,1,MS
2020-06-16,0,0,11,1,MS
2020-06-17,0,0,11,1,MS
2020-06-18,0,0,11,1,MS
2020-06-19,0,0,11,1,MS
2020-06-20,0,0,11,1,MS
2020-06-21,0,0,11,1,MS
2020-06-22,0,0,11,1,MS
2020-06-23,0,0,11,1,MS
2020-06-24,0,0,11,1,MS
2020-06-25,0,0,11,1,MS
2020-06-26,0,0,11,1,MS
2020-03-06,1,0,1,0,MT
2020-03-07,2,0,3,0,MT
2020-03-08,0,0,3,0,MT
2020-03-09,2,0,5,0,MT
2020-03-10,1,0,6,0,MT
2020-03-11,1,0,7,0,MT
2020-03-12,1,0,8,0,MT
2020-03-13,10,0,18,0,MT
2020-03-14,2,0,20,0,MT
2020-03-15,10,0,30,0,MT
2020-03-16,8,0,38,0,MT
2020-03-17,10,0,48,0,MT
2020-03-18,4,0,52,0,MT
2020-03-19,12,0,64,0,MT
2020-03-20,9,0,73,0,MT
2020-03-21,17,0,90,0,MT
2020-03-22,17,0,107,0,MT
2020-03-23,5,0,112,0,MT
2020-03-24,17,0,129,0,MT
2020-03-25,5,0,134,0,MT
2020-03-26,5,0,139,0,MT
2020-03-27,10,0,149,0,MT
2020-03-28,2,0,151,0,MT
2020-03-29,5,0,156,0,MT
2020-03-30,9,0,165,0,MT
2020-03-31,19,0,184,0,MT
2020-04-01,10,0,194,0,MT
2020-04-02,7,0,201,0,MT
2020-04-03,5,0,206,0,MT
2020-04-04,12,0,218,0,MT
2020-04-05,17,0,235,0,MT
2020-04-06,19,0,254,0,MT
2020-04-07,44,0,298,0,MT
2020-04-08,9,1,307,1,MT
2020-04-09,35,1,342,2,MT
2020-04-10,18,0,360,2,MT
2020-04-11,13,1,373,3,MT
2020-04-12,11,0,384,3,MT
2020-04-13,1,0,385,3,MT
2020-04-14,8,0,393,3,MT
2020-04-15,15,0,408,3,MT
2020-04-16,5,0,413,3,MT
2020-04-17,9,0,422,3,MT
2020-04-18,4,0,426,3,MT
2020-04-19,2,0,428,3,MT
2020-04-20,5,0,433,3,MT
2020-04-21,11,0,444,3,MT
2020-04-22,1,0,445,3,MT
2020-04-23,1,0,446,3,MT
2020-04-24,1,0,447,3,MT
2020-04-25,1,1,448,4,MT
2020-04-26,0,0,448,4,MT
2020-04-27,2,0,450,4,MT
2020-04-28,0,0,450,4,MT
2020-04-29,13,0,463,4,MT
2020-04-30,2,0,465,4,MT
2020-05-01,2,0,467,4,MT
2020-05-02,0,0,467,4,MT
2020-05-03,10,0,477,4,MT
2020-05-04,3,0,480,4,MT
2020-05-05,2,1,482,5,MT
2020-05-06,2,0,484,5,MT
2020-05-07,2,0,486,5,MT
2020-05-08,3,0,489,5,MT
2020-05-09,1,0,490,5,MT
2020-05-10,6,0,496,5,MT
2020-05-11,7,0,503,5,MT
2020-05-12,0,0,503,5,MT
2020-05-13,5,1,508,6,MT
2020-05-14,14,0,522,6,MT
2020-05-15,10,0,532,6,MT
2020-05-16,14,0,546,6,MT
2020-05-17,7,0,553,6,MT
2020-05-18,5,0,558,6,MT
2020-05-19,2,0,560,6,MT
2020-05-20,24,0,584,6,MT
2020-05-21,15,0,599,6,MT
2020-05-22,1,0,600,6,MT
2020-05-23,9,0,609,6,MT
2020-05-24,1,0,610,6,MT
2020-05-25,1,0,611,6,MT
2020-05-26,0,0,611,6,MT
2020-05-27,4,1,615,7,MT
2020-05-28,1,0,616,7,MT
2020-05-29,0,0,616,7,MT
2020-05-30,0,0,616,7,MT
2020-05-31,0,0,616,7,MT
2020-06-01,3,2,619,9,MT
2020-06-02,1,0,620,9,MT
2020-06-03,2,0,622,9,MT
2020-06-04,0,0,622,9,MT
2020-06-05,0,0,622,9,MT
2020-06-06,0,0,622,9,MT
2020-06-07,7,0,629,9,MT
2020-06-08,1,0,630,9,MT
2020-06-09,2,0,632,9,MT
2020-06-10,3,0,635,9,MT
2020-06-11,5,0,640,9,MT
2020-06-12,5,0,645,9,MT
2020-06-13,1,0,646,9,MT
2020-06-14,2,0,648,9,MT
2020-06-15,2,0,650,9,MT
2020-06-16,6,0,656,9,MT
2020-06-17,6,0,662,9,MT
2020-06-18,1,0,663,9,MT
2020-06-19,0,0,663,9,MT
2020-06-20,1,0,664,9,MT
2020-06-21,1,0,665,9,MT
2020-06-22,0,0,665,9,MT
2020-06-23,0,0,665,9,MT
2020-06-24,0,0,665,9,MT
2020-06-25,3,0,668,9,MT
2020-06-26,2,0,670,9,MT
2020-03-19,3,0,3,0,MU
2020-03-20,9,0,12,0,MU
2020-03-21,2,1,14,1,MU
2020-03-22,14,1,28,2,MU
2020-03-23,8,0,36,2,MU
2020-03-24,6,0,42,2,MU
2020-03-25,6,0,48,2,MU
2020-03-26,33,0,81,2,MU
2020-03-27,13,0,94,2,MU
2020-03-28,8,0,102,2,MU
2020-03-29,8,1,110,3,MU
2020-03-30,18,0,128,3,MU
2020-03-31,15,0,143,3,MU
2020-04-01,11,2,154,5,MU
2020-04-02,15,2,169,7,MU
2020-04-03,17,0,186,7,MU
2020-04-04,10,0,196,7,MU
2020-04-05,31,0,227,7,MU
2020-04-06,17,0,244,7,MU
2020-04-07,24,0,268,7,MU
2020-04-08,5,0,273,7,MU
2020-04-09,41,0,314,7,MU
2020-04-10,4,2,318,9,MU
2020-04-11,1,0,319,9,MU
2020-04-12,5,0,324,9,MU
2020-04-13,0,0,324,9,MU
2020-04-14,0,0,324,9,MU
2020-04-15,0,0,324,9,MU
2020-04-16,0,0,324,9,MU
2020-04-17,0,0,324,9,MU
2020-04-18,1,0,325,9,MU
2020-04-19,3,0,328,9,MU
2020-04-20,0,0,328,9,MU
2020-04-21,0,0,328,9,MU
2020-04-22,1,0,329,9,MU
2020-04-23,2,0,331,9,MU
2020-04-24,0,0,331,9,MU
2020-04-25,0,0,331,9,MU
2020-04-26,1,0,332,9,MU
2020-04-27,0,1,332,10,MU
2020-04-28,0,0,332,10,MU
2020-04-29,0,0,332,10,MU
2020-04-30,0,0,332,10,MU
2020-05-01,0,0,332,10,MU
2020-05-02,0,0,332,10,MU
2020-05-03,0,0,332,10,MU
2020-05-04,0,0,332,10,MU
2020-05-05,0,0,332,10,MU
2020-05-06,0,0,332,10,MU
2020-05-07,0,0,332,10,MU
2020-05-08,0,0,332,10,MU
2020-05-09,0,0,332,10,MU
2020-05-10,0,0,332,10,MU
2020-05-11,0,0,332,10,MU
2020-05-12,0,0,332,10,MU
2020-05-13,0,0,332,10,MU
2020-05-14,0,0,332,10,MU
2020-05-15,0,0,332,10,MU
2020-05-16,0,0,332,10,MU
2020-05-17,0,0,332,10,MU
2020-05-18,0,0,332,10,MU
2020-05-19,0,0,332,10,MU
2020-05-20,0,0,332,10,MU
2020-05-21,0,0,332,10,MU
2020-05-22,0,0,332,10,MU
2020-05-23,0,0,332,10,MU
2020-05-24,2,0,334,10,MU
2020-05-25,0,0,334,10,MU
2020-05-26,0,0,334,10,MU
2020-05-27,0,0,334,10,MU
2020-05-28,0,0,334,10,MU
2020-05-29,1,0,335,10,MU
2020-05-30,0,0,335,10,MU
2020-05-31,0,0,335,10,MU
2020-06-01,0,0,335,10,MU
2020-06-02,0,0,335,10,MU
2020-06-03,0,0,335,10,MU
2020-06-04,0,0,335,10,MU
2020-06-05,2,0,337,10,MU
2020-06-06,0,0,337,10,MU
2020-06-07,0,0,337,10,MU
2020-06-08,0,0,337,10,MU
2020-06-09,0,0,337,10,MU
2020-06-10,0,0,337,10,MU
2020-06-11,0,0,337,10,MU
2020-06-12,0,0,337,10,MU
2020-06-13,0,0,337,10,MU
2020-06-14,0,0,337,10,MU
2020-06-15,0,0,337,10,MU
2020-06-16,0,0,337,10,MU
2020-06-17,0,0,337,10,MU
2020-06-18,0,0,337,10,MU
2020-06-19,0,0,337,10,MU
2020-06-20,0,0,337,10,MU
2020-06-21,0,0,337,10,MU
2020-06-22,3,0,340,10,MU
2020-06-23,0,0,340,10,MU
2020-06-24,1,0,341,10,MU
2020-06-25,0,0,341,10,MU
2020-06-26,0,0,341,10,MU
2020-03-07,2,0,2,0,MV
2020-03-08,2,0,4,0,MV
2020-03-10,2,0,6,0,MV
2020-03-11,2,0,8,0,MV
2020-03-13,1,0,9,0,MV
2020-03-14,0,0,9,0,MV
2020-03-15,4,0,13,0,MV
2020-03-16,0,0,13,0,MV
2020-03-17,0,0,13,0,MV
2020-03-18,0,0,13,0,MV
2020-03-19,0,0,13,0,MV
2020-03-20,0,0,13,0,MV
2020-03-21,0,0,13,0,MV
2020-03-22,0,0,13,0,MV
2020-03-23,0,0,13,0,MV
2020-03-24,0,0,13,0,MV
2020-03-25,0,0,13,0,MV
2020-03-26,0,0,13,0,MV
2020-03-27,1,0,14,0,MV
2020-03-28,2,0,16,0,MV
2020-03-29,1,0,17,0,MV
2020-03-30,0,0,17,0,MV
2020-03-31,1,0,18,0,MV
2020-04-01,1,0,19,0,MV
2020-04-02,0,0,19,0,MV
2020-04-03,0,0,19,0,MV
2020-04-04,0,0,19,0,MV
2020-04-05,0,0,19,0,MV
2020-04-06,0,0,19,0,MV
2020-04-07,0,0,19,0,MV
2020-04-08,0,0,19,0,MV
2020-04-09,0,0,19,0,MV
2020-04-10,0,0,19,0,MV
2020-04-11,0,0,19,0,MV
2020-04-12,1,0,20,0,MV
2020-04-13,0,0,20,0,MV
2020-04-14,1,0,21,0,MV
2020-04-15,0,0,21,0,MV
2020-04-16,4,0,25,0,MV
2020-04-17,4,0,29,0,MV
2020-04-18,6,0,35,0,MV
2020-04-19,17,0,52,0,MV
2020-04-20,17,0,69,0,MV
2020-04-21,16,0,85,0,MV
2020-04-22,0,0,85,0,MV
2020-04-23,25,0,110,0,MV
2020-04-24,18,0,128,0,MV
2020-04-25,9,0,137,0,MV
2020-04-26,77,0,214,0,MV
2020-04-27,0,0,214,0,MV
2020-04-28,31,0,245,0,MV
2020-04-29,32,0,277,0,MV
2020-04-30,191,1,468,1,MV
2020-05-01,23,0,491,1,MV
2020-05-02,28,0,519,1,MV
2020-05-03,8,0,527,1,MV
2020-05-04,24,0,551,1,MV
2020-05-05,22,0,573,1,MV
2020-05-06,44,1,617,2,MV
2020-05-07,25,1,642,3,MV
2020-05-08,2,0,644,3,MV
2020-05-09,146,0,790,3,MV
2020-05-10,45,0,835,3,MV
2020-05-11,62,0,897,3,MV
2020-05-12,7,0,904,3,MV
2020-05-13,51,1,955,4,MV
2020-05-14,27,0,982,4,MV
2020-05-15,49,0,1031,4,MV
2020-05-16,47,0,1078,4,MV
2020-05-17,16,0,1094,4,MV
2020-05-18,12,0,1106,4,MV
2020-05-19,37,0,1143,4,MV
2020-05-20,43,0,1186,4,MV
2020-05-21,30,0,1216,4,MV
2020-05-22,58,0,1274,4,MV
2020-05-23,29,0,1303,4,MV
2020-05-24,68,0,1371,4,MV
2020-05-25,24,0,1395,4,MV
2020-05-26,43,1,1438,5,MV
2020-05-27,19,0,1457,5,MV
2020-05-28,56,0,1513,5,MV
2020-05-29,78,0,1591,5,MV
2020-05-30,81,0,1672,5,MV
2020-05-31,101,0,1773,5,MV
2020-06-01,56,1,1829,6,MV
2020-06-02,12,1,1841,7,MV
2020-06-03,9,0,1850,7,MV
2020-06-04,22,0,1872,7,MV
2020-06-05,11,0,1883,7,MV
2020-06-06,18,0,1901,7,MV
2020-06-07,2,1,1903,8,MV
2020-06-08,13,0,1916,8,MV
2020-06-09,26,0,1942,8,MV
2020-06-10,20,0,1962,8,MV
2020-06-11,14,0,1976,8,MV
2020-06-12,27,0,2003,8,MV
2020-06-13,10,0,2013,8,MV
2020-06-14,22,0,2035,8,MV
2020-06-15,30,0,2065,8,MV
2020-06-16,29,0,2094,8,MV
2020-06-17,26,0,2120,8,MV
2020-06-18,17,0,2137,8,MV
2020-06-19,13,0,2150,8,MV
2020-06-20,37,0,2187,8,MV
2020-06-21,16,0,2203,8,MV
2020-06-22,14,0,2217,8,MV
2020-06-23,21,0,2238,8,MV
2020-06-24,23,0,2261,8,MV
2020-06-25,16,0,2277,8,MV
2020-06-26,6,0,2283,8,MV
2020-04-02,3,0,3,0,MW
2020-04-03,0,0,3,0,MW
2020-04-04,1,0,4,0,MW
2020-04-05,0,0,4,0,MW
2020-04-06,1,0,5,0,MW
2020-04-07,3,1,8,1,MW
2020-04-08,0,0,8,1,MW
2020-04-09,0,0,8,1,MW
2020-04-10,1,0,9,1,MW
2020-04-11,3,1,12,2,MW
2020-04-12,1,0,13,2,MW
2020-04-13,3,0,16,2,MW
2020-04-14,0,0,16,2,MW
2020-04-15,0,0,16,2,MW
2020-04-16,0,0,16,2,MW
2020-04-17,1,0,17,2,MW
2020-04-18,0,0,17,2,MW
2020-04-19,0,0,17,2,MW
2020-04-20,0,0,17,2,MW
2020-04-21,1,0,18,2,MW
2020-04-22,5,1,23,3,MW
2020-04-23,10,0,33,3,MW
2020-04-24,0,0,33,3,MW
2020-04-25,0,0,33,3,MW
2020-04-26,1,0,34,3,MW
2020-04-27,2,0,36,3,MW
2020-04-28,0,0,36,3,MW
2020-04-29,0,0,36,3,MW
2020-04-30,1,0,37,3,MW
2020-05-01,0,0,37,3,MW
2020-05-02,1,0,38,3,MW
2020-05-03,1,0,39,3,MW
2020-05-04,2,0,41,3,MW
2020-05-05,0,0,41,3,MW
2020-05-06,2,0,43,3,MW
2020-05-07,0,0,43,3,MW
2020-05-08,0,0,43,3,MW
2020-05-09,13,0,56,3,MW
2020-05-10,0,0,56,3,MW
2020-05-11,1,0,57,3,MW
2020-05-12,1,0,58,3,MW
2020-05-13,5,0,63,3,MW
2020-05-14,0,0,63,3,MW
2020-05-15,0,0,63,3,MW
2020-05-16,2,0,65,3,MW
2020-05-17,5,0,70,3,MW
2020-05-18,0,0,70,3,MW
2020-05-19,1,0,71,3,MW
2020-05-20,1,0,72,3,MW
2020-05-21,0,0,72,3,MW
2020-05-22,10,0,82,3,MW
2020-05-23,1,1,83,4,MW
2020-05-24,0,0,83,4,MW
2020-05-25,18,0,101,4,MW
2020-05-26,0,0,101,4,MW
2020-05-27,0,0,101,4,MW
2020-05-28,102,0,203,4,MW
2020-05-29,70,0,273,4,MW
2020-05-30,6,0,279,4,MW
2020-05-31,5,0,284,4,MW
2020-06-01,52,0,336,4,MW
2020-06-02,22,0,358,4,MW
2020-06-03,11,0,369,4,MW
2020-06-04,24,0,393,4,MW
2020-06-05,16,0,409,4,MW
2020-06-06,0,0,409,4,MW
2020-06-07,29,0,438,4,MW
2020-06-08,5,0,443,4,MW
2020-06-09,12,0,455,4,MW
2020-06-10,0,0,455,4,MW
2020-06-11,26,0,481,4,MW
2020-06-12,0,0,481,4,MW
2020-06-13,48,1,529,5,MW
2020-06-14,18,1,547,6,MW
2020-06-15,9,0,556,6,MW
2020-06-16,8,0,564,6,MW
2020-06-17,8,0,572,6,MW
2020-06-18,20,2,592,8,MW
2020-06-19,28,0,620,8,MW
2020-06-20,0,0,620,8,MW
2020-06-21,110,3,730,11,MW
2020-06-22,73,0,803,11,MW
2020-06-23,45,0,848,11,MW
2020-06-24,93,0,941,11,MW
2020-06-25,19,1,960,12,MW
2020-06-26,45,1,1005,13,MW
2019-12-30,0,0,0,0,MX
2019-12-31,0,0,0,0,MX
2020-01-01,0,0,0,0,MX
2020-01-02,0,0,0,0,MX
2020-01-03,0,0,0,0,MX
2020-01-04,0,0,0,0,MX
2020-01-05,0,0,0,0,MX
2020-01-06,0,0,0,0,MX
2020-01-07,0,0,0,0,MX
2020-01-08,0,0,0,0,MX
2020-01-09,0,0,0,0,MX
2020-01-10,0,0,0,0,MX
2020-01-11,0,0,0,0,MX
2020-01-12,0,0,0,0,MX
2020-01-13,0,0,0,0,MX
2020-01-14,0,0,0,0,MX
2020-01-15,0,0,0,0,MX
2020-01-16,0,0,0,0,MX
2020-01-17,0,0,0,0,MX
2020-01-18,0,0,0,0,MX
2020-01-19,0,0,0,0,MX
2020-01-20,0,0,0,0,MX
2020-01-21,0,0,0,0,MX
2020-01-22,0,0,0,0,MX
2020-01-23,0,0,0,0,MX
2020-01-24,0,0,0,0,MX
2020-01-25,0,0,0,0,MX
2020-01-26,0,0,0,0,MX
2020-01-27,0,0,0,0,MX
2020-01-28,0,0,0,0,MX
2020-01-29,0,0,0,0,MX
2020-01-30,0,0,0,0,MX
2020-01-31,0,0,0,0,MX
2020-02-01,0,0,0,0,MX
2020-02-02,0,0,0,0,MX
2020-02-03,0,0,0,0,MX
2020-02-04,0,0,0,0,MX
2020-02-05,0,0,0,0,MX
2020-02-06,0,0,0,0,MX
2020-02-07,0,0,0,0,MX
2020-02-08,0,0,0,0,MX
2020-02-09,0,0,0,0,MX
2020-02-10,0,0,0,0,MX
2020-02-11,0,0,0,0,MX
2020-02-12,0,0,0,0,MX
2020-02-13,0,0,0,0,MX
2020-02-14,0,0,0,0,MX
2020-02-15,0,0,0,0,MX
2020-02-16,0,0,0,0,MX
2020-02-17,0,0,0,0,MX
2020-02-18,0,0,0,0,MX
2020-02-19,0,0,0,0,MX
2020-02-20,0,0,0,0,MX
2020-02-21,0,0,0,0,MX
2020-02-22,0,0,0,0,MX
2020-02-23,0,0,0,0,MX
2020-02-24,0,0,0,0,MX
2020-02-25,0,0,0,0,MX
2020-02-26,0,0,0,0,MX
2020-02-27,0,0,0,0,MX
2020-02-28,2,0,2,0,MX
2020-02-29,2,0,4,0,MX
2020-03-01,1,0,5,0,MX
2020-03-08,2,0,7,0,MX
2020-03-11,4,0,11,0,MX
2020-03-12,5,0,16,0,MX
2020-03-13,10,0,26,0,MX
2020-03-14,15,0,41,0,MX
2020-03-15,12,0,53,0,MX
2020-03-16,29,0,82,0,MX
2020-03-17,11,0,93,0,MX
2020-03-18,25,0,118,0,MX
2020-03-19,46,0,164,0,MX
2020-03-20,39,2,203,2,MX
2020-03-21,48,0,251,2,MX
2020-03-22,65,0,316,2,MX
2020-03-23,51,2,367,4,MX
2020-03-24,38,1,405,5,MX
2020-03-25,70,0,475,5,MX
2020-03-26,110,3,585,8,MX
2020-03-27,132,4,717,12,MX
2020-03-28,131,4,848,16,MX
2020-03-29,145,4,993,20,MX
2020-03-30,101,8,1094,28,MX
2020-03-31,121,1,1215,29,MX
2020-04-01,163,8,1378,37,MX
2020-04-02,132,13,1510,50,MX
2020-04-03,178,10,1688,60,MX
2020-04-04,202,19,1890,79,MX
2020-04-05,253,15,2143,94,MX
2020-04-06,296,31,2439,125,MX
2020-04-07,346,16,2785,141,MX
2020-04-08,396,33,3181,174,MX
2020-04-09,260,20,3441,194,MX
2020-04-10,403,39,3844,233,MX
2020-04-11,375,40,4219,273,MX
2020-04-12,442,23,4661,296,MX
2020-04-13,353,36,5014,332,MX
2020-04-14,385,74,5399,406,MX
2020-04-15,448,43,5847,449,MX
2020-04-16,450,37,6297,486,MX
2020-04-17,578,60,6875,546,MX
2020-04-18,622,104,7497,650,MX
2020-04-19,764,36,8261,686,MX
2020-04-20,511,26,8772,712,MX
2020-04-21,729,145,9501,857,MX
2020-04-22,1043,113,10544,970,MX
2020-04-23,1089,99,11633,1069,MX
2020-04-24,1239,152,12872,1221,MX
2020-04-25,970,84,13842,1305,MX
2020-04-26,835,46,14677,1351,MX
2020-04-27,852,83,15529,1434,MX
2020-04-28,1223,135,16752,1569,MX
2020-04-29,1047,163,17799,1732,MX
2020-04-30,1425,127,19224,1859,MX
2020-05-01,1515,113,20739,1972,MX
2020-05-02,1349,89,22088,2061,MX
2020-05-03,1383,93,23471,2154,MX
2020-05-04,1434,117,24905,2271,MX
2020-05-05,1120,236,26025,2507,MX
2020-05-06,1609,197,27634,2704,MX
2020-05-07,1982,257,29616,2961,MX
2020-05-08,1906,199,31522,3160,MX
2020-05-09,1938,193,33460,3353,MX
2020-05-10,1562,112,35022,3465,MX
2020-05-11,1305,108,36327,3573,MX
2020-05-12,1997,353,38324,3926,MX
2020-05-13,1862,294,40186,4220,MX
2020-05-14,2409,257,42595,4477,MX
2020-05-15,2437,290,45032,4767,MX
2020-05-16,2112,278,47144,5045,MX
2020-05-17,2075,132,49219,5177,MX
2020-05-18,2414,155,51633,5332,MX
2020-05-19,2713,334,54346,5666,MX
2020-05-20,2248,424,56594,6090,MX
2020-05-21,2973,420,59567,6510,MX
2020-05-22,2960,479,62527,6989,MX
2020-05-23,3329,190,65856,7179,MX
2020-05-24,2764,215,68620,7394,MX
2020-05-25,2485,239,71105,7633,MX
2020-05-26,3455,501,74560,8134,MX
2020-05-27,3463,463,78023,8597,MX
2020-05-28,3377,447,81400,9044,MX
2020-05-29,3227,371,84627,9415,MX
2020-05-30,2885,364,87512,9779,MX
2020-05-31,3152,151,90664,9930,MX
2020-06-01,2771,237,93435,10167,MX
2020-06-02,3891,470,97326,10637,MX
2020-06-03,3912,1091,101238,11728,MX
2020-06-04,4442,817,105680,12545,MX
2020-06-05,4346,625,110026,13170,MX
2020-06-06,3593,341,113619,13511,MX
2020-06-07,3484,188,117103,13699,MX
2020-06-08,2999,354,120102,14053,MX
2020-06-09,4199,596,124301,14649,MX
2020-06-10,4883,708,129184,15357,MX
2020-06-11,4790,587,133974,15944,MX
2020-06-12,5222,504,139196,16448,MX
2020-06-13,3494,424,142690,16872,MX
2020-06-14,4147,269,146837,17141,MX
2020-06-15,3427,439,150264,17580,MX
2020-06-16,4599,730,154863,18310,MX
2020-06-17,4930,770,159793,19080,MX
2020-06-18,5662,667,165455,19747,MX
2020-06-19,5030,647,170485,20394,MX
2020-06-20,4717,387,175202,20781,MX
2020-06-21,5343,1044,180545,21825,MX
2020-06-22,4577,759,185122,22584,MX
2020-06-23,6288,793,191410,23377,MX
2020-06-24,5437,965,196847,24342,MX
2020-06-25,6104,718,202951,25060,MX
2020-06-26,5441,719,208392,25779,MX
2019-12-30,0,0,0,0,MY
2019-12-31,0,0,0,0,MY
2020-01-01,0,0,0,0,MY
2020-01-02,0,0,0,0,MY
2020-01-03,0,0,0,0,MY
2020-01-04,0,0,0,0,MY
2020-01-05,0,0,0,0,MY
2020-01-06,0,0,0,0,MY
2020-01-07,0,0,0,0,MY
2020-01-08,0,0,0,0,MY
2020-01-09,0,0,0,0,MY
2020-01-10,0,0,0,0,MY
2020-01-11,0,0,0,0,MY
2020-01-12,0,0,0,0,MY
2020-01-13,0,0,0,0,MY
2020-01-14,0,0,0,0,MY
2020-01-15,0,0,0,0,MY
2020-01-16,0,0,0,0,MY
2020-01-17,0,0,0,0,MY
2020-01-18,0,0,0,0,MY
2020-01-19,0,0,0,0,MY
2020-01-20,0,0,0,0,MY
2020-01-21,0,0,0,0,MY
2020-01-22,0,0,0,0,MY
2020-01-23,0,0,0,0,MY
2020-01-24,3,0,3,0,MY
2020-01-25,1,0,4,0,MY
2020-01-26,0,0,4,0,MY
2020-01-27,0,0,4,0,MY
2020-01-28,3,0,7,0,MY
2020-01-29,0,0,7,0,MY
2020-01-30,1,0,8,0,MY
2020-01-31,0,0,8,0,MY
2020-02-01,0,0,8,0,MY
2020-02-02,0,0,8,0,MY
2020-02-03,0,0,8,0,MY
2020-02-04,2,0,10,0,MY
2020-02-05,2,0,12,0,MY
2020-02-06,2,0,14,0,MY
2020-02-07,1,0,15,0,MY
2020-02-08,1,0,16,0,MY
2020-02-09,2,0,18,0,MY
2020-02-10,0,0,18,0,MY
2020-02-11,0,0,18,0,MY
2020-02-12,0,0,18,0,MY
2020-02-13,1,0,19,0,MY
2020-02-14,2,0,21,0,MY
2020-02-15,1,0,22,0,MY
2020-02-16,0,0,22,0,MY
2020-02-17,0,0,22,0,MY
2020-02-18,0,0,22,0,MY
2020-02-19,0,0,22,0,MY
2020-02-20,0,0,22,0,MY
2020-02-21,0,0,22,0,MY
2020-02-22,0,0,22,0,MY
2020-02-23,0,0,22,0,MY
2020-02-24,0,0,22,0,MY
2020-02-25,0,0,22,0,MY
2020-02-26,0,0,22,0,MY
2020-02-27,1,0,23,0,MY
2020-02-28,2,0,25,0,MY
2020-02-29,0,0,25,0,MY
2020-03-01,4,0,29,0,MY
2020-03-03,7,0,36,0,MY
2020-03-04,14,0,50,0,MY
2020-03-05,0,0,50,0,MY
2020-03-06,33,0,83,0,MY
2020-03-07,10,0,93,0,MY
2020-03-08,6,0,99,0,MY
2020-03-09,18,0,117,0,MY
2020-03-10,12,0,129,0,MY
2020-03-11,20,0,149,0,MY
2020-03-12,9,0,158,0,MY
2020-03-13,39,0,197,0,MY
2020-03-14,41,0,238,0,MY
2020-03-15,190,0,428,0,MY
2020-03-16,125,0,553,0,MY
2020-03-17,120,2,673,2,MY
2020-03-18,117,0,790,2,MY
2020-03-19,110,0,900,2,MY
2020-03-20,130,0,1030,2,MY
2020-03-21,153,2,1183,4,MY
2020-03-22,123,6,1306,10,MY
2020-03-23,212,4,1518,14,MY
2020-03-24,106,1,1624,15,MY
2020-03-25,172,4,1796,19,MY
2020-03-26,235,4,2031,23,MY
2020-03-27,130,3,2161,26,MY
2020-03-28,159,1,2320,27,MY
2020-03-29,150,7,2470,34,MY
2020-03-30,156,3,2626,37,MY
2020-03-31,140,6,2766,43,MY
2020-04-01,142,2,2908,45,MY
2020-04-02,208,5,3116,50,MY
2020-04-03,217,3,3333,53,MY
2020-04-04,150,4,3483,57,MY
2020-04-05,179,4,3662,61,MY
2020-04-06,131,1,3793,62,MY
2020-04-07,170,1,3963,63,MY
2020-04-08,156,2,4119,65,MY
2020-04-09,109,2,4228,67,MY
2020-04-10,118,3,4346,70,MY
2020-04-11,184,3,4530,73,MY
2020-04-12,153,3,4683,76,MY
2020-04-13,134,1,4817,77,MY
2020-04-14,170,5,4987,82,MY
2020-04-15,85,1,5072,83,MY
2020-04-16,110,1,5182,84,MY
2020-04-17,69,2,5251,86,MY
2020-04-18,54,2,5305,88,MY
2020-04-19,84,1,5389,89,MY
2020-04-20,36,0,5425,89,MY
2020-04-21,57,3,5482,92,MY
2020-04-22,50,1,5532,93,MY
2020-04-23,71,2,5603,95,MY
2020-04-24,88,1,5691,96,MY
2020-04-25,51,2,5742,98,MY
2020-04-26,38,0,5780,98,MY
2020-04-27,40,1,5820,99,MY
2020-04-28,31,1,5851,100,MY
2020-04-29,94,0,5945,100,MY
2020-04-30,57,2,6002,102,MY
2020-05-01,69,1,6071,103,MY
2020-05-02,105,0,6176,103,MY
2020-05-03,122,2,6298,105,MY
2020-05-04,55,0,6353,105,MY
2020-05-05,30,1,6383,106,MY
2020-05-06,45,1,6428,107,MY
2020-05-07,39,0,6467,107,MY
2020-05-08,68,0,6535,107,MY
2020-05-09,54,1,6589,108,MY
2020-05-10,67,0,6656,108,MY
2020-05-11,70,1,6726,109,MY
2020-05-12,16,0,6742,109,MY
2020-05-13,37,2,6779,111,MY
2020-05-14,40,1,6819,112,MY
2020-05-15,36,0,6855,112,MY
2020-05-16,17,1,6872,113,MY
2020-05-17,22,0,6894,113,MY
2020-05-18,47,0,6941,113,MY
2020-05-19,37,1,6978,114,MY
2020-05-20,31,0,7009,114,MY
2020-05-21,50,0,7059,114,MY
2020-05-22,78,1,7137,115,MY
2020-05-23,48,0,7185,115,MY
2020-05-24,60,0,7245,115,MY
2020-05-25,172,0,7417,115,MY
2020-05-26,187,0,7604,115,MY
2020-05-27,15,0,7619,115,MY
2020-05-28,10,0,7629,115,MY
2020-05-29,103,0,7732,115,MY
2020-05-30,30,0,7762,115,MY
2020-05-31,57,0,7819,115,MY
2020-06-01,38,0,7857,115,MY
2020-06-02,20,0,7877,115,MY
2020-06-03,93,0,7970,115,MY
2020-06-04,0,0,7970,115,MY
2020-06-05,296,1,8266,116,MY
2020-06-06,37,1,8303,117,MY
2020-06-07,19,0,8322,117,MY
2020-06-08,7,0,8329,117,MY
2020-06-09,7,0,8336,117,MY
2020-06-10,2,1,8338,118,MY
2020-06-11,31,0,8369,118,MY
2020-06-12,33,1,8402,119,MY
2020-06-13,43,1,8445,120,MY
2020-06-14,8,1,8453,121,MY
2020-06-15,41,0,8494,121,MY
2020-06-16,11,0,8505,121,MY
2020-06-17,10,0,8515,121,MY
2020-06-18,14,0,8529,121,MY
2020-06-19,6,0,8535,121,MY
2020-06-20,21,0,8556,121,MY
2020-06-21,16,0,8572,121,MY
2020-06-22,15,0,8587,121,MY
2020-06-23,3,0,8590,121,MY
2020-06-24,6,0,8596,121,MY
2020-06-25,4,0,8600,121,MY
2020-06-26,6,0,8606,121,MY
2020-03-22,1,0,1,0,MZ
2020-03-23,0,0,1,0,MZ
2020-03-24,0,0,1,0,MZ
2020-03-25,4,0,5,0,MZ
2020-03-26,2,0,7,0,MZ
2020-03-27,0,0,7,0,MZ
2020-03-28,1,0,8,0,MZ
2020-03-29,0,0,8,0,MZ
2020-03-30,0,0,8,0,MZ
2020-03-31,0,0,8,0,MZ
2020-04-01,2,0,10,0,MZ
2020-04-02,0,0,10,0,MZ
2020-04-03,0,0,10,0,MZ
2020-04-04,0,0,10,0,MZ
2020-04-05,0,0,10,0,MZ
2020-04-06,0,0,10,0,MZ
2020-04-07,0,0,10,0,MZ
2020-04-08,7,0,17,0,MZ
2020-04-09,0,0,17,0,MZ
2020-04-10,3,0,20,0,MZ
2020-04-11,0,0,20,0,MZ
2020-04-12,1,0,21,0,MZ
2020-04-13,6,0,27,0,MZ
2020-04-14,1,0,28,0,MZ
2020-04-15,1,0,29,0,MZ
2020-04-16,2,0,31,0,MZ
2020-04-17,3,0,34,0,MZ
2020-04-18,1,0,35,0,MZ
2020-04-19,4,0,39,0,MZ
2020-04-20,0,0,39,0,MZ
2020-04-21,0,0,39,0,MZ
2020-04-22,2,0,41,0,MZ
2020-04-23,5,0,46,0,MZ
2020-04-24,19,0,65,0,MZ
2020-04-25,5,0,70,0,MZ
2020-04-26,6,0,76,0,MZ
2020-04-27,0,0,76,0,MZ
2020-04-28,0,0,76,0,MZ
2020-04-29,0,0,76,0,MZ
2020-04-30,0,0,76,0,MZ
2020-05-01,3,0,79,0,MZ
2020-05-02,0,0,79,0,MZ
2020-05-03,1,0,80,0,MZ
2020-05-04,0,0,80,0,MZ
2020-05-05,1,0,81,0,MZ
2020-05-06,0,0,81,0,MZ
2020-05-07,0,0,81,0,MZ
2020-05-08,1,0,82,0,MZ
2020-05-09,5,0,87,0,MZ
2020-05-10,4,0,91,0,MZ
2020-05-11,12,0,103,0,MZ
2020-05-12,1,0,104,0,MZ
2020-05-13,3,0,107,0,MZ
2020-05-14,8,0,115,0,MZ
2020-05-15,4,0,119,0,MZ
2020-05-16,10,0,129,0,MZ
2020-05-17,8,0,137,0,MZ
2020-05-18,8,0,145,0,MZ
2020-05-19,1,0,146,0,MZ
2020-05-20,10,0,156,0,MZ
2020-05-21,6,0,162,0,MZ
2020-05-22,2,0,164,0,MZ
2020-05-23,4,0,168,0,MZ
2020-05-24,26,0,194,0,MZ
2020-05-25,15,1,209,1,MZ
2020-05-26,4,0,213,1,MZ
2020-05-27,14,0,227,1,MZ
2020-05-28,6,1,233,2,MZ
2020-05-29,1,0,234,2,MZ
2020-05-30,10,0,244,2,MZ
2020-05-31,10,0,254,2,MZ
2020-06-01,0,0,254,2,MZ
2020-06-02,53,0,307,2,MZ
2020-06-03,9,0,316,2,MZ
2020-06-04,36,0,352,2,MZ
2020-06-05,2,0,354,2,MZ
2020-06-06,57,0,411,2,MZ
2020-06-07,15,0,426,2,MZ
2020-06-08,7,0,433,2,MZ
2020-06-09,20,0,453,2,MZ
2020-06-10,19,0,472,2,MZ
2020-06-11,17,0,489,2,MZ
2020-06-12,20,0,509,2,MZ
2020-06-13,44,0,553,2,MZ
2020-06-14,30,1,583,3,MZ
2020-06-15,26,0,609,3,MZ
2020-06-16,29,1,638,4,MZ
2020-06-17,13,0,651,4,MZ
2020-06-18,11,0,662,4,MZ
2020-06-19,6,0,668,4,MZ
2020-06-20,20,0,688,4,MZ
2020-06-21,45,1,733,5,MZ
2020-06-22,4,0,737,5,MZ
2020-06-23,20,0,757,5,MZ
2020-06-24,5,0,762,5,MZ
2020-06-25,26,0,788,5,MZ
2020-06-26,28,0,816,5,MZ
2020-03-15,2,0,2,0,NA
2020-03-16,0,0,2,0,NA
2020-03-17,0,0,2,0,NA
2020-03-18,0,0,2,0,NA
2020-03-19,0,0,2,0,NA
2020-03-20,0,0,2,0,NA
2020-03-21,1,0,3,0,NA
2020-03-22,0,0,3,0,NA
2020-03-23,0,0,3,0,NA
2020-03-24,0,0,3,0,NA
2020-03-25,0,0,3,0,NA
2020-03-26,1,0,4,0,NA
2020-03-27,4,0,8,0,NA
2020-03-28,0,0,8,0,NA
2020-03-29,0,0,8,0,NA
2020-03-30,3,0,11,0,NA
2020-03-31,0,0,11,0,NA
2020-04-01,0,0,11,0,NA
2020-04-02,2,0,13,0,NA
2020-04-03,0,0,13,0,NA
2020-04-04,1,0,14,0,NA
2020-04-05,0,0,14,0,NA
2020-04-06,2,0,16,0,NA
2020-04-07,0,0,16,0,NA
2020-04-08,0,0,16,0,NA
2020-04-09,0,0,16,0,NA
2020-04-10,0,0,16,0,NA
2020-04-11,0,0,16,0,NA
2020-04-12,0,0,16,0,NA
2020-04-13,0,0,16,0,NA
2020-04-14,0,0,16,0,NA
2020-04-15,0,0,16,0,NA
2020-04-16,0,0,16,0,NA
2020-04-17,0,0,16,0,NA
2020-04-18,0,0,16,0,NA
2020-04-19,0,0,16,0,NA
2020-04-20,0,0,16,0,NA
2020-04-21,0,0,16,0,NA
2020-04-22,0,0,16,0,NA
2020-04-23,0,0,16,0,NA
2020-04-24,0,0,16,0,NA
2020-04-25,0,0,16,0,NA
2020-04-26,0,0,16,0,NA
2020-04-27,0,0,16,0,NA
2020-04-28,0,0,16,0,NA
2020-04-29,0,0,16,0,NA
2020-04-30,0,0,16,0,NA
2020-05-01,0,0,16,0,NA
2020-05-02,0,0,16,0,NA
2020-05-03,0,0,16,0,NA
2020-05-04,0,0,16,0,NA
2020-05-05,0,0,16,0,NA
2020-05-06,0,0,16,0,NA
2020-05-07,0,0,16,0,NA
2020-05-08,0,0,16,0,NA
2020-05-09,0,0,16,0,NA
2020-05-10,0,0,16,0,NA
2020-05-11,0,0,16,0,NA
2020-05-12,0,0,16,0,NA
2020-05-13,0,0,16,0,NA
2020-05-14,0,0,16,0,NA
2020-05-15,0,0,16,0,NA
2020-05-16,0,0,16,0,NA
2020-05-17,0,0,16,0,NA
2020-05-18,0,0,16,0,NA
2020-05-19,0,0,16,0,NA
2020-05-20,0,0,16,0,NA
2020-05-21,0,0,16,0,NA
2020-05-22,2,0,18,0,NA
2020-05-23,1,0,19,0,NA
2020-05-24,1,0,20,0,NA
2020-05-25,1,0,21,0,NA
2020-05-26,0,0,21,0,NA
2020-05-27,0,0,21,0,NA
2020-05-28,1,0,22,0,NA
2020-05-29,0,0,22,0,NA
2020-05-30,1,0,23,0,NA
2020-05-31,0,0,23,0,NA
2020-06-01,1,0,24,0,NA
2020-06-02,1,0,25,0,NA
2020-06-03,0,0,25,0,NA
2020-06-04,0,0,25,0,NA
2020-06-05,0,0,25,0,NA
2020-06-06,0,0,25,0,NA
2020-06-07,4,0,29,0,NA
2020-06-08,0,0,29,0,NA
2020-06-09,2,0,31,0,NA
2020-06-10,0,0,31,0,NA
2020-06-11,0,0,31,0,NA
2020-06-12,0,0,31,0,NA
2020-06-13,0,0,31,0,NA
2020-06-14,1,0,32,0,NA
2020-06-15,0,0,32,0,NA
2020-06-16,0,0,32,0,NA
2020-06-17,2,0,34,0,NA
2020-06-18,2,0,36,0,NA
2020-06-19,3,0,39,0,NA
2020-06-20,6,0,45,0,NA
2020-06-21,1,0,46,0,NA
2020-06-22,9,0,55,0,NA
2020-06-23,8,0,63,0,NA
2020-06-24,9,0,72,0,NA
2020-06-25,4,0,76,0,NA
2020-06-26,5,0,81,0,NA
2020-06-27,40,0,121,0,NA
2020-03-20,2,0,2,0,NC
2020-03-21,2,0,4,0,NC
2020-03-22,1,0,5,0,NC
2020-03-23,2,0,7,0,NC
2020-03-24,2,0,9,0,NC
2020-03-25,5,0,14,0,NC
2020-03-26,1,0,15,0,NC
2020-03-27,0,0,15,0,NC
2020-03-28,0,0,15,0,NC
2020-03-29,0,0,15,0,NC
2020-03-30,1,0,16,0,NC
2020-03-31,0,0,16,0,NC
2020-04-01,0,0,16,0,NC
2020-04-02,0,0,16,0,NC
2020-04-03,2,0,18,0,NC
2020-04-04,0,0,18,0,NC
2020-04-05,0,0,18,0,NC
2020-04-06,0,0,18,0,NC
2020-04-07,0,0,18,0,NC
2020-04-08,0,0,18,0,NC
2020-04-09,0,0,18,0,NC
2020-04-10,0,0,18,0,NC
2020-04-11,0,0,18,0,NC
2020-04-12,0,0,18,0,NC
2020-04-13,0,0,18,0,NC
2020-04-14,0,0,18,0,NC
2020-04-15,0,0,18,0,NC
2020-04-16,0,0,18,0,NC
2020-04-17,0,0,18,0,NC
2020-04-18,0,0,18,0,NC
2020-04-19,0,0,18,0,NC
2020-04-20,0,0,18,0,NC
2020-04-21,0,0,18,0,NC
2020-04-22,0,0,18,0,NC
2020-04-23,0,0,18,0,NC
2020-04-24,0,0,18,0,NC
2020-04-25,0,0,18,0,NC
2020-04-26,0,0,18,0,NC
2020-04-27,0,0,18,0,NC
2020-04-28,0,0,18,0,NC
2020-04-29,0,0,18,0,NC
2020-04-30,0,0,18,0,NC
2020-05-01,0,0,18,0,NC
2020-05-02,0,0,18,0,NC
2020-05-03,0,0,18,0,NC
2020-05-04,0,0,18,0,NC
2020-05-05,0,0,18,0,NC
2020-05-06,0,0,18,0,NC
2020-05-07,0,0,18,0,NC
2020-05-08,0,0,18,0,NC
2020-05-09,0,0,18,0,NC
2020-05-10,0,0,18,0,NC
2020-05-11,0,0,18,0,NC
2020-05-12,0,0,18,0,NC
2020-05-13,0,0,18,0,NC
2020-05-14,0,0,18,0,NC
2020-05-15,0,0,18,0,NC
2020-05-16,0,0,18,0,NC
2020-05-17,0,0,18,0,NC
2020-05-18,0,0,18,0,NC
2020-05-19,0,0,18,0,NC
2020-05-20,0,0,18,0,NC
2020-05-21,0,0,18,0,NC
2020-05-22,0,0,18,0,NC
2020-05-23,0,0,18,0,NC
2020-05-24,0,0,18,0,NC
2020-05-25,0,0,18,0,NC
2020-05-26,0,0,18,0,NC
2020-05-27,0,0,18,0,NC
2020-05-28,1,0,19,0,NC
2020-05-29,0,0,19,0,NC
2020-05-30,0,0,19,0,NC
2020-05-31,0,0,19,0,NC
2020-06-01,1,0,20,0,NC
2020-06-02,0,0,20,0,NC
2020-06-03,0,0,20,0,NC
2020-06-04,0,0,20,0,NC
2020-06-05,0,0,20,0,NC
2020-06-06,0,0,20,0,NC
2020-06-07,0,0,20,0,NC
2020-06-08,0,0,20,0,NC
2020-06-09,1,0,21,0,NC
2020-06-10,0,0,21,0,NC
2020-06-11,0,0,21,0,NC
2020-06-12,0,0,21,0,NC
2020-06-13,0,0,21,0,NC
2020-06-14,0,0,21,0,NC
2020-06-15,0,0,21,0,NC
2020-06-16,0,0,21,0,NC
2020-06-17,0,0,21,0,NC
2020-06-18,0,0,21,0,NC
2020-06-19,0,0,21,0,NC
2020-06-20,0,0,21,0,NC
2020-06-21,0,0,21,0,NC
2020-06-22,0,0,21,0,NC
2020-06-23,0,0,21,0,NC
2020-06-24,0,0,21,0,NC
2020-06-25,0,0,21,0,NC
2020-06-26,0,0,21,0,NC
2020-03-20,1,0,1,0,NE
2020-03-21,0,0,1,0,NE
2020-03-22,0,0,1,0,NE
2020-03-23,1,0,2,0,NE
2020-03-24,5,1,7,1,NE
2020-03-25,0,0,7,1,NE
2020-03-26,3,0,10,1,NE
2020-03-27,0,0,10,1,NE
2020-03-28,0,0,10,1,NE
2020-03-29,0,0,10,1,NE
2020-03-30,10,2,20,3,NE
2020-03-31,0,0,20,3,NE
2020-04-01,54,2,74,5,NE
2020-04-02,0,0,74,5,NE
2020-04-03,24,0,98,5,NE
2020-04-04,22,0,120,5,NE
2020-04-05,64,5,184,10,NE
2020-04-06,69,0,253,10,NE
2020-04-07,25,1,278,11,NE
2020-04-08,64,0,342,11,NE
2020-04-09,68,0,410,11,NE
2020-04-10,28,0,438,11,NE
2020-04-11,53,0,491,11,NE
2020-04-12,38,1,529,12,NE
2020-04-13,19,1,548,13,NE
2020-04-14,22,1,570,14,NE
2020-04-15,14,0,584,14,NE
2020-04-16,25,1,609,15,NE
2020-04-17,18,3,627,18,NE
2020-04-18,12,1,639,19,NE
2020-04-19,9,1,648,20,NE
2020-04-20,7,0,655,20,NE
2020-04-21,0,0,655,20,NE
2020-04-22,7,2,662,22,NE
2020-04-23,9,2,671,24,NE
2020-04-24,10,0,681,24,NE
2020-04-25,3,3,684,27,NE
2020-04-26,12,2,696,29,NE
2020-04-27,5,0,701,29,NE
2020-04-28,8,2,709,31,NE
2020-04-29,4,1,713,32,NE
2020-04-30,6,0,719,32,NE
2020-05-01,9,1,728,33,NE
2020-05-02,8,2,736,35,NE
2020-05-03,14,1,750,36,NE
2020-05-04,5,1,755,37,NE
2020-05-05,8,1,763,38,NE
2020-05-06,7,0,770,38,NE
2020-05-07,11,4,781,42,NE
2020-05-08,14,2,795,44,NE
2020-05-09,20,1,815,45,NE
2020-05-10,6,1,821,46,NE
2020-05-11,11,0,832,46,NE
2020-05-12,22,1,854,47,NE
2020-05-13,6,2,860,49,NE
2020-05-14,16,1,876,50,NE
2020-05-15,9,1,885,51,NE
2020-05-16,4,0,889,51,NE
2020-05-17,15,3,904,54,NE
2020-05-18,5,1,909,55,NE
2020-05-19,5,0,914,55,NE
2020-05-20,6,3,920,58,NE
2020-05-21,4,2,924,60,NE
2020-05-22,13,0,937,60,NE
2020-05-23,6,1,943,61,NE
2020-05-24,2,0,945,61,NE
2020-05-25,6,1,951,62,NE
2020-05-26,1,1,952,63,NE
2020-05-27,3,1,955,64,NE
2020-05-28,0,0,955,64,NE
2020-05-29,0,0,955,64,NE
2020-05-30,1,0,956,64,NE
2020-05-31,2,0,958,64,NE
2020-06-01,0,1,958,65,NE
2020-06-02,2,0,960,65,NE
2020-06-03,1,0,961,65,NE
2020-06-04,2,0,963,65,NE
2020-06-05,3,0,966,65,NE
2020-06-06,4,0,970,65,NE
2020-06-07,3,0,973,65,NE
2020-06-08,0,0,973,65,NE
2020-06-09,1,0,974,65,NE
2020-06-10,0,0,974,65,NE
2020-06-11,0,0,974,65,NE
2020-06-12,4,0,978,65,NE
2020-06-13,2,1,980,66,NE
2020-06-14,0,0,980,66,NE
2020-06-15,0,0,980,66,NE
2020-06-16,36,0,1016,66,NE
2020-06-17,4,1,1020,67,NE
2020-06-18,0,0,1020,67,NE
2020-06-19,0,0,1020,67,NE
2020-06-20,15,0,1035,67,NE
2020-06-21,1,0,1036,67,NE
2020-06-22,10,0,1046,67,NE
2020-06-23,5,0,1051,67,NE
2020-06-24,5,0,1056,67,NE
2020-06-25,3,0,1059,67,NE
2020-06-26,3,0,1062,67,NE
2019-12-30,0,0,0,0,NG
2019-12-31,0,0,0,0,NG
2020-01-01,0,0,0,0,NG
2020-01-02,0,0,0,0,NG
2020-01-03,0,0,0,0,NG
2020-01-04,0,0,0,0,NG
2020-01-05,0,0,0,0,NG
2020-01-06,0,0,0,0,NG
2020-01-07,0,0,0,0,NG
2020-01-08,0,0,0,0,NG
2020-01-09,0,0,0,0,NG
2020-01-10,0,0,0,0,NG
2020-01-11,0,0,0,0,NG
2020-01-12,0,0,0,0,NG
2020-01-13,0,0,0,0,NG
2020-01-14,0,0,0,0,NG
2020-01-15,0,0,0,0,NG
2020-01-16,0,0,0,0,NG
2020-01-17,0,0,0,0,NG
2020-01-18,0,0,0,0,NG
2020-01-19,0,0,0,0,NG
2020-01-20,0,0,0,0,NG
2020-01-21,0,0,0,0,NG
2020-01-22,0,0,0,0,NG
2020-01-23,0,0,0,0,NG
2020-01-24,0,0,0,0,NG
2020-01-25,0,0,0,0,NG
2020-01-26,0,0,0,0,NG
2020-01-27,0,0,0,0,NG
2020-01-28,0,0,0,0,NG
2020-01-29,0,0,0,0,NG
2020-01-30,0,0,0,0,NG
2020-01-31,0,0,0,0,NG
2020-02-01,0,0,0,0,NG
2020-02-02,0,0,0,0,NG
2020-02-03,0,0,0,0,NG
2020-02-04,0,0,0,0,NG
2020-02-05,0,0,0,0,NG
2020-02-06,0,0,0,0,NG
2020-02-07,0,0,0,0,NG
2020-02-08,0,0,0,0,NG
2020-02-09,0,0,0,0,NG
2020-02-10,0,0,0,0,NG
2020-02-11,0,0,0,0,NG
2020-02-12,0,0,0,0,NG
2020-02-13,0,0,0,0,NG
2020-02-14,0,0,0,0,NG
2020-02-15,0,0,0,0,NG
2020-02-16,0,0,0,0,NG
2020-02-17,0,0,0,0,NG
2020-02-18,0,0,0,0,NG
2020-02-19,0,0,0,0,NG
2020-02-20,0,0,0,0,NG
2020-02-21,0,0,0,0,NG
2020-02-22,0,0,0,0,NG
2020-02-23,0,0,0,0,NG
2020-02-24,0,0,0,0,NG
2020-02-25,0,0,0,0,NG
2020-02-26,0,0,0,0,NG
2020-02-27,1,0,1,0,NG
2020-02-28,0,0,1,0,NG
2020-02-29,0,0,1,0,NG
2020-03-01,0,0,1,0,NG
2020-03-09,1,0,2,0,NG
2020-03-14,0,0,2,0,NG
2020-03-15,0,0,2,0,NG
2020-03-16,0,0,2,0,NG
2020-03-17,1,0,3,0,NG
2020-03-18,5,0,8,0,NG
2020-03-19,0,0,8,0,NG
2020-03-20,4,0,12,0,NG
2020-03-21,10,0,22,0,NG
2020-03-22,8,0,30,0,NG
2020-03-23,10,1,40,1,NG
2020-03-24,4,0,44,1,NG
2020-03-25,7,0,51,1,NG
2020-03-26,14,0,65,1,NG
2020-03-27,16,0,81,1,NG
2020-03-28,16,0,97,1,NG
2020-03-29,0,0,97,1,NG
2020-03-30,34,1,131,2,NG
2020-03-31,0,0,131,2,NG
2020-04-01,20,0,151,2,NG
2020-04-02,23,0,174,2,NG
2020-04-03,16,0,190,2,NG
2020-04-04,20,2,210,4,NG
2020-04-05,22,1,232,5,NG
2020-04-06,6,0,238,5,NG
2020-04-07,16,1,254,6,NG
2020-04-08,22,0,276,6,NG
2020-04-09,12,1,288,7,NG
2020-04-10,17,0,305,7,NG
2020-04-11,13,3,318,10,NG
2020-04-12,5,0,323,10,NG
2020-04-13,20,0,343,10,NG
2020-04-14,30,1,373,11,NG
2020-04-15,34,1,407,12,NG
2020-04-16,35,1,442,13,NG
2020-04-17,51,4,493,17,NG
2020-04-18,49,2,542,19,NG
2020-04-19,85,2,627,21,NG
2020-04-20,38,1,665,22,NG
2020-04-21,117,3,782,25,NG
2020-04-22,91,3,873,28,NG
2020-04-23,108,3,981,31,NG
2020-04-24,114,1,1095,32,NG
2020-04-25,87,3,1182,35,NG
2020-04-26,91,5,1273,40,NG
2020-04-27,64,0,1337,40,NG
2020-04-28,195,4,1532,44,NG
2020-04-29,196,7,1728,51,NG
2020-04-30,204,7,1932,58,NG
2020-05-01,238,10,2170,68,NG
2020-05-02,218,17,2388,85,NG
2020-05-03,170,2,2558,87,NG
2020-05-04,244,6,2802,93,NG
2020-05-05,148,5,2950,98,NG
2020-05-06,195,5,3145,103,NG
2020-05-07,381,4,3526,107,NG
2020-05-08,386,10,3912,117,NG
2020-05-09,239,11,4151,128,NG
2020-05-10,248,15,4399,143,NG
2020-05-11,242,7,4641,150,NG
2020-05-12,146,8,4787,158,NG
2020-05-13,184,6,4971,164,NG
2020-05-14,191,3,5162,167,NG
2020-05-15,283,4,5445,171,NG
2020-05-16,176,5,5621,176,NG
2020-05-17,338,6,5959,182,NG
2020-05-18,216,9,6175,191,NG
2020-05-19,226,1,6401,192,NG
2020-05-20,276,8,6677,200,NG
2020-05-21,339,11,7016,211,NG
2020-05-22,245,10,7261,221,NG
2020-05-23,265,0,7526,221,NG
2020-05-24,313,5,7839,226,NG
2020-05-25,229,7,8068,233,NG
2020-05-26,276,16,8344,249,NG
2020-05-27,389,5,8733,254,NG
2020-05-28,182,5,8915,259,NG
2020-05-29,387,2,9302,261,NG
2020-05-30,553,12,9855,273,NG
2020-05-31,307,14,10162,287,NG
2020-06-01,416,12,10578,299,NG
2020-06-02,241,15,10819,314,NG
2020-06-03,347,1,11166,315,NG
2020-06-04,350,8,11516,323,NG
2020-06-05,328,10,11844,333,NG
2020-06-06,389,9,12233,342,NG
2020-06-07,253,12,12486,354,NG
2020-06-08,315,7,12801,361,NG
2020-06-09,663,4,13464,365,NG
2020-06-10,409,17,13873,382,NG
2020-06-11,681,5,14554,387,NG
2020-06-12,627,12,15181,399,NG
2020-06-13,501,8,15682,407,NG
2020-06-14,403,13,16085,420,NG
2020-06-15,573,4,16658,424,NG
2020-06-16,490,31,17148,455,NG
2020-06-17,587,14,17735,469,NG
2020-06-18,745,6,18480,475,NG
2020-06-19,667,12,19147,487,NG
2020-06-20,661,19,19808,506,NG
2020-06-21,436,12,20244,518,NG
2020-06-22,675,7,20919,525,NG
2020-06-23,452,8,21371,533,NG
2020-06-24,649,9,22020,542,NG
2020-06-25,594,7,22614,549,NG
2020-06-26,684,5,23298,554,NG
2020-03-18,1,0,1,0,NI
2020-03-19,0,0,1,0,NI
2020-03-20,1,0,2,0,NI
2020-03-21,0,0,2,0,NI
2020-03-22,0,0,2,0,NI
2020-03-23,0,0,2,0,NI
2020-03-24,0,0,2,0,NI
2020-03-25,0,0,2,0,NI
2020-03-26,0,0,2,0,NI
2020-03-27,0,1,2,1,NI
2020-03-28,2,0,4,1,NI
2020-03-29,0,0,4,1,NI
2020-03-30,0,0,4,1,NI
2020-03-31,0,0,4,1,NI
2020-04-01,1,0,5,1,NI
2020-04-02,0,0,5,1,NI
2020-04-03,0,0,5,1,NI
2020-04-04,0,0,5,1,NI
2020-04-05,0,0,5,1,NI
2020-04-06,1,0,6,1,NI
2020-04-07,0,0,6,1,NI
2020-04-08,0,0,6,1,NI
2020-04-09,0,0,6,1,NI
2020-04-10,1,0,7,1,NI
2020-04-11,0,0,7,1,NI
2020-04-12,2,0,9,1,NI
2020-04-13,0,0,9,1,NI
2020-04-14,0,0,9,1,NI
2020-04-15,0,0,9,1,NI
2020-04-16,0,0,9,1,NI
2020-04-17,0,0,9,1,NI
2020-04-18,0,0,9,1,NI
2020-04-19,0,0,9,1,NI
2020-04-20,0,1,9,2,NI
2020-04-21,1,0,10,2,NI
2020-04-22,0,0,10,2,NI
2020-04-23,0,0,10,2,NI
2020-04-24,1,1,11,3,NI
2020-04-25,1,0,12,3,NI
2020-04-26,1,0,13,3,NI
2020-04-27,0,0,13,3,NI
2020-04-28,0,0,13,3,NI
2020-04-29,1,1,14,4,NI
2020-04-30,0,0,14,4,NI
2020-05-01,0,0,14,4,NI
2020-05-02,0,0,14,4,NI
2020-05-03,0,1,14,5,NI
2020-05-04,1,0,15,5,NI
2020-05-05,1,0,16,5,NI
2020-05-06,0,0,16,5,NI
2020-05-07,0,0,16,5,NI
2020-05-08,0,0,16,5,NI
2020-05-09,0,0,16,5,NI
2020-05-10,0,0,16,5,NI
2020-05-11,0,0,16,5,NI
2020-05-12,9,3,25,8,NI
2020-05-13,0,0,25,8,NI
2020-05-14,0,0,25,8,NI
2020-05-15,0,0,25,8,NI
2020-05-16,0,0,25,8,NI
2020-05-17,0,0,25,8,NI
2020-05-18,0,0,25,8,NI
2020-05-19,0,0,25,8,NI
2020-05-20,0,0,25,8,NI
2020-05-21,0,0,25,8,NI
2020-05-22,254,9,279,17,NI
2020-05-23,0,0,279,17,NI
2020-05-24,0,0,279,17,NI
2020-05-25,0,0,279,17,NI
2020-05-26,480,18,759,35,NI
2020-05-27,0,0,759,35,NI
2020-05-28,0,0,759,35,NI
2020-05-29,0,0,759,35,NI
2020-05-30,0,0,759,35,NI
2020-05-31,0,0,759,35,NI
2020-06-01,0,0,759,35,NI
2020-06-02,359,11,1118,46,NI
2020-06-03,0,0,1118,46,NI
2020-06-04,0,0,1118,46,NI
2020-06-05,0,0,1118,46,NI
2020-06-06,191,0,1309,46,NI
2020-06-07,0,0,1309,46,NI
2020-06-08,0,0,1309,46,NI
2020-06-09,0,0,1309,46,NI
2020-06-10,155,9,1464,55,NI
2020-06-11,0,0,1464,55,NI
2020-06-12,191,0,1655,55,NI
2020-06-13,0,0,1655,55,NI
2020-06-14,0,0,1655,55,NI
2020-06-15,0,0,1655,55,NI
2020-06-16,168,9,1823,64,NI
2020-06-17,191,0,2014,64,NI
2020-06-18,0,0,2014,64,NI
2020-06-19,0,0,2014,64,NI
2020-06-20,0,0,2014,64,NI
2020-06-21,0,0,2014,64,NI
2020-06-22,0,0,2014,64,NI
2020-06-23,156,10,2170,74,NI
2020-06-24,0,0,2170,74,NI
2020-06-25,0,0,2170,74,NI
2020-06-26,0,0,2170,74,NI
2019-12-30,0,0,0,0,NL
2019-12-31,0,0,0,0,NL
2020-01-01,0,0,0,0,NL
2020-01-02,0,0,0,0,NL
2020-01-03,0,0,0,0,NL
2020-01-04,0,0,0,0,NL
2020-01-05,0,0,0,0,NL
2020-01-06,0,0,0,0,NL
2020-01-07,0,0,0,0,NL
2020-01-08,0,0,0,0,NL
2020-01-09,0,0,0,0,NL
2020-01-10,0,0,0,0,NL
2020-01-11,0,0,0,0,NL
2020-01-12,0,0,0,0,NL
2020-01-13,0,0,0,0,NL
2020-01-14,0,0,0,0,NL
2020-01-15,0,0,0,0,NL
2020-01-16,0,0,0,0,NL
2020-01-17,0,0,0,0,NL
2020-01-18,0,0,0,0,NL
2020-01-19,0,0,0,0,NL
2020-01-20,0,0,0,0,NL
2020-01-21,0,0,0,0,NL
2020-01-22,0,0,0,0,NL
2020-01-23,0,0,0,0,NL
2020-01-24,0,0,0,0,NL
2020-01-25,0,0,0,0,NL
2020-01-26,0,0,0,0,NL
2020-01-27,0,0,0,0,NL
2020-01-28,0,0,0,0,NL
2020-01-29,0,0,0,0,NL
2020-01-30,0,0,0,0,NL
2020-01-31,0,0,0,0,NL
2020-02-01,0,0,0,0,NL
2020-02-02,0,0,0,0,NL
2020-02-03,0,0,0,0,NL
2020-02-04,0,0,0,0,NL
2020-02-05,0,0,0,0,NL
2020-02-06,0,0,0,0,NL
2020-02-07,0,0,0,0,NL
2020-02-08,0,0,0,0,NL
2020-02-09,0,0,0,0,NL
2020-02-10,0,0,0,0,NL
2020-02-11,0,0,0,0,NL
2020-02-12,0,0,0,0,NL
2020-02-13,0,0,0,0,NL
2020-02-14,0,0,0,0,NL
2020-02-15,0,0,0,0,NL
2020-02-16,0,0,0,0,NL
2020-02-17,0,0,0,0,NL
2020-02-18,0,0,0,0,NL
2020-02-19,0,0,0,0,NL
2020-02-20,0,0,0,0,NL
2020-02-21,0,0,0,0,NL
2020-02-22,0,0,0,0,NL
2020-02-23,0,0,0,0,NL
2020-02-24,0,0,0,0,NL
2020-02-25,0,0,0,0,NL
2020-02-26,0,0,0,0,NL
2020-02-27,1,0,1,0,NL
2020-02-28,1,0,2,0,NL
2020-02-29,5,0,7,0,NL
2020-03-01,6,0,13,0,NL
2020-03-02,5,0,18,0,NL
2020-03-03,10,0,28,0,NL
2020-03-04,10,0,38,0,NL
2020-03-05,44,0,82,0,NL
2020-03-06,46,1,128,1,NL
2020-03-07,60,0,188,1,NL
2020-03-08,77,2,265,3,NL
2020-03-09,56,0,321,3,NL
2020-03-10,61,1,382,4,NL
2020-03-11,121,1,503,5,NL
2020-03-12,111,0,614,5,NL
2020-03-13,190,0,804,5,NL
2020-03-14,155,7,959,12,NL
2020-03-15,176,8,1135,20,NL
2020-03-16,278,4,1413,24,NL
2020-03-17,292,19,1705,43,NL
2020-03-18,346,15,2051,58,NL
2020-03-19,409,18,2460,76,NL
2020-03-20,534,30,2994,106,NL
2020-03-21,637,30,3631,136,NL
2020-03-22,573,43,4204,179,NL
2020-03-23,545,34,4749,213,NL
2020-03-24,811,63,5560,276,NL
2020-03-25,852,80,6412,356,NL
2020-03-26,1019,78,7431,434,NL
2020-03-27,1172,112,8603,546,NL
2020-03-28,1159,93,9762,639,NL
2020-03-29,1104,132,10866,771,NL
2020-03-30,884,93,11750,864,NL
2020-03-31,845,175,12595,1039,NL
2020-04-01,1019,134,13614,1173,NL
2020-04-02,1083,166,14697,1339,NL
2020-04-03,1026,148,15723,1487,NL
2020-04-04,904,164,16627,1651,NL
2020-04-05,1224,115,17851,1766,NL
2020-04-06,952,101,18803,1867,NL
2020-04-07,777,234,19580,2101,NL
2020-04-08,969,147,20549,2248,NL
2020-04-09,1213,148,21762,2396,NL
2020-04-10,1335,115,23097,2511,NL
2020-04-11,1316,132,24413,2643,NL
2020-04-12,1174,94,25587,2737,NL
2020-04-13,964,86,26551,2823,NL
2020-04-14,868,122,27419,2945,NL
2020-04-15,734,189,28153,3134,NL
2020-04-16,1061,181,29214,3315,NL
2020-04-17,1235,144,30449,3459,NL
2020-04-18,1140,142,31589,3601,NL
2020-04-19,1066,83,32655,3684,NL
2020-04-20,750,67,33405,3751,NL
2020-04-21,729,165,34134,3916,NL
2020-04-22,708,138,34842,4054,NL
2020-04-23,887,123,35729,4177,NL
2020-04-24,806,112,36535,4289,NL
2020-04-25,655,120,37190,4409,NL
2020-04-26,655,66,37845,4475,NL
2020-04-27,400,43,38245,4518,NL
2020-04-28,171,48,38416,4566,NL
2020-04-29,386,145,38802,4711,NL
2020-04-30,514,84,39316,4795,NL
2020-05-01,475,98,39791,4893,NL
2020-05-02,445,94,40236,4987,NL
2020-05-03,335,69,40571,5056,NL
2020-05-04,199,26,40770,5082,NL
2020-05-05,317,86,41087,5168,NL
2020-05-06,232,36,41319,5204,NL
2020-05-07,455,84,41774,5288,NL
2020-05-08,319,71,42093,5359,NL
2020-05-09,289,63,42382,5422,NL
2020-05-10,245,18,42627,5440,NL
2020-05-11,161,16,42788,5456,NL
2020-05-12,196,54,42984,5510,NL
2020-05-13,227,52,43211,5562,NL
2020-05-14,270,28,43481,5590,NL
2020-05-15,200,53,43681,5643,NL
2020-05-16,189,27,43870,5670,NL
2020-05-17,125,10,43995,5680,NL
2020-05-18,146,14,44141,5694,NL
2020-05-19,108,21,44249,5715,NL
2020-05-20,198,33,44447,5748,NL
2020-05-21,253,27,44700,5775,NL
2020-05-22,188,13,44888,5788,NL
2020-05-23,176,23,45064,5811,NL
2020-05-24,172,11,45236,5822,NL
2020-05-25,209,8,45445,5830,NL
2020-05-26,133,26,45578,5856,NL
2020-05-27,190,15,45768,5871,NL
2020-05-28,182,32,45950,5903,NL
2020-05-29,176,28,46126,5931,NL
2020-05-30,131,20,46257,5951,NL
2020-05-31,185,5,46442,5956,NL
2020-06-01,103,6,46545,5962,NL
2020-06-02,102,5,46647,5967,NL
2020-06-03,86,10,46733,5977,NL
2020-06-04,209,13,46942,5990,NL
2020-06-05,210,15,47152,6005,NL
2020-06-06,183,6,47335,6011,NL
2020-06-07,239,2,47574,6013,NL
2020-06-08,165,3,47739,6016,NL
2020-06-09,164,15,47903,6031,NL
2020-06-10,184,11,48087,6042,NL
2020-06-11,164,2,48251,6044,NL
2020-06-12,210,9,48461,6053,NL
2020-06-13,179,4,48640,6057,NL
2020-06-14,143,2,48783,6059,NL
2020-06-15,0,0,48783,6059,NL
2020-06-16,304,11,49087,6070,NL
2020-06-17,117,4,49204,6074,NL
2020-06-18,115,4,49319,6078,NL
2020-06-19,107,3,49426,6081,NL
2020-06-20,76,8,49502,6089,NL
2020-06-21,91,1,49593,6090,NL
2020-06-22,65,0,49658,6090,NL
2020-06-23,64,5,49722,6095,NL
2020-06-24,82,2,49804,6097,NL
2020-06-25,110,3,49914,6100,NL
2020-06-26,91,3,50005,6103,NL
2019-12-30,0,0,0,0,NO
2019-12-31,0,0,0,0,NO
2020-01-01,0,0,0,0,NO
2020-01-02,0,0,0,0,NO
2020-01-03,0,0,0,0,NO
2020-01-04,0,0,0,0,NO
2020-01-05,0,0,0,0,NO
2020-01-06,0,0,0,0,NO
2020-01-07,0,0,0,0,NO
2020-01-08,0,0,0,0,NO
2020-01-09,0,0,0,0,NO
2020-01-10,0,0,0,0,NO
2020-01-11,0,0,0,0,NO
2020-01-12,0,0,0,0,NO
2020-01-13,0,0,0,0,NO
2020-01-14,0,0,0,0,NO
2020-01-15,0,0,0,0,NO
2020-01-16,0,0,0,0,NO
2020-01-17,0,0,0,0,NO
2020-01-18,0,0,0,0,NO
2020-01-19,0,0,0,0,NO
2020-01-20,0,0,0,0,NO
2020-01-21,0,0,0,0,NO
2020-01-22,0,0,0,0,NO
2020-01-23,0,0,0,0,NO
2020-01-24,0,0,0,0,NO
2020-01-25,0,0,0,0,NO
2020-01-26,0,0,0,0,NO
2020-01-27,0,0,0,0,NO
2020-01-28,0,0,0,0,NO
2020-01-29,0,0,0,0,NO
2020-01-30,0,0,0,0,NO
2020-01-31,0,0,0,0,NO
2020-02-01,0,0,0,0,NO
2020-02-02,0,0,0,0,NO
2020-02-03,0,0,0,0,NO
2020-02-04,0,0,0,0,NO
2020-02-05,0,0,0,0,NO
2020-02-06,0,0,0,0,NO
2020-02-07,0,0,0,0,NO
2020-02-08,0,0,0,0,NO
2020-02-09,0,0,0,0,NO
2020-02-10,0,0,0,0,NO
2020-02-11,0,0,0,0,NO
2020-02-12,0,0,0,0,NO
2020-02-13,0,0,0,0,NO
2020-02-14,0,0,0,0,NO
2020-02-15,0,0,0,0,NO
2020-02-16,0,0,0,0,NO
2020-02-17,0,0,0,0,NO
2020-02-18,0,0,0,0,NO
2020-02-19,0,0,0,0,NO
2020-02-20,0,0,0,0,NO
2020-02-21,0,0,0,0,NO
2020-02-22,0,0,0,0,NO
2020-02-23,0,0,0,0,NO
2020-02-24,0,0,0,0,NO
2020-02-25,0,0,0,0,NO
2020-02-26,1,0,1,0,NO
2020-02-27,3,0,4,0,NO
2020-02-28,2,0,6,0,NO
2020-02-29,9,0,15,0,NO
2020-03-01,4,0,19,0,NO
2020-03-02,6,0,25,0,NO
2020-03-03,8,0,33,0,NO
2020-03-04,23,0,56,0,NO
2020-03-05,30,0,86,0,NO
2020-03-06,27,0,113,0,NO
2020-03-07,34,0,147,0,NO
2020-03-08,22,0,169,0,NO
2020-03-09,23,0,192,0,NO
2020-03-10,85,0,277,0,NO
2020-03-11,212,0,489,0,NO
2020-03-12,132,1,621,1,NO
2020-03-13,0,0,621,1,NO
2020-03-14,286,0,907,1,NO
2020-03-15,170,0,1077,1,NO
2020-03-16,92,2,1169,3,NO
2020-03-17,139,0,1308,3,NO
2020-03-18,115,0,1423,3,NO
2020-03-19,129,3,1552,6,NO
2020-03-20,190,1,1742,7,NO
2020-03-21,184,0,1926,7,NO
2020-03-22,206,0,2132,7,NO
2020-03-23,239,1,2371,8,NO
2020-03-24,195,2,2566,10,NO
2020-03-25,350,2,2916,12,NO
2020-03-26,240,2,3156,14,NO
2020-03-27,425,2,3581,16,NO
2020-03-28,264,4,3845,20,NO
2020-03-29,257,2,4102,22,NO
2020-03-30,124,4,4226,26,NO
2020-03-31,221,2,4447,28,NO
2020-04-01,218,4,4665,32,NO
2020-04-02,270,10,4935,42,NO
2020-04-03,273,2,5208,44,NO
2020-04-04,302,6,5510,50,NO
2020-04-05,130,8,5640,58,NO
2020-04-06,115,1,5755,59,NO
2020-04-07,108,10,5863,69,NO
2020-04-08,147,11,6010,80,NO
2020-04-09,150,8,6160,88,NO
2020-04-10,84,4,6244,92,NO
2020-04-11,76,6,6320,98,NO
2020-04-12,95,5,6415,103,NO
2020-04-13,73,11,6488,114,NO
2020-04-14,78,13,6566,127,NO
2020-04-15,111,3,6677,130,NO
2020-04-16,114,6,6791,136,NO
2020-04-17,0,0,6791,136,NO
2020-04-18,193,12,6984,148,NO
2020-04-19,84,6,7068,154,NO
2020-04-20,45,0,7113,154,NO
2020-04-21,53,9,7166,163,NO
2020-04-22,84,6,7250,169,NO
2020-04-23,95,11,7345,180,NO
2020-04-24,63,11,7408,191,NO
2020-04-25,59,2,7467,193,NO
2020-04-26,38,0,7505,193,NO
2020-04-27,28,0,7533,193,NO
2020-04-28,72,2,7605,195,NO
2020-04-29,62,7,7667,202,NO
2020-04-30,43,2,7710,204,NO
2020-05-01,49,0,7759,204,NO
2020-05-02,0,0,7759,204,NO
2020-05-03,50,4,7809,208,NO
2020-05-04,38,0,7847,208,NO
2020-05-05,56,1,7903,209,NO
2020-05-06,50,0,7953,209,NO
2020-05-07,42,0,7995,209,NO
2020-05-08,39,4,8034,213,NO
2020-05-09,35,0,8069,213,NO
2020-05-10,30,4,8099,217,NO
2020-05-11,7,7,8106,224,NO
2020-05-12,29,4,8135,228,NO
2020-05-13,23,1,8158,229,NO
2020-05-14,17,3,8175,232,NO
2020-05-15,22,0,8197,232,NO
2020-05-16,0,0,8197,232,NO
2020-05-17,0,0,8197,232,NO
2020-05-18,52,1,8249,233,NO
2020-05-19,8,0,8257,233,NO
2020-05-20,11,1,8268,234,NO
2020-05-21,0,0,8268,234,NO
2020-05-22,41,1,8309,235,NO
2020-05-23,0,0,8309,235,NO
2020-05-24,0,0,8309,235,NO
2020-05-25,43,0,8352,235,NO
2020-05-26,12,0,8364,235,NO
2020-05-27,19,0,8383,235,NO
2020-05-28,18,1,8401,236,NO
2020-05-29,10,0,8411,236,NO
2020-05-30,0,0,8411,236,NO
2020-05-31,0,0,8411,236,NO
2020-06-01,0,0,8411,236,NO
2020-06-02,35,1,8446,237,NO
2020-06-03,0,0,8446,237,NO
2020-06-04,31,1,8477,238,NO
2020-06-05,27,0,8504,238,NO
2020-06-06,0,0,8504,238,NO
2020-06-07,0,0,8504,238,NO
2020-06-08,43,1,8547,239,NO
2020-06-09,16,0,8563,239,NO
2020-06-10,13,0,8576,239,NO
2020-06-11,18,3,8594,242,NO
2020-06-12,12,0,8606,242,NO
2020-06-13,0,0,8606,242,NO
2020-06-14,0,0,8606,242,NO
2020-06-15,25,0,8631,242,NO
2020-06-16,0,0,8631,242,NO
2020-06-17,29,1,8660,243,NO
2020-06-18,32,1,8692,244,NO
2020-06-19,0,0,8692,244,NO
2020-06-20,16,0,8708,244,NO
2020-06-21,0,0,8708,244,NO
2020-06-22,37,4,8745,248,NO
2020-06-23,6,0,8751,248,NO
2020-06-24,26,1,8777,249,NO
2020-06-25,16,0,8793,249,NO
2020-06-26,22,0,8815,249,NO
2019-12-30,0,0,0,0,NP
2019-12-31,0,0,0,0,NP
2020-01-01,0,0,0,0,NP
2020-01-02,0,0,0,0,NP
2020-01-03,0,0,0,0,NP
2020-01-04,0,0,0,0,NP
2020-01-05,0,0,0,0,NP
2020-01-06,0,0,0,0,NP
2020-01-07,0,0,0,0,NP
2020-01-08,0,0,0,0,NP
2020-01-09,0,0,0,0,NP
2020-01-10,0,0,0,0,NP
2020-01-11,0,0,0,0,NP
2020-01-12,0,0,0,0,NP
2020-01-13,0,0,0,0,NP
2020-01-14,0,0,0,0,NP
2020-01-15,0,0,0,0,NP
2020-01-16,0,0,0,0,NP
2020-01-17,0,0,0,0,NP
2020-01-18,0,0,0,0,NP
2020-01-19,0,0,0,0,NP
2020-01-20,0,0,0,0,NP
2020-01-21,0,0,0,0,NP
2020-01-22,0,0,0,0,NP
2020-01-23,0,0,0,0,NP
2020-01-24,1,0,1,0,NP
2020-01-25,0,0,1,0,NP
2020-01-26,0,0,1,0,NP
2020-01-27,0,0,1,0,NP
2020-01-28,0,0,1,0,NP
2020-01-29,0,0,1,0,NP
2020-01-30,0,0,1,0,NP
2020-01-31,0,0,1,0,NP
2020-02-01,0,0,1,0,NP
2020-02-02,0,0,1,0,NP
2020-02-03,0,0,1,0,NP
2020-02-04,0,0,1,0,NP
2020-02-05,0,0,1,0,NP
2020-02-06,0,0,1,0,NP
2020-02-07,0,0,1,0,NP
2020-02-08,0,0,1,0,NP
2020-02-09,0,0,1,0,NP
2020-02-10,0,0,1,0,NP
2020-02-11,0,0,1,0,NP
2020-02-12,0,0,1,0,NP
2020-02-13,0,0,1,0,NP
2020-02-14,0,0,1,0,NP
2020-02-15,0,0,1,0,NP
2020-02-16,0,0,1,0,NP
2020-02-17,0,0,1,0,NP
2020-02-18,0,0,1,0,NP
2020-02-19,0,0,1,0,NP
2020-02-20,0,0,1,0,NP
2020-02-21,0,0,1,0,NP
2020-02-22,0,0,1,0,NP
2020-02-23,0,0,1,0,NP
2020-02-24,0,0,1,0,NP
2020-02-25,0,0,1,0,NP
2020-02-26,0,0,1,0,NP
2020-02-27,0,0,1,0,NP
2020-02-28,0,0,1,0,NP
2020-02-29,0,0,1,0,NP
2020-03-01,0,0,1,0,NP
2020-03-14,0,0,1,0,NP
2020-03-16,0,0,1,0,NP
2020-03-17,0,0,1,0,NP
2020-03-18,0,0,1,0,NP
2020-03-19,0,0,1,0,NP
2020-03-20,0,0,1,0,NP
2020-03-21,0,0,1,0,NP
2020-03-22,0,0,1,0,NP
2020-03-23,1,0,2,0,NP
2020-03-24,1,0,3,0,NP
2020-03-25,0,0,3,0,NP
2020-03-26,0,0,3,0,NP
2020-03-27,0,0,3,0,NP
2020-03-28,2,0,5,0,NP
2020-03-29,0,0,5,0,NP
2020-03-30,0,0,5,0,NP
2020-03-31,0,0,5,0,NP
2020-04-01,0,0,5,0,NP
2020-04-02,0,0,5,0,NP
2020-04-03,1,0,6,0,NP
2020-04-04,0,0,6,0,NP
2020-04-05,3,0,9,0,NP
2020-04-06,0,0,9,0,NP
2020-04-07,0,0,9,0,NP
2020-04-08,0,0,9,0,NP
2020-04-09,0,0,9,0,NP
2020-04-10,0,0,9,0,NP
2020-04-11,0,0,9,0,NP
2020-04-12,3,0,12,0,NP
2020-04-13,2,0,14,0,NP
2020-04-14,2,0,16,0,NP
2020-04-15,0,0,16,0,NP
2020-04-16,0,0,16,0,NP
2020-04-17,14,0,30,0,NP
2020-04-18,1,0,31,0,NP
2020-04-19,0,0,31,0,NP
2020-04-20,0,0,31,0,NP
2020-04-21,11,0,42,0,NP
2020-04-22,3,0,45,0,NP
2020-04-23,3,0,48,0,NP
2020-04-24,1,0,49,0,NP
2020-04-25,0,0,49,0,NP
2020-04-26,3,0,52,0,NP
2020-04-27,0,0,52,0,NP
2020-04-28,2,0,54,0,NP
2020-04-29,3,0,57,0,NP
2020-04-30,0,0,57,0,NP
2020-05-01,2,0,59,0,NP
2020-05-02,0,0,59,0,NP
2020-05-03,16,0,75,0,NP
2020-05-04,7,0,82,0,NP
2020-05-05,0,0,82,0,NP
2020-05-06,17,0,99,0,NP
2020-05-07,2,0,101,0,NP
2020-05-08,0,0,101,0,NP
2020-05-09,8,0,109,0,NP
2020-05-10,11,0,120,0,NP
2020-05-11,14,0,134,0,NP
2020-05-12,83,0,217,0,NP
2020-05-13,2,0,219,0,NP
2020-05-14,39,0,258,0,NP
2020-05-15,18,0,276,0,NP
2020-05-16,15,1,291,1,NP
2020-05-17,13,1,304,2,NP
2020-05-18,71,0,375,2,NP
2020-05-19,27,0,402,2,NP
2020-05-20,42,0,444,2,NP
2020-05-21,43,1,487,3,NP
2020-05-22,61,0,548,3,NP
2020-05-23,36,0,584,3,NP
2020-05-24,19,0,603,3,NP
2020-05-25,79,1,682,4,NP
2020-05-26,90,0,772,4,NP
2020-05-27,114,0,886,4,NP
2020-05-28,156,1,1042,5,NP
2020-05-29,170,1,1212,6,NP
2020-05-30,189,0,1401,6,NP
2020-05-31,171,2,1572,8,NP
2020-06-01,226,0,1798,8,NP
2020-06-02,301,0,2099,8,NP
2020-06-03,201,1,2300,9,NP
2020-06-04,334,1,2634,10,NP
2020-06-05,278,1,2912,11,NP
2020-06-06,0,0,2912,11,NP
2020-06-07,536,2,3448,13,NP
2020-06-08,314,1,3762,14,NP
2020-06-09,323,1,4085,15,NP
2020-06-10,279,0,4364,15,NP
2020-06-11,250,0,4614,15,NP
2020-06-12,448,1,5062,16,NP
2020-06-13,273,2,5335,18,NP
2020-06-14,425,1,5760,19,NP
2020-06-15,451,0,6211,19,NP
2020-06-16,380,0,6591,19,NP
2020-06-17,586,1,7177,20,NP
2020-06-18,671,2,7848,22,NP
2020-06-19,426,0,8274,22,NP
2020-06-20,331,0,8605,22,NP
2020-06-21,421,1,9026,23,NP
2020-06-22,0,0,9026,23,NP
2020-06-23,0,0,9026,23,NP
2020-06-24,1702,0,10728,23,NP
2020-06-25,434,3,11162,26,NP
2020-06-26,593,1,11755,27,NP
2019-12-31,0,0,0,0,NZ
2020-01-01,0,0,0,0,NZ
2020-01-02,0,0,0,0,NZ
2020-01-03,0,0,0,0,NZ
2020-01-04,0,0,0,0,NZ
2020-01-05,0,0,0,0,NZ
2020-01-06,0,0,0,0,NZ
2020-01-07,0,0,0,0,NZ
2020-01-08,0,0,0,0,NZ
2020-01-09,0,0,0,0,NZ
2020-01-10,0,0,0,0,NZ
2020-01-11,0,0,0,0,NZ
2020-01-12,0,0,0,0,NZ
2020-01-13,0,0,0,0,NZ
2020-01-14,0,0,0,0,NZ
2020-01-15,0,0,0,0,NZ
2020-01-16,0,0,0,0,NZ
2020-01-17,0,0,0,0,NZ
2020-01-18,0,0,0,0,NZ
2020-01-19,0,0,0,0,NZ
2020-01-20,0,0,0,0,NZ
2020-01-21,0,0,0,0,NZ
2020-01-22,0,0,0,0,NZ
2020-01-23,0,0,0,0,NZ
2020-01-24,0,0,0,0,NZ
2020-01-25,0,0,0,0,NZ
2020-01-26,0,0,0,0,NZ
2020-01-27,0,0,0,0,NZ
2020-01-28,0,0,0,0,NZ
2020-01-29,0,0,0,0,NZ
2020-01-30,0,0,0,0,NZ
2020-01-31,0,0,0,0,NZ
2020-02-01,0,0,0,0,NZ
2020-02-02,0,0,0,0,NZ
2020-02-03,0,0,0,0,NZ
2020-02-04,0,0,0,0,NZ
2020-02-05,0,0,0,0,NZ
2020-02-06,0,0,0,0,NZ
2020-02-07,0,0,0,0,NZ
2020-02-08,0,0,0,0,NZ
2020-02-09,0,0,0,0,NZ
2020-02-10,0,0,0,0,NZ
2020-02-11,0,0,0,0,NZ
2020-02-12,0,0,0,0,NZ
2020-02-13,0,0,0,0,NZ
2020-02-14,0,0,0,0,NZ
2020-02-15,0,0,0,0,NZ
2020-02-16,0,0,0,0,NZ
2020-02-17,0,0,0,0,NZ
2020-02-18,0,0,0,0,NZ
2020-02-19,0,0,0,0,NZ
2020-02-20,0,0,0,0,NZ
2020-02-21,0,0,0,0,NZ
2020-02-22,0,0,0,0,NZ
2020-02-23,0,0,0,0,NZ
2020-02-24,0,0,0,0,NZ
2020-02-25,0,0,0,0,NZ
2020-02-26,0,0,0,0,NZ
2020-02-27,0,0,0,0,NZ
2020-02-28,1,0,1,0,NZ
2020-02-29,0,0,1,0,NZ
2020-03-01,0,0,1,0,NZ
2020-03-02,0,0,1,0,NZ
2020-03-04,1,0,2,0,NZ
2020-03-05,1,0,3,0,NZ
2020-03-06,1,0,4,0,NZ
2020-03-07,1,0,5,0,NZ
2020-03-14,1,0,6,0,NZ
2020-03-15,2,0,8,0,NZ
2020-03-18,12,0,20,0,NZ
2020-03-19,8,0,28,0,NZ
2020-03-20,11,0,39,0,NZ
2020-03-21,14,0,53,0,NZ
2020-03-22,13,0,66,0,NZ
2020-03-23,36,0,102,0,NZ
2020-03-24,40,0,142,0,NZ
2020-03-25,47,0,189,0,NZ
2020-03-26,73,0,262,0,NZ
2020-03-27,76,0,338,0,NZ
2020-03-28,78,0,416,0,NZ
2020-03-29,60,1,476,1,NZ
2020-03-30,76,0,552,1,NZ
2020-03-31,95,0,647,1,NZ
2020-04-01,0,0,647,1,NZ
2020-04-02,76,0,723,1,NZ
2020-04-03,49,0,772,1,NZ
2020-04-04,52,0,824,1,NZ
2020-04-05,48,0,872,1,NZ
2020-04-06,39,0,911,1,NZ
2020-04-07,32,0,943,1,NZ
2020-04-08,26,0,969,1,NZ
2020-04-09,23,0,992,1,NZ
2020-04-10,23,1,1015,2,NZ
2020-04-11,20,2,1035,4,NZ
2020-04-12,14,0,1049,4,NZ
2020-04-13,15,1,1064,5,NZ
2020-04-14,8,4,1072,9,NZ
2020-04-15,6,0,1078,9,NZ
2020-04-16,6,0,1084,9,NZ
2020-04-17,2,2,1086,11,NZ
2020-04-18,8,0,1094,11,NZ
2020-04-19,4,1,1098,12,NZ
2020-04-20,7,0,1105,12,NZ
2020-04-21,2,1,1107,13,NZ
2020-04-22,5,1,1112,14,NZ
2020-04-23,0,2,1112,16,NZ
2020-04-24,2,1,1114,17,NZ
2020-04-25,3,1,1117,18,NZ
2020-04-26,4,0,1121,18,NZ
2020-04-27,1,1,1122,19,NZ
2020-04-28,2,0,1124,19,NZ
2020-04-29,2,0,1126,19,NZ
2020-04-30,3,0,1129,19,NZ
2020-05-01,3,0,1132,19,NZ
2020-05-02,2,1,1134,20,NZ
2020-05-03,2,0,1136,20,NZ
2020-05-04,1,0,1137,20,NZ
2020-05-05,0,0,1137,20,NZ
2020-05-06,1,1,1138,21,NZ
2020-05-07,1,0,1139,21,NZ
2020-05-08,2,0,1141,21,NZ
2020-05-09,1,0,1142,21,NZ
2020-05-10,2,0,1144,21,NZ
2020-05-11,3,0,1147,21,NZ
2020-05-12,0,0,1147,21,NZ
2020-05-13,0,0,1147,21,NZ
2020-05-14,0,0,1147,21,NZ
2020-05-15,1,0,1148,21,NZ
2020-05-16,0,0,1148,21,NZ
2020-05-17,1,0,1149,21,NZ
2020-05-18,0,0,1149,21,NZ
2020-05-19,4,0,1153,21,NZ
2020-05-20,0,0,1153,21,NZ
2020-05-21,0,0,1153,21,NZ
2020-05-22,1,0,1154,21,NZ
2020-05-23,0,0,1154,21,NZ
2020-05-24,0,0,1154,21,NZ
2020-05-25,0,0,1154,21,NZ
2020-05-26,0,0,1154,21,NZ
2020-05-27,0,0,1154,21,NZ
2020-05-28,0,1,1154,22,NZ
2020-05-29,0,0,1154,22,NZ
2020-05-30,0,0,1154,22,NZ
2020-05-31,0,0,1154,22,NZ
2020-06-01,0,0,1154,22,NZ
2020-06-02,0,0,1154,22,NZ
2020-06-03,0,0,1154,22,NZ
2020-06-04,0,0,1154,22,NZ
2020-06-05,0,0,1154,22,NZ
2020-06-06,0,0,1154,22,NZ
2020-06-07,0,0,1154,22,NZ
2020-06-08,0,0,1154,22,NZ
2020-06-09,0,0,1154,22,NZ
2020-06-10,0,0,1154,22,NZ
2020-06-11,0,0,1154,22,NZ
2020-06-12,0,0,1154,22,NZ
2020-06-13,0,0,1154,22,NZ
2020-06-14,0,0,1154,22,NZ
2020-06-15,0,0,1154,22,NZ
2020-06-16,2,0,1156,22,NZ
2020-06-17,0,0,1156,22,NZ
2020-06-18,1,0,1157,22,NZ
2020-06-19,0,0,1157,22,NZ
2020-06-20,2,0,1159,22,NZ
2020-06-21,2,0,1161,22,NZ
2020-06-22,2,0,1163,22,NZ
2020-06-23,2,0,1165,22,NZ
2020-06-24,1,0,1166,22,NZ
2020-06-25,3,0,1169,22,NZ
2020-06-26,1,0,1170,22,NZ
2020-06-27,2,0,1172,22,NZ
2019-12-30,0,0,0,0,OM
2019-12-31,0,0,0,0,OM
2020-01-01,0,0,0,0,OM
2020-01-02,0,0,0,0,OM
2020-01-03,0,0,0,0,OM
2020-01-04,0,0,0,0,OM
2020-01-05,0,0,0,0,OM
2020-01-06,0,0,0,0,OM
2020-01-07,0,0,0,0,OM
2020-01-08,0,0,0,0,OM
2020-01-09,0,0,0,0,OM
2020-01-10,0,0,0,0,OM
2020-01-11,0,0,0,0,OM
2020-01-12,0,0,0,0,OM
2020-01-13,0,0,0,0,OM
2020-01-14,0,0,0,0,OM
2020-01-15,0,0,0,0,OM
2020-01-16,0,0,0,0,OM
2020-01-17,0,0,0,0,OM
2020-01-18,0,0,0,0,OM
2020-01-19,0,0,0,0,OM
2020-01-20,0,0,0,0,OM
2020-01-21,0,0,0,0,OM
2020-01-22,0,0,0,0,OM
2020-01-23,0,0,0,0,OM
2020-01-24,0,0,0,0,OM
2020-01-25,0,0,0,0,OM
2020-01-26,0,0,0,0,OM
2020-01-27,0,0,0,0,OM
2020-01-28,0,0,0,0,OM
2020-01-29,0,0,0,0,OM
2020-01-30,0,0,0,0,OM
2020-01-31,0,0,0,0,OM
2020-02-01,0,0,0,0,OM
2020-02-02,0,0,0,0,OM
2020-02-03,0,0,0,0,OM
2020-02-04,0,0,0,0,OM
2020-02-05,0,0,0,0,OM
2020-02-06,0,0,0,0,OM
2020-02-07,0,0,0,0,OM
2020-02-08,0,0,0,0,OM
2020-02-09,0,0,0,0,OM
2020-02-10,0,0,0,0,OM
2020-02-11,0,0,0,0,OM
2020-02-12,0,0,0,0,OM
2020-02-13,0,0,0,0,OM
2020-02-14,0,0,0,0,OM
2020-02-15,0,0,0,0,OM
2020-02-16,0,0,0,0,OM
2020-02-17,0,0,0,0,OM
2020-02-18,0,0,0,0,OM
2020-02-19,0,0,0,0,OM
2020-02-20,0,0,0,0,OM
2020-02-21,0,0,0,0,OM
2020-02-22,0,0,0,0,OM
2020-02-23,0,0,0,0,OM
2020-02-24,2,0,2,0,OM
2020-02-25,2,0,4,0,OM
2020-02-26,0,0,4,0,OM
2020-02-27,2,0,6,0,OM
2020-02-28,0,0,6,0,OM
2020-02-29,0,0,6,0,OM
2020-03-01,0,0,6,0,OM
2020-03-02,1,0,7,0,OM
2020-03-04,8,0,15,0,OM
2020-03-05,1,0,16,0,OM
2020-03-09,2,0,18,0,OM
2020-03-10,0,0,18,0,OM
2020-03-13,2,0,20,0,OM
2020-03-14,0,0,20,0,OM
2020-03-15,2,0,22,0,OM
2020-03-16,2,0,24,0,OM
2020-03-17,0,0,24,0,OM
2020-03-18,15,0,39,0,OM
2020-03-19,0,0,39,0,OM
2020-03-20,9,0,48,0,OM
2020-03-21,4,0,52,0,OM
2020-03-22,3,0,55,0,OM
2020-03-23,11,0,66,0,OM
2020-03-24,18,0,84,0,OM
2020-03-25,15,0,99,0,OM
2020-03-26,10,0,109,0,OM
2020-03-27,22,0,131,0,OM
2020-03-28,21,0,152,0,OM
2020-03-29,15,0,167,0,OM
2020-03-30,12,0,179,0,OM
2020-03-31,13,1,192,1,OM
2020-04-01,18,0,210,1,OM
2020-04-02,21,0,231,1,OM
2020-04-03,0,0,231,1,OM
2020-04-04,46,1,277,2,OM
2020-04-05,21,0,298,2,OM
2020-04-06,73,0,371,2,OM
2020-04-07,48,0,419,2,OM
2020-04-08,0,0,419,2,OM
2020-04-09,38,1,457,3,OM
2020-04-10,27,0,484,3,OM
2020-04-11,62,0,546,3,OM
2020-04-12,53,1,599,4,OM
2020-04-13,214,0,813,4,OM
2020-04-14,97,0,910,4,OM
2020-04-15,0,0,910,4,OM
2020-04-16,109,0,1019,4,OM
2020-04-17,50,2,1069,6,OM
2020-04-18,111,0,1180,6,OM
2020-04-19,86,1,1266,7,OM
2020-04-20,242,1,1508,8,OM
2020-04-21,0,0,1508,8,OM
2020-04-22,106,0,1614,8,OM
2020-04-23,102,1,1716,9,OM
2020-04-24,74,1,1790,10,OM
2020-04-25,115,0,1905,10,OM
2020-04-26,93,0,1998,10,OM
2020-04-27,51,0,2049,10,OM
2020-04-28,82,0,2131,10,OM
2020-04-29,143,0,2274,10,OM
2020-04-30,74,1,2348,11,OM
2020-05-01,99,0,2447,11,OM
2020-05-02,36,1,2483,12,OM
2020-05-03,85,0,2568,12,OM
2020-05-04,69,0,2637,12,OM
2020-05-05,98,0,2735,12,OM
2020-05-06,168,1,2903,13,OM
2020-05-07,55,1,2958,14,OM
2020-05-08,154,1,3112,15,OM
2020-05-09,112,2,3224,17,OM
2020-05-10,175,0,3399,17,OM
2020-05-11,175,0,3574,17,OM
2020-05-12,147,0,3721,17,OM
2020-05-13,298,0,4019,17,OM
2020-05-14,322,2,4341,19,OM
2020-05-15,284,0,4625,19,OM
2020-05-16,404,2,5029,21,OM
2020-05-17,157,1,5186,22,OM
2020-05-18,193,4,5379,26,OM
2020-05-19,292,1,5671,27,OM
2020-05-20,372,3,6043,30,OM
2020-05-21,327,1,6370,31,OM
2020-05-22,424,1,6794,32,OM
2020-05-23,463,4,7257,36,OM
2020-05-24,513,1,7770,37,OM
2020-05-25,0,0,7770,37,OM
2020-05-26,348,0,8118,37,OM
2020-05-27,255,1,8373,38,OM
2020-05-28,636,2,9009,40,OM
2020-05-29,811,0,9820,40,OM
2020-05-30,603,2,10423,42,OM
2020-05-31,1014,5,11437,47,OM
2020-06-01,786,3,12223,50,OM
2020-06-02,576,9,12799,59,OM
2020-06-03,738,8,13537,67,OM
2020-06-04,779,0,14316,67,OM
2020-06-05,770,5,15086,72,OM
2020-06-06,930,0,16016,72,OM
2020-06-07,866,3,16882,75,OM
2020-06-08,604,6,17486,81,OM
2020-06-09,712,2,18198,83,OM
2020-06-10,689,1,18887,84,OM
2020-06-11,1067,5,19954,89,OM
2020-06-12,1117,7,21071,96,OM
2020-06-13,1006,3,22077,99,OM
2020-06-14,1404,5,23481,104,OM
2020-06-15,1043,4,24524,108,OM
2020-06-16,745,6,25269,114,OM
2020-06-17,810,2,26079,116,OM
2020-06-18,739,3,26818,119,OM
2020-06-19,852,6,27670,125,OM
2020-06-20,896,3,28566,128,OM
2020-06-21,905,3,29471,131,OM
2020-06-22,1605,6,31076,137,OM
2020-06-23,1318,3,32394,140,OM
2020-06-24,1142,2,33536,142,OM
2020-06-25,1366,2,34902,144,OM
2020-06-26,1132,9,36034,153,OM
2020-03-09,1,0,1,0,PA
2020-03-10,6,1,7,1,PA
2020-03-11,7,0,14,1,PA
2020-03-12,13,0,27,1,PA
2020-03-13,9,0,36,1,PA
2020-03-14,7,0,43,1,PA
2020-03-15,0,0,43,1,PA
2020-03-16,26,0,69,1,PA
2020-03-17,17,0,86,1,PA
2020-03-18,23,0,109,1,PA
2020-03-19,28,0,137,1,PA
2020-03-20,63,0,200,1,PA
2020-03-21,45,2,245,3,PA
2020-03-22,68,0,313,3,PA
2020-03-23,32,3,345,6,PA
2020-03-24,98,0,443,6,PA
2020-03-25,145,0,588,6,PA
2020-03-26,86,3,674,9,PA
2020-03-27,112,5,786,14,PA
2020-03-28,115,3,901,17,PA
2020-03-29,88,7,989,24,PA
2020-03-30,86,2,1075,26,PA
2020-03-31,106,4,1181,30,PA
2020-04-01,136,2,1317,32,PA
2020-04-02,158,5,1475,37,PA
2020-04-03,198,4,1673,41,PA
2020-04-04,128,5,1801,46,PA
2020-04-05,187,8,1988,54,PA
2020-04-06,112,1,2100,55,PA
2020-04-07,149,4,2249,59,PA
2020-04-08,279,4,2528,63,PA
2020-04-09,224,3,2752,66,PA
2020-04-10,222,8,2974,74,PA
2020-04-11,260,5,3234,79,PA
2020-04-12,166,8,3400,87,PA
2020-04-13,72,7,3472,94,PA
2020-04-14,102,1,3574,95,PA
2020-04-15,177,8,3751,103,PA
2020-04-16,265,6,4016,109,PA
2020-04-17,194,7,4210,116,PA
2020-04-18,63,4,4273,120,PA
2020-04-19,194,6,4467,126,PA
2020-04-20,191,10,4658,136,PA
2020-04-21,163,5,4821,141,PA
2020-04-22,171,3,4992,144,PA
2020-04-23,174,2,5166,146,PA
2020-04-24,172,8,5338,154,PA
2020-04-25,200,5,5538,159,PA
2020-04-26,241,6,5779,165,PA
2020-04-27,242,2,6021,167,PA
2020-04-28,179,9,6200,176,PA
2020-04-29,178,2,6378,178,PA
2020-04-30,154,10,6532,188,PA
2020-05-01,188,4,6720,192,PA
2020-05-02,370,5,7090,197,PA
2020-05-03,107,3,7197,200,PA
2020-05-04,190,3,7387,203,PA
2020-05-05,136,7,7523,210,PA
2020-05-06,208,8,7731,218,PA
2020-05-07,137,7,7868,225,PA
2020-05-08,202,6,8070,231,PA
2020-05-09,212,6,8282,237,PA
2020-05-10,166,7,8448,244,PA
2020-05-11,168,5,8616,249,PA
2020-05-12,167,3,8783,252,PA
2020-05-13,161,4,8944,256,PA
2020-05-14,174,4,9118,260,PA
2020-05-15,150,6,9268,266,PA
2020-05-16,181,3,9449,269,PA
2020-05-17,157,6,9606,275,PA
2020-05-18,120,4,9726,279,PA
2020-05-19,141,2,9867,281,PA
2020-05-20,110,6,9977,287,PA
2020-05-21,139,4,10116,291,PA
2020-05-22,151,4,10267,295,PA
2020-05-23,310,4,10577,299,PA
2020-05-24,349,7,10926,306,PA
2020-05-25,257,4,11183,310,PA
2020-05-26,264,3,11447,313,PA
2020-05-27,281,2,11728,315,PA
2020-05-28,403,5,12131,320,PA
2020-05-29,400,6,12531,326,PA
2020-05-30,487,4,13018,330,PA
2020-05-31,445,6,13463,336,PA
2020-06-01,374,8,13837,344,PA
2020-06-02,258,8,14095,352,PA
2020-06-03,514,5,14609,357,PA
2020-06-04,435,6,15044,363,PA
2020-06-05,419,7,15463,370,PA
2020-06-06,541,16,16004,386,PA
2020-06-07,421,7,16425,393,PA
2020-06-08,429,5,16854,398,PA
2020-06-09,379,5,17233,403,PA
2020-06-10,656,10,17889,413,PA
2020-06-11,697,5,18586,418,PA
2020-06-12,625,3,19211,421,PA
2020-06-13,848,8,20059,429,PA
2020-06-14,627,8,20686,437,PA
2020-06-15,736,11,21422,448,PA
2020-06-16,540,9,21962,457,PA
2020-06-17,635,13,22597,470,PA
2020-06-18,754,5,23351,475,PA
2020-06-19,923,10,24274,485,PA
2020-06-20,948,8,25222,493,PA
2020-06-21,808,8,26030,501,PA
2020-06-22,722,20,26752,521,PA
2020-06-23,562,15,27314,536,PA
2020-06-24,716,11,28030,547,PA
2020-06-25,1007,17,29037,564,PA
2020-06-26,868,11,29905,575,PA
2020-03-06,1,0,1,0,PE
2020-03-08,6,0,7,0,PE
2020-03-09,2,0,9,0,PE
2020-03-10,2,0,11,0,PE
2020-03-11,6,0,17,0,PE
2020-03-12,5,0,22,0,PE
2020-03-13,16,0,38,0,PE
2020-03-14,5,0,43,0,PE
2020-03-15,28,0,71,0,PE
2020-03-16,15,0,86,0,PE
2020-03-17,31,0,117,0,PE
2020-03-18,28,0,145,0,PE
2020-03-19,89,2,234,2,PE
2020-03-20,29,1,263,3,PE
2020-03-21,55,2,318,5,PE
2020-03-22,45,0,363,5,PE
2020-03-23,32,0,395,5,PE
2020-03-24,21,2,416,7,PE
2020-03-25,142,1,558,8,PE
2020-03-26,22,1,580,9,PE
2020-03-27,55,2,635,11,PE
2020-03-28,36,5,671,16,PE
2020-03-29,181,2,852,18,PE
2020-03-30,98,6,950,24,PE
2020-03-31,115,6,1065,30,PE
2020-04-01,258,17,1323,47,PE
2020-04-02,91,8,1414,55,PE
2020-04-03,181,6,1595,61,PE
2020-04-04,151,12,1746,73,PE
2020-04-05,535,10,2281,83,PE
2020-04-06,280,9,2561,92,PE
2020-04-07,393,15,2954,107,PE
2020-04-08,1388,14,4342,121,PE
2020-04-09,914,17,5256,138,PE
2020-04-10,641,31,5897,169,PE
2020-04-11,951,12,6848,181,PE
2020-04-12,671,12,7519,193,PE
2020-04-13,0,0,7519,193,PE
2020-04-14,2784,37,10303,230,PE
2020-04-15,1172,24,11475,254,PE
2020-04-16,1016,20,12491,274,PE
2020-04-17,998,26,13489,300,PE
2020-04-18,931,48,14420,348,PE
2020-04-19,1208,52,15628,400,PE
2020-04-20,697,45,16325,445,PE
2020-04-21,1512,39,17837,484,PE
2020-04-22,1413,46,19250,530,PE
2020-04-23,1664,42,20914,572,PE
2020-04-24,734,62,21648,634,PE
2020-04-25,3683,66,25331,700,PE
2020-04-26,2186,28,27517,728,PE
2020-04-27,1182,54,28699,782,PE
2020-04-28,2491,72,31190,854,PE
2020-04-29,2741,89,33931,943,PE
2020-04-30,3045,108,36976,1051,PE
2020-05-01,3483,73,40459,1124,PE
2020-05-02,2075,76,42534,1200,PE
2020-05-03,3394,86,45928,1286,PE
2020-05-04,1444,58,47372,1344,PE
2020-05-05,3817,100,51189,1444,PE
2020-05-06,3628,89,54817,1533,PE
2020-05-07,3709,94,58526,1627,PE
2020-05-08,3321,87,61847,1714,PE
2020-05-09,3168,100,65015,1814,PE
2020-05-10,2292,75,67307,1889,PE
2020-05-11,1515,72,68822,1961,PE
2020-05-12,3237,96,72059,2057,PE
2020-05-13,4247,112,76306,2169,PE
2020-05-14,4298,98,80604,2267,PE
2020-05-15,3891,126,84495,2393,PE
2020-05-16,4046,130,88541,2523,PE
2020-05-17,3732,125,92273,2648,PE
2020-05-18,2660,141,94933,2789,PE
2020-05-19,4550,125,99483,2914,PE
2020-05-20,4537,110,104020,3024,PE
2020-05-21,4749,124,108769,3148,PE
2020-05-22,2929,96,111698,3244,PE
2020-05-23,4056,129,115754,3373,PE
2020-05-24,4205,83,119959,3456,PE
2020-05-25,4020,173,123979,3629,PE
2020-05-26,5772,159,129751,3788,PE
2020-05-27,6154,195,135905,3983,PE
2020-05-28,5874,116,141779,4099,PE
2020-05-29,6506,131,148285,4230,PE
2020-05-30,7386,141,155671,4371,PE
2020-05-31,8805,135,164476,4506,PE
2020-06-01,5563,128,170039,4634,PE
2020-06-02,0,0,170039,4634,PE
2020-06-03,8875,260,178914,4894,PE
2020-06-04,4284,137,183198,5031,PE
2020-06-05,4202,131,187400,5162,PE
2020-06-06,4358,139,191758,5301,PE
2020-06-07,4757,164,196515,5465,PE
2020-06-08,3181,106,199696,5571,PE
2020-06-09,4040,167,203736,5738,PE
2020-06-10,5087,165,208823,5903,PE
2020-06-11,5965,206,214788,6109,PE
2020-06-12,5961,199,220749,6308,PE
2020-06-13,4383,190,225132,6498,PE
2020-06-14,4604,190,229736,6688,PE
2020-06-15,3256,172,232992,6860,PE
2020-06-16,4164,196,237156,7056,PE
2020-06-17,3752,201,240908,7257,PE
2020-06-18,3480,204,244388,7461,PE
2020-06-19,3537,199,247925,7660,PE
2020-06-20,3413,201,251338,7861,PE
2020-06-21,3598,184,254936,8045,PE
2020-06-22,0,0,254936,8045,PE
2020-06-23,5874,359,260810,8404,PE
2020-06-24,3879,182,264689,8586,PE
2020-06-25,3913,175,268602,8761,PE
2020-06-26,3762,178,272364,8939,PE
2020-03-18,3,0,3,0,PF
2020-03-19,0,0,3,0,PF
2020-03-20,12,0,15,0,PF
2020-03-21,2,0,17,0,PF
2020-03-22,1,0,18,0,PF
2020-03-23,5,0,23,0,PF
2020-03-24,2,0,25,0,PF
2020-03-25,0,0,25,0,PF
2020-03-26,5,0,30,0,PF
2020-03-27,0,0,30,0,PF
2020-03-28,4,0,34,0,PF
2020-03-29,1,0,35,0,PF
2020-03-30,1,0,36,0,PF
2020-03-31,1,0,37,0,PF
2020-04-01,0,0,37,0,PF
2020-04-02,0,0,37,0,PF
2020-04-03,2,0,39,0,PF
2020-04-04,1,0,40,0,PF
2020-04-05,1,0,41,0,PF
2020-04-06,0,0,41,0,PF
2020-04-07,6,0,47,0,PF
2020-04-08,4,0,51,0,PF
2020-04-09,0,0,51,0,PF
2020-04-10,0,0,51,0,PF
2020-04-11,0,0,51,0,PF
2020-04-12,2,0,53,0,PF
2020-04-13,2,0,55,0,PF
2020-04-14,0,0,55,0,PF
2020-04-15,0,0,55,0,PF
2020-04-16,0,0,55,0,PF
2020-04-17,0,0,55,0,PF
2020-04-18,0,0,55,0,PF
2020-04-19,0,0,55,0,PF
2020-04-20,1,0,56,0,PF
2020-04-21,1,0,57,0,PF
2020-04-22,0,0,57,0,PF
2020-04-23,0,0,57,0,PF
2020-04-24,0,0,57,0,PF
2020-04-25,0,0,57,0,PF
2020-04-26,0,0,57,0,PF
2020-04-27,1,0,58,0,PF
2020-04-28,0,0,58,0,PF
2020-04-29,0,0,58,0,PF
2020-04-30,0,0,58,0,PF
2020-05-01,0,0,58,0,PF
2020-05-02,0,0,58,0,PF
2020-05-03,0,0,58,0,PF
2020-05-04,0,0,58,0,PF
2020-05-05,2,0,60,0,PF
2020-05-06,0,0,60,0,PF
2020-05-07,0,0,60,0,PF
2020-05-08,0,0,60,0,PF
2020-05-09,0,0,60,0,PF
2020-05-10,0,0,60,0,PF
2020-05-11,0,0,60,0,PF
2020-05-12,0,0,60,0,PF
2020-05-13,0,0,60,0,PF
2020-05-14,0,0,60,0,PF
2020-05-15,0,0,60,0,PF
2020-05-16,0,0,60,0,PF
2020-05-17,0,0,60,0,PF
2020-05-18,0,0,60,0,PF
2020-05-19,0,0,60,0,PF
2020-05-20,0,0,60,0,PF
2020-05-21,0,0,60,0,PF
2020-05-22,0,0,60,0,PF
2020-05-23,0,0,60,0,PF
2020-05-24,0,0,60,0,PF
2020-05-25,0,0,60,0,PF
2020-05-26,0,0,60,0,PF
2020-05-27,0,0,60,0,PF
2020-05-28,0,0,60,0,PF
2020-05-29,0,0,60,0,PF
2020-05-30,0,0,60,0,PF
2020-05-31,0,0,60,0,PF
2020-06-01,0,0,60,0,PF
2020-06-02,0,0,60,0,PF
2020-06-03,0,0,60,0,PF
2020-06-04,0,0,60,0,PF
2020-06-05,0,0,60,0,PF
2020-06-06,0,0,60,0,PF
2020-06-07,0,0,60,0,PF
2020-06-08,0,0,60,0,PF
2020-06-09,0,0,60,0,PF
2020-06-10,0,0,60,0,PF
2020-06-11,0,0,60,0,PF
2020-06-12,0,0,60,0,PF
2020-06-13,0,0,60,0,PF
2020-06-14,0,0,60,0,PF
2020-06-15,0,0,60,0,PF
2020-06-16,0,0,60,0,PF
2020-06-17,0,0,60,0,PF
2020-06-18,0,0,60,0,PF
2020-06-19,0,0,60,0,PF
2020-06-20,0,0,60,0,PF
2020-06-21,0,0,60,0,PF
2020-06-22,0,0,60,0,PF
2020-06-23,0,0,60,0,PF
2020-06-24,0,0,60,0,PF
2020-06-25,0,0,60,0,PF
2020-06-26,2,0,62,0,PF
2020-03-20,1,0,1,0,PG
2020-03-21,0,0,1,0,PG
2020-03-22,0,0,1,0,PG
2020-03-23,0,0,1,0,PG
2020-03-24,0,0,1,0,PG
2020-03-25,0,0,1,0,PG
2020-03-26,0,0,1,0,PG
2020-03-27,0,0,1,0,PG
2020-03-28,0,0,1,0,PG
2020-03-29,0,0,1,0,PG
2020-03-30,0,0,1,0,PG
2020-03-31,0,0,1,0,PG
2020-04-01,0,0,1,0,PG
2020-04-02,0,0,1,0,PG
2020-04-03,0,0,1,0,PG
2020-04-04,0,0,1,0,PG
2020-04-05,0,0,1,0,PG
2020-04-06,0,0,1,0,PG
2020-04-07,1,0,2,0,PG
2020-04-08,0,0,2,0,PG
2020-04-09,0,0,2,0,PG
2020-04-10,0,0,2,0,PG
2020-04-11,0,0,2,0,PG
2020-04-12,0,0,2,0,PG
2020-04-13,0,0,2,0,PG
2020-04-14,0,0,2,0,PG
2020-04-15,0,0,2,0,PG
2020-04-16,5,0,7,0,PG
2020-04-17,0,0,7,0,PG
2020-04-18,0,0,7,0,PG
2020-04-19,0,0,7,0,PG
2020-04-20,0,0,7,0,PG
2020-04-21,0,0,7,0,PG
2020-04-22,1,0,8,0,PG
2020-04-23,0,0,8,0,PG
2020-04-24,0,0,8,0,PG
2020-04-25,0,0,8,0,PG
2020-04-26,0,0,8,0,PG
2020-04-27,0,0,8,0,PG
2020-04-28,0,0,8,0,PG
2020-04-29,0,0,8,0,PG
2020-04-30,0,0,8,0,PG
2020-05-01,0,0,8,0,PG
2020-05-02,0,0,8,0,PG
2020-05-03,0,0,8,0,PG
2020-05-04,0,0,8,0,PG
2020-05-05,0,0,8,0,PG
2020-05-06,0,0,8,0,PG
2020-05-07,0,0,8,0,PG
2020-05-08,0,0,8,0,PG
2020-05-09,0,0,8,0,PG
2020-05-10,0,0,8,0,PG
2020-05-11,0,0,8,0,PG
2020-05-12,0,0,8,0,PG
2020-05-13,0,0,8,0,PG
2020-05-14,0,0,8,0,PG
2020-05-15,0,0,8,0,PG
2020-05-16,0,0,8,0,PG
2020-05-17,0,0,8,0,PG
2020-05-18,0,0,8,0,PG
2020-05-19,0,0,8,0,PG
2020-05-20,0,0,8,0,PG
2020-05-21,0,0,8,0,PG
2020-05-22,0,0,8,0,PG
2020-05-23,0,0,8,0,PG
2020-05-24,0,0,8,0,PG
2020-05-25,0,0,8,0,PG
2020-05-26,0,0,8,0,PG
2020-05-27,0,0,8,0,PG
2020-05-28,0,0,8,0,PG
2020-05-29,0,0,8,0,PG
2020-05-30,0,0,8,0,PG
2020-05-31,0,0,8,0,PG
2020-06-01,0,0,8,0,PG
2020-06-02,0,0,8,0,PG
2020-06-03,0,0,8,0,PG
2020-06-04,0,0,8,0,PG
2020-06-05,0,0,8,0,PG
2020-06-06,0,0,8,0,PG
2020-06-07,0,0,8,0,PG
2020-06-08,0,0,8,0,PG
2020-06-09,0,0,8,0,PG
2020-06-10,0,0,8,0,PG
2020-06-11,0,0,8,0,PG
2020-06-12,0,0,8,0,PG
2020-06-13,0,0,8,0,PG
2020-06-14,0,0,8,0,PG
2020-06-15,0,0,8,0,PG
2020-06-16,0,0,8,0,PG
2020-06-17,0,0,8,0,PG
2020-06-18,0,0,8,0,PG
2020-06-19,0,0,8,0,PG
2020-06-20,0,0,8,0,PG
2020-06-21,1,0,9,0,PG
2020-06-22,0,0,9,0,PG
2020-06-23,0,0,9,0,PG
2020-06-24,1,0,10,0,PG
2020-06-25,1,0,11,0,PG
2020-06-26,0,0,11,0,PG
2019-12-30,0,0,0,0,PH
2019-12-31,0,0,0,0,PH
2020-01-01,0,0,0,0,PH
2020-01-02,0,0,0,0,PH
2020-01-03,0,0,0,0,PH
2020-01-04,0,0,0,0,PH
2020-01-05,0,0,0,0,PH
2020-01-06,0,0,0,0,PH
2020-01-07,0,0,0,0,PH
2020-01-08,0,0,0,0,PH
2020-01-09,0,0,0,0,PH
2020-01-10,0,0,0,0,PH
2020-01-11,0,0,0,0,PH
2020-01-12,0,0,0,0,PH
2020-01-13,0,0,0,0,PH
2020-01-14,0,0,0,0,PH
2020-01-15,0,0,0,0,PH
2020-01-16,0,0,0,0,PH
2020-01-17,0,0,0,0,PH
2020-01-18,0,0,0,0,PH
2020-01-19,0,0,0,0,PH
2020-01-20,0,0,0,0,PH
2020-01-21,0,0,0,0,PH
2020-01-22,0,0,0,0,PH
2020-01-23,0,0,0,0,PH
2020-01-24,0,0,0,0,PH
2020-01-25,0,0,0,0,PH
2020-01-26,0,0,0,0,PH
2020-01-27,0,0,0,0,PH
2020-01-28,0,0,0,0,PH
2020-01-29,1,0,1,0,PH
2020-01-30,0,0,1,0,PH
2020-01-31,0,0,1,0,PH
2020-02-01,1,1,2,1,PH
2020-02-02,0,0,2,1,PH
2020-02-03,0,0,2,1,PH
2020-02-04,0,0,2,1,PH
2020-02-05,1,0,3,1,PH
2020-02-06,0,0,3,1,PH
2020-02-07,0,0,3,1,PH
2020-02-08,0,0,3,1,PH
2020-02-09,0,0,3,1,PH
2020-02-10,0,0,3,1,PH
2020-02-11,0,0,3,1,PH
2020-02-12,0,0,3,1,PH
2020-02-13,0,0,3,1,PH
2020-02-14,0,0,3,1,PH
2020-02-15,0,0,3,1,PH
2020-02-16,0,0,3,1,PH
2020-02-17,0,0,3,1,PH
2020-02-18,0,0,3,1,PH
2020-02-19,0,0,3,1,PH
2020-02-20,0,0,3,1,PH
2020-02-21,0,0,3,1,PH
2020-02-22,0,0,3,1,PH
2020-02-23,0,0,3,1,PH
2020-02-24,0,0,3,1,PH
2020-02-25,0,0,3,1,PH
2020-02-26,0,0,3,1,PH
2020-02-27,0,0,3,1,PH
2020-02-28,0,0,3,1,PH
2020-02-29,0,0,3,1,PH
2020-03-01,0,0,3,1,PH
2020-03-06,2,0,5,1,PH
2020-03-07,1,0,6,1,PH
2020-03-08,4,0,10,1,PH
2020-03-09,23,0,33,1,PH
2020-03-10,0,0,33,1,PH
2020-03-11,16,1,49,2,PH
2020-03-12,3,0,52,2,PH
2020-03-13,12,4,64,6,PH
2020-03-14,47,0,111,6,PH
2020-03-15,29,6,140,12,PH
2020-03-16,2,0,142,12,PH
2020-03-17,45,2,187,14,PH
2020-03-18,15,3,202,17,PH
2020-03-19,28,1,230,18,PH
2020-03-20,0,0,230,18,PH
2020-03-21,150,7,380,25,PH
2020-03-22,0,0,380,25,PH
2020-03-23,82,8,462,33,PH
2020-03-24,90,2,552,35,PH
2020-03-25,84,3,636,38,PH
2020-03-26,71,7,707,45,PH
2020-03-27,96,9,803,54,PH
2020-03-28,272,14,1075,68,PH
2020-03-29,343,3,1418,71,PH
2020-03-30,666,17,2084,88,PH
2020-03-31,0,0,2084,88,PH
2020-04-01,227,8,2311,96,PH
2020-04-02,322,11,2633,107,PH
2020-04-03,385,29,3018,136,PH
2020-04-04,76,8,3094,144,PH
2020-04-05,152,8,3246,152,PH
2020-04-06,414,11,3660,163,PH
2020-04-07,104,14,3764,177,PH
2020-04-08,106,5,3870,182,PH
2020-04-09,206,21,4076,203,PH
2020-04-10,0,0,4076,203,PH
2020-04-11,352,44,4428,247,PH
2020-04-12,220,50,4648,297,PH
2020-04-13,284,18,4932,315,PH
2020-04-14,291,20,5223,335,PH
2020-04-15,230,14,5453,349,PH
2020-04-16,207,13,5660,362,PH
2020-04-17,218,25,5878,387,PH
2020-04-18,209,10,6087,397,PH
2020-04-19,172,12,6259,409,PH
2020-04-20,200,19,6459,428,PH
2020-04-21,140,9,6599,437,PH
2020-04-22,111,9,6710,446,PH
2020-04-23,271,16,6981,462,PH
2020-04-24,211,15,7192,477,PH
2020-04-25,102,17,7294,494,PH
2020-04-26,285,7,7579,501,PH
2020-04-27,198,10,7777,511,PH
2020-04-28,181,19,7958,530,PH
2020-04-29,254,28,8212,558,PH
2020-04-30,276,10,8488,568,PH
2020-05-01,284,11,8772,579,PH
2020-05-02,156,24,8928,603,PH
2020-05-03,295,4,9223,607,PH
2020-05-04,262,16,9485,623,PH
2020-05-05,199,14,9684,637,PH
2020-05-06,320,21,10004,658,PH
2020-05-07,339,27,10343,685,PH
2020-05-08,120,11,10463,696,PH
2020-05-09,147,8,10610,704,PH
2020-05-10,184,15,10794,719,PH
2020-05-11,292,7,11086,726,PH
2020-05-12,264,25,11350,751,PH
2020-05-13,268,21,11618,772,PH
2020-05-14,258,18,11876,790,PH
2020-05-15,215,16,12091,806,PH
2020-05-16,214,11,12305,817,PH
2020-05-17,208,7,12513,824,PH
2020-05-18,205,7,12718,831,PH
2020-05-19,224,6,12942,837,PH
2020-05-20,279,5,13221,842,PH
2020-05-21,213,4,13434,846,PH
2020-05-22,163,11,13597,857,PH
2020-05-23,180,6,13777,863,PH
2020-05-24,258,5,14035,868,PH
2020-05-25,284,5,14319,873,PH
2020-05-26,350,13,14669,886,PH
2020-05-27,380,18,15049,904,PH
2020-05-28,539,17,15588,921,PH
2020-05-29,1046,21,16634,942,PH
2020-05-30,590,8,17224,950,PH
2020-05-31,862,7,18086,957,PH
2020-06-01,552,3,18638,960,PH
2020-06-02,359,6,18997,966,PH
2020-06-03,751,8,19748,974,PH
2020-06-04,634,10,20382,984,PH
2020-06-05,244,3,20626,987,PH
2020-06-06,714,7,21340,994,PH
2020-06-07,555,9,21895,1003,PH
2020-06-08,579,8,22474,1011,PH
2020-06-09,518,6,22992,1017,PH
2020-06-10,740,10,23732,1027,PH
2020-06-11,443,9,24175,1036,PH
2020-06-12,612,16,24787,1052,PH
2020-06-13,605,22,25392,1074,PH
2020-06-14,538,14,25930,1088,PH
2020-06-15,490,10,26420,1098,PH
2020-06-16,361,5,26781,1103,PH
2020-06-17,457,5,27238,1108,PH
2020-06-18,561,8,27799,1116,PH
2020-06-19,660,14,28459,1130,PH
2020-06-20,941,20,29400,1150,PH
2020-06-21,652,19,30052,1169,PH
2020-06-22,630,8,30682,1177,PH
2020-06-23,1143,9,31825,1186,PH
2020-06-24,470,18,32295,1204,PH
2020-06-25,774,8,33069,1212,PH
2020-06-26,1004,12,34073,1224,PH
2019-12-30,0,0,0,0,PK
2019-12-31,0,0,0,0,PK
2020-01-01,0,0,0,0,PK
2020-01-02,0,0,0,0,PK
2020-01-03,0,0,0,0,PK
2020-01-04,0,0,0,0,PK
2020-01-05,0,0,0,0,PK
2020-01-06,0,0,0,0,PK
2020-01-07,0,0,0,0,PK
2020-01-08,0,0,0,0,PK
2020-01-09,0,0,0,0,PK
2020-01-10,0,0,0,0,PK
2020-01-11,0,0,0,0,PK
2020-01-12,0,0,0,0,PK
2020-01-13,0,0,0,0,PK
2020-01-14,0,0,0,0,PK
2020-01-15,0,0,0,0,PK
2020-01-16,0,0,0,0,PK
2020-01-17,0,0,0,0,PK
2020-01-18,0,0,0,0,PK
2020-01-19,0,0,0,0,PK
2020-01-20,0,0,0,0,PK
2020-01-21,0,0,0,0,PK
2020-01-22,0,0,0,0,PK
2020-01-23,0,0,0,0,PK
2020-01-24,0,0,0,0,PK
2020-01-25,0,0,0,0,PK
2020-01-26,0,0,0,0,PK
2020-01-27,0,0,0,0,PK
2020-01-28,0,0,0,0,PK
2020-01-29,0,0,0,0,PK
2020-01-30,0,0,0,0,PK
2020-01-31,0,0,0,0,PK
2020-02-01,0,0,0,0,PK
2020-02-02,0,0,0,0,PK
2020-02-03,0,0,0,0,PK
2020-02-04,0,0,0,0,PK
2020-02-05,0,0,0,0,PK
2020-02-06,0,0,0,0,PK
2020-02-07,0,0,0,0,PK
2020-02-08,0,0,0,0,PK
2020-02-09,0,0,0,0,PK
2020-02-10,0,0,0,0,PK
2020-02-11,0,0,0,0,PK
2020-02-12,0,0,0,0,PK
2020-02-13,0,0,0,0,PK
2020-02-14,0,0,0,0,PK
2020-02-15,0,0,0,0,PK
2020-02-16,0,0,0,0,PK
2020-02-17,0,0,0,0,PK
2020-02-18,0,0,0,0,PK
2020-02-19,0,0,0,0,PK
2020-02-20,0,0,0,0,PK
2020-02-21,0,0,0,0,PK
2020-02-22,0,0,0,0,PK
2020-02-23,0,0,0,0,PK
2020-02-24,0,0,0,0,PK
2020-02-25,0,0,0,0,PK
2020-02-26,2,0,2,0,PK
2020-02-27,0,0,2,0,PK
2020-02-28,0,0,2,0,PK
2020-02-29,2,0,4,0,PK
2020-03-01,0,0,4,0,PK
2020-03-03,1,0,5,0,PK
2020-03-06,1,0,6,0,PK
2020-03-09,10,0,16,0,PK
2020-03-10,0,0,16,0,PK
2020-03-11,4,0,20,0,PK
2020-03-12,1,0,21,0,PK
2020-03-13,0,0,21,0,PK
2020-03-14,9,0,30,0,PK
2020-03-15,1,0,31,0,PK
2020-03-16,156,0,187,0,PK
2020-03-17,0,0,187,0,PK
2020-03-18,115,0,302,0,PK
2020-03-19,176,2,478,2,PK
2020-03-20,17,1,495,3,PK
2020-03-21,151,0,646,3,PK
2020-03-22,138,2,784,5,PK
2020-03-23,103,1,887,6,PK
2020-03-24,104,1,991,7,PK
2020-03-25,66,1,1057,8,PK
2020-03-26,140,1,1197,9,PK
2020-03-27,0,0,1197,9,PK
2020-03-28,211,2,1408,11,PK
2020-03-29,118,2,1526,13,PK
2020-03-30,99,5,1625,18,PK
2020-03-31,414,8,2039,26,PK
2020-04-01,252,5,2291,31,PK
2020-04-02,0,0,2291,31,PK
2020-04-03,0,0,2291,31,PK
2020-04-04,159,4,2450,35,PK
2020-04-05,827,15,3277,50,PK
2020-04-06,587,4,3864,54,PK
2020-04-07,208,4,4072,58,PK
2020-04-08,250,5,4322,63,PK
2020-04-09,279,3,4601,66,PK
2020-04-10,187,5,4788,71,PK
2020-04-11,250,15,5038,86,PK
2020-04-12,336,7,5374,93,PK
2020-04-13,342,3,5716,96,PK
2020-04-14,272,11,5988,107,PK
2020-04-15,517,17,6505,124,PK
2020-04-16,520,11,7025,135,PK
2020-04-17,456,8,7481,143,PK
2020-04-18,512,16,7993,159,PK
2020-04-19,425,17,8418,176,PK
2020-04-20,798,16,9216,192,PK
2020-04-21,533,17,9749,209,PK
2020-04-22,0,0,9749,209,PK
2020-04-23,1406,28,11155,237,PK
2020-04-24,785,16,11940,253,PK
2020-04-25,783,16,12723,269,PK
2020-04-26,605,12,13328,281,PK
2020-04-27,751,20,14079,301,PK
2020-04-28,806,26,14885,327,PK
2020-04-29,874,19,15759,346,PK
2020-04-30,1058,39,16817,385,PK
2020-05-01,1297,32,18114,417,PK
2020-05-02,989,23,19103,440,PK
2020-05-03,1083,22,20186,462,PK
2020-05-04,1315,24,21501,486,PK
2020-05-05,1049,40,22550,526,PK
2020-05-06,1523,38,24073,564,PK
2020-05-07,1764,30,25837,594,PK
2020-05-08,1637,24,27474,618,PK
2020-05-09,1991,21,29465,639,PK
2020-05-10,1476,28,30941,667,PK
2020-05-11,1140,39,32081,706,PK
2020-05-12,2255,31,34336,737,PK
2020-05-13,1452,33,35788,770,PK
2020-05-14,1430,33,37218,803,PK
2020-05-15,1581,31,38799,834,PK
2020-05-16,1352,39,40151,873,PK
2020-05-17,1974,30,42125,903,PK
2020-05-18,1841,36,43966,939,PK
2020-05-19,1932,46,45898,985,PK
2020-05-20,2193,32,48091,1017,PK
2020-05-21,2603,50,50694,1067,PK
2020-05-22,1743,34,52437,1101,PK
2020-05-23,2164,32,54601,1133,PK
2020-05-24,1748,34,56349,1167,PK
2020-05-25,1356,30,57705,1197,PK
2020-05-26,1446,28,59151,1225,PK
2020-05-27,2076,35,61227,1260,PK
2020-05-28,2801,57,64028,1317,PK
2020-05-29,2429,78,66457,1395,PK
2020-05-30,3039,88,69496,1483,PK
2020-05-31,2964,60,72460,1543,PK
2020-06-01,3938,78,76398,1621,PK
2020-06-02,4065,67,80463,1688,PK
2020-06-03,4801,82,85264,1770,PK
2020-06-04,3985,68,89249,1838,PK
2020-06-05,4734,97,93983,1935,PK
2020-06-06,4960,67,98943,2002,PK
2020-06-07,4728,65,103671,2067,PK
2020-06-08,4646,105,108317,2172,PK
2020-06-09,5385,83,113702,2255,PK
2020-06-10,5834,101,119536,2356,PK
2020-06-11,6397,107,125933,2463,PK
2020-06-12,6472,88,132405,2551,PK
2020-06-13,6825,81,139230,2632,PK
2020-06-14,5248,97,144478,2729,PK
2020-06-15,4443,110,148921,2839,PK
2020-06-16,5839,136,154760,2975,PK
2020-06-17,5358,118,160118,3093,PK
2020-06-18,4944,136,165062,3229,PK
2020-06-19,6604,153,171666,3382,PK
2020-06-20,4951,119,176617,3501,PK
2020-06-21,4471,89,181088,3590,PK
2020-06-22,3946,105,185034,3695,PK
2020-06-23,3892,60,188926,3755,PK
2020-06-24,4044,148,192970,3903,PK
2020-06-25,2775,59,195745,3962,PK
2020-06-26,3138,73,198883,4035,PK
2020-03-03,1,0,1,0,PL
2020-03-06,4,0,5,0,PL
2020-03-07,1,0,6,0,PL
2020-03-08,5,0,11,0,PL
2020-03-09,6,0,17,0,PL
2020-03-10,5,0,22,0,PL
2020-03-11,9,0,31,0,PL
2020-03-12,18,1,49,1,PL
2020-03-13,19,1,68,2,PL
2020-03-14,36,1,104,3,PL
2020-03-15,21,0,125,3,PL
2020-03-16,52,1,177,4,PL
2020-03-17,61,1,238,5,PL
2020-03-18,49,0,287,5,PL
2020-03-19,68,0,355,5,PL
2020-03-20,70,0,425,5,PL
2020-03-21,111,0,536,5,PL
2020-03-22,98,2,634,7,PL
2020-03-23,115,1,749,8,PL
2020-03-24,152,2,901,10,PL
2020-03-25,150,4,1051,14,PL
2020-03-26,170,2,1221,16,PL
2020-03-27,168,0,1389,16,PL
2020-03-28,249,2,1638,18,PL
2020-03-29,224,4,1862,22,PL
2020-03-30,193,9,2055,31,PL
2020-03-31,256,2,2311,33,PL
2020-04-01,243,10,2554,43,PL
2020-04-02,392,14,2946,57,PL
2020-04-03,437,14,3383,71,PL
2020-04-04,244,8,3627,79,PL
2020-04-05,475,15,4102,94,PL
2020-04-06,311,13,4413,107,PL
2020-04-07,435,22,4848,129,PL
2020-04-08,357,30,5205,159,PL
2020-04-09,370,15,5575,174,PL
2020-04-10,380,7,5955,181,PL
2020-04-11,401,27,6356,208,PL
2020-04-12,318,24,6674,232,PL
2020-04-13,260,13,6934,245,PL
2020-04-14,268,18,7202,263,PL
2020-04-15,380,23,7582,286,PL
2020-04-16,336,28,7918,314,PL
2020-04-17,461,18,8379,332,PL
2020-04-18,363,15,8742,347,PL
2020-04-19,545,13,9287,360,PL
2020-04-20,306,20,9593,380,PL
2020-04-21,263,21,9856,401,PL
2020-04-22,313,25,10169,426,PL
2020-04-23,342,28,10511,454,PL
2020-04-24,381,40,10892,494,PL
2020-04-25,381,30,11273,524,PL
2020-04-26,344,11,11617,535,PL
2020-04-27,285,27,11902,562,PL
2020-04-28,316,34,12218,596,PL
2020-04-29,422,28,12640,624,PL
2020-04-30,237,20,12877,644,PL
2020-05-01,228,7,13105,651,PL
2020-05-02,270,13,13375,664,PL
2020-05-03,318,14,13693,678,PL
2020-05-04,313,20,14006,698,PL
2020-05-05,425,18,14431,716,PL
2020-05-06,309,17,14740,733,PL
2020-05-07,307,22,15047,755,PL
2020-05-08,319,21,15366,776,PL
2020-05-09,285,9,15651,785,PL
2020-05-10,345,15,15996,800,PL
2020-05-11,330,11,16326,811,PL
2020-05-12,595,28,16921,839,PL
2020-05-13,283,22,17204,861,PL
2020-05-14,411,22,17615,883,PL
2020-05-15,401,24,18016,907,PL
2020-05-16,241,8,18257,915,PL
2020-05-17,272,10,18529,925,PL
2020-05-18,356,11,18885,936,PL
2020-05-19,383,12,19268,948,PL
2020-05-20,471,14,19739,962,PL
2020-05-21,404,10,20143,972,PL
2020-05-22,476,10,20619,982,PL
2020-05-23,312,11,20931,993,PL
2020-05-24,395,3,21326,996,PL
2020-05-25,305,11,21631,1007,PL
2020-05-26,443,17,22074,1024,PL
2020-05-27,399,4,22473,1028,PL
2020-05-28,352,10,22825,1038,PL
2020-05-29,330,13,23155,1051,PL
2020-05-30,416,10,23571,1061,PL
2020-05-31,215,3,23786,1064,PL
2020-06-01,379,10,24165,1074,PL
2020-06-02,230,18,24395,1092,PL
2020-06-03,0,0,24395,1092,PL
2020-06-04,653,25,25048,1117,PL
2020-06-05,371,20,25419,1137,PL
2020-06-06,567,16,25986,1153,PL
2020-06-07,575,4,26561,1157,PL
2020-06-08,599,9,27160,1166,PL
2020-06-09,400,17,27560,1183,PL
2020-06-10,197,23,27757,1206,PL
2020-06-11,444,9,28201,1215,PL
2020-06-12,376,7,28577,1222,PL
2020-06-13,440,15,29017,1237,PL
2020-06-14,375,10,29392,1247,PL
2020-06-15,396,9,29788,1256,PL
2020-06-16,407,16,30195,1272,PL
2020-06-17,506,14,30701,1286,PL
2020-06-18,314,30,31015,1316,PL
2020-06-19,301,18,31316,1334,PL
2020-06-20,304,12,31620,1346,PL
2020-06-21,311,10,31931,1356,PL
2020-06-22,296,3,32227,1359,PL
2020-06-23,300,16,32527,1375,PL
2020-06-24,294,21,32821,1396,PL
2020-06-25,298,16,33119,1412,PL
2020-06-26,276,17,33395,1429,PL
2020-03-27,64,2,64,2,PR
2020-03-28,36,1,100,3,PR
2020-03-29,27,2,127,5,PR
2020-03-30,47,1,174,6,PR
2020-03-31,65,2,239,8,PR
2020-04-01,47,3,286,11,PR
2020-04-02,30,1,316,12,PR
2020-04-03,62,3,378,15,PR
2020-04-04,74,3,452,18,PR
2020-04-05,23,2,475,20,PR
2020-04-06,38,1,513,21,PR
2020-04-07,60,2,573,23,PR
2020-04-08,47,1,620,24,PR
2020-04-09,63,9,683,33,PR
2020-04-10,42,6,725,39,PR
2020-04-11,63,3,788,42,PR
2020-04-12,109,2,897,44,PR
2020-04-13,6,1,903,45,PR
2020-04-14,20,0,923,45,PR
2020-04-15,51,6,974,51,PR
2020-04-16,69,5,1043,56,PR
2020-04-17,25,2,1068,58,PR
2020-04-18,50,2,1118,60,PR
2020-04-19,95,2,1213,62,PR
2020-04-20,39,1,1252,63,PR
2020-04-21,0,0,1252,63,PR
2020-04-22,0,1,1252,64,PR
2020-04-23,0,5,1252,69,PR
2020-04-24,24,8,1276,77,PR
2020-04-25,31,6,1307,83,PR
2020-04-26,64,1,1371,84,PR
2020-04-27,18,0,1389,84,PR
2020-04-28,11,2,1400,86,PR
2020-04-29,33,0,1433,86,PR
2020-04-30,106,6,1539,92,PR
2020-05-01,36,2,1575,94,PR
2020-05-02,182,1,1757,95,PR
2020-05-03,51,2,1808,97,PR
2020-05-04,35,0,1843,97,PR
2020-05-05,81,2,1924,99,PR
2020-05-06,44,0,1968,99,PR
2020-05-07,63,3,2031,102,PR
2020-05-08,125,5,2156,107,PR
2020-05-09,17,1,2173,108,PR
2020-05-10,25,3,2198,111,PR
2020-05-11,58,2,2256,113,PR
2020-05-12,43,1,2299,114,PR
2020-05-13,30,1,2329,115,PR
2020-05-14,98,2,2427,117,PR
2020-05-15,115,5,2542,122,PR
2020-05-16,47,0,2589,122,PR
2020-05-17,57,1,2646,123,PR
2020-05-18,64,1,2710,124,PR
2020-05-19,95,0,2805,124,PR
2020-05-20,61,1,2866,125,PR
2020-05-21,47,1,2913,126,PR
2020-05-22,117,0,3030,126,PR
2020-05-23,70,1,3100,127,PR
2020-05-24,89,0,3189,127,PR
2020-05-25,71,2,3260,129,PR
2020-05-26,64,0,3324,129,PR
2020-05-27,73,0,3397,129,PR
2020-05-28,89,2,3486,131,PR
2020-05-29,161,1,3647,132,PR
2020-05-30,71,1,3718,133,PR
2020-05-31,58,3,3776,136,PR
2020-06-01,97,0,3873,136,PR
2020-06-02,62,2,3935,138,PR
2020-06-03,88,2,4023,140,PR
2020-06-04,485,0,4508,140,PR
2020-06-05,112,1,4620,141,PR
2020-06-06,295,1,4915,142,PR
2020-06-07,70,0,4985,142,PR
2020-06-08,61,0,5046,142,PR
2020-06-09,139,0,5185,142,PR
2020-06-10,144,1,5329,143,PR
2020-06-11,23,1,5352,144,PR
2020-06-12,184,2,5536,146,PR
2020-06-13,154,0,5690,146,PR
2020-06-14,121,1,5811,147,PR
2020-06-15,79,0,5890,147,PR
2020-06-16,61,0,5951,147,PR
2020-06-17,52,0,6003,147,PR
2020-06-18,108,0,6111,147,PR
2020-06-19,0,0,6111,147,PR
2020-06-20,352,0,6463,147,PR
2020-06-21,62,2,6525,149,PR
2020-06-22,39,0,6564,149,PR
2020-06-23,121,0,6685,149,PR
2020-06-24,135,0,6820,149,PR
2020-06-25,57,2,6877,151,PR
2020-06-26,45,0,6922,151,PR
2020-03-05,7,0,7,0,PS
2020-03-06,9,0,16,0,PS
2020-03-07,3,0,19,0,PS
2020-03-09,1,0,20,0,PS
2020-03-10,9,0,29,0,PS
2020-03-11,1,0,30,0,PS
2020-03-13,5,0,35,0,PS
2020-03-14,3,0,38,0,PS
2020-03-15,0,0,38,0,PS
2020-03-16,1,0,39,0,PS
2020-03-17,2,0,41,0,PS
2020-03-18,3,0,44,0,PS
2020-03-19,3,0,47,0,PS
2020-03-20,1,0,48,0,PS
2020-03-21,4,0,52,0,PS
2020-03-22,7,0,59,0,PS
2020-03-23,0,0,59,0,PS
2020-03-24,1,0,60,0,PS
2020-03-25,2,0,62,0,PS
2020-03-26,22,1,84,1,PS
2020-03-27,7,0,91,1,PS
2020-03-28,6,0,97,1,PS
2020-03-29,9,0,106,1,PS
2020-03-30,9,0,115,1,PS
2020-03-31,2,0,117,1,PS
2020-04-01,17,0,134,1,PS
2020-04-02,21,0,155,1,PS
2020-04-03,0,0,155,1,PS
2020-04-05,62,0,217,1,PS
2020-04-06,36,0,253,1,PS
2020-04-07,7,0,260,1,PS
2020-04-08,3,0,263,1,PS
2020-04-09,0,0,263,1,PS
2020-04-10,3,1,266,2,PS
2020-04-11,2,0,268,2,PS
2020-04-12,0,0,268,2,PS
2020-04-13,0,0,268,2,PS
2020-04-14,19,0,287,2,PS
2020-04-15,4,0,291,2,PS
2020-04-16,3,0,294,2,PS
2020-04-17,13,0,307,2,PS
2020-04-18,6,0,313,2,PS
2020-04-19,9,0,322,2,PS
2020-04-20,7,0,329,2,PS
2020-04-21,0,0,329,2,PS
2020-04-22,6,0,335,2,PS
2020-04-23,1,0,336,2,PS
2020-04-24,4,0,340,2,PS
2020-04-25,2,0,342,2,PS
2020-04-26,153,0,495,2,PS
2020-04-27,0,0,495,2,PS
2020-04-28,0,0,495,2,PS
2020-04-29,12,0,507,2,PS
2020-04-30,0,2,507,4,PS
2020-05-01,10,0,517,4,PS
2020-05-02,0,0,517,4,PS
2020-05-03,5,0,522,4,PS
2020-05-04,2,0,524,4,PS
2020-05-05,14,0,538,4,PS
2020-05-06,8,0,546,4,PS
2020-05-07,1,0,547,4,PS
2020-05-08,0,0,547,4,PS
2020-05-09,0,0,547,4,PS
2020-05-10,0,0,547,4,PS
2020-05-11,0,0,547,4,PS
2020-05-12,0,0,547,4,PS
2020-05-13,1,0,548,4,PS
2020-05-14,0,0,548,4,PS
2020-05-15,6,0,554,4,PS
2020-05-16,0,0,554,4,PS
2020-05-17,6,0,560,4,PS
2020-05-18,7,0,567,4,PS
2020-05-19,3,0,570,4,PS
2020-05-20,7,0,577,4,PS
2020-05-21,25,0,602,4,PS
2020-05-22,0,0,602,4,PS
2020-05-23,0,1,602,5,PS
2020-05-24,0,0,602,5,PS
2020-05-25,0,0,602,5,PS
2020-05-26,3,0,605,5,PS
2020-05-27,8,0,613,5,PS
2020-05-28,12,0,625,5,PS
2020-05-29,0,0,625,5,PS
2020-05-30,1,0,626,5,PS
2020-05-31,1,0,627,5,PS
2020-06-01,1,0,628,5,PS
2020-06-02,2,0,630,5,PS
2020-06-03,5,0,635,5,PS
2020-06-04,8,0,643,5,PS
2020-06-05,0,0,643,5,PS
2020-06-06,0,0,643,5,PS
2020-06-07,8,0,651,5,PS
2020-06-08,1,0,652,5,PS
2020-06-09,9,0,661,5,PS
2020-06-10,4,0,665,5,PS
2020-06-11,2,0,667,5,PS
2020-06-12,2,0,669,5,PS
2020-06-13,4,0,673,5,PS
2020-06-14,0,0,673,5,PS
2020-06-15,13,0,686,5,PS
2020-06-16,4,0,690,5,PS
2020-06-17,11,0,701,5,PS
2020-06-18,94,0,795,5,PS
2020-06-19,63,0,858,5,PS
2020-06-20,121,0,979,5,PS
2020-06-21,43,0,1022,5,PS
2020-06-22,174,0,1196,5,PS
2020-06-23,179,0,1375,5,PS
2020-06-24,159,0,1534,5,PS
2020-06-25,54,0,1588,5,PS
2020-06-26,207,0,1795,5,PS
2020-03-02,2,0,2,0,PT
2020-03-03,2,0,4,0,PT
2020-03-04,1,0,5,0,PT
2020-03-05,4,0,9,0,PT
2020-03-06,4,0,13,0,PT
2020-03-07,8,0,21,0,PT
2020-03-08,9,0,30,0,PT
2020-03-09,9,0,39,0,PT
2020-03-10,2,0,41,0,PT
2020-03-11,18,0,59,0,PT
2020-03-12,19,0,78,0,PT
2020-03-13,34,0,112,0,PT
2020-03-14,57,0,169,0,PT
2020-03-15,76,0,245,0,PT
2020-03-16,86,0,331,0,PT
2020-03-17,117,1,448,1,PT
2020-03-18,194,1,642,2,PT
2020-03-19,143,1,785,3,PT
2020-03-20,235,3,1020,6,PT
2020-03-21,260,6,1280,12,PT
2020-03-22,320,2,1600,14,PT
2020-03-23,460,9,2060,23,PT
2020-03-24,302,10,2362,33,PT
2020-03-25,633,10,2995,43,PT
2020-03-26,549,17,3544,60,PT
2020-03-27,724,16,4268,76,PT
2020-03-28,902,24,5170,100,PT
2020-03-29,792,19,5962,119,PT
2020-03-30,446,21,6408,140,PT
2020-03-31,1035,20,7443,160,PT
2020-04-01,808,27,8251,187,PT
2020-04-02,783,22,9034,209,PT
2020-04-03,852,37,9886,246,PT
2020-04-04,638,20,10524,266,PT
2020-04-05,754,29,11278,295,PT
2020-04-06,452,16,11730,311,PT
2020-04-07,712,34,12442,345,PT
2020-04-08,699,35,13141,380,PT
2020-04-09,815,29,13956,409,PT
2020-04-10,1516,26,15472,435,PT
2020-04-11,515,35,15987,470,PT
2020-04-12,598,34,16585,504,PT
2020-04-13,349,31,16934,535,PT
2020-04-14,514,32,17448,567,PT
2020-04-15,643,32,18091,599,PT
2020-04-16,750,30,18841,629,PT
2020-04-17,181,28,19022,657,PT
2020-04-18,663,30,19685,687,PT
2020-04-19,521,27,20206,714,PT
2020-04-20,657,21,20863,735,PT
2020-04-21,516,27,21379,762,PT
2020-04-22,603,23,21982,785,PT
2020-04-23,371,35,22353,820,PT
2020-04-24,918,60,23271,880,PT
2020-04-25,412,23,23683,903,PT
2020-04-26,163,25,23846,928,PT
2020-04-27,298,20,24144,948,PT
2020-04-28,180,25,24324,973,PT
2020-04-29,368,16,24692,989,PT
2020-04-30,295,18,24987,1007,PT
2020-05-01,364,0,25351,1007,PT
2020-05-02,-161,16,25190,1023,PT
2020-05-03,334,40,25524,1063,PT
2020-05-04,0,0,25524,1063,PT
2020-05-05,178,11,25702,1074,PT
2020-05-06,480,15,26182,1089,PT
2020-05-07,533,16,26715,1105,PT
2020-05-08,553,9,27268,1114,PT
2020-05-09,138,12,27406,1126,PT
2020-05-10,175,9,27581,1135,PT
2020-05-11,98,9,27679,1144,PT
2020-05-12,234,19,27913,1163,PT
2020-05-13,219,12,28132,1175,PT
2020-05-14,187,9,28319,1184,PT
2020-05-15,264,6,28583,1190,PT
2020-05-16,227,13,28810,1203,PT
2020-05-17,226,15,29036,1218,PT
2020-05-18,173,13,29209,1231,PT
2020-05-19,223,16,29432,1247,PT
2020-05-20,228,16,29660,1263,PT
2020-05-21,252,14,29912,1277,PT
2020-05-22,288,12,30200,1289,PT
2020-05-23,271,13,30471,1302,PT
2020-05-24,152,14,30623,1316,PT
2020-05-25,165,14,30788,1330,PT
2020-05-26,219,12,31007,1342,PT
2020-05-27,285,14,31292,1356,PT
2020-05-28,304,13,31596,1369,PT
2020-05-29,350,14,31946,1383,PT
2020-05-30,257,13,32203,1396,PT
2020-05-31,297,14,32500,1410,PT
2020-06-01,200,14,32700,1424,PT
2020-06-02,195,12,32895,1436,PT
2020-06-03,366,11,33261,1447,PT
2020-06-04,331,8,33592,1455,PT
2020-06-05,377,10,33969,1465,PT
2020-06-06,382,9,34351,1474,PT
2020-06-07,142,5,34493,1479,PT
2020-06-08,392,6,34885,1485,PT
2020-06-09,421,7,35306,1492,PT
2020-06-10,294,3,35600,1495,PT
2020-06-11,310,9,35910,1504,PT
2020-06-12,270,1,36180,1505,PT
2020-06-13,283,7,36463,1512,PT
2020-06-14,227,5,36690,1517,PT
2020-06-15,346,3,37036,1520,PT
2020-06-16,300,2,37336,1522,PT
2020-06-17,336,1,37672,1523,PT
2020-06-18,417,1,38089,1524,PT
2020-06-19,375,3,38464,1527,PT
2020-06-20,377,1,38841,1528,PT
2020-06-21,292,2,39133,1530,PT
2020-06-22,259,4,39392,1534,PT
2020-06-23,345,6,39737,1540,PT
2020-06-24,367,3,40104,1543,PT
2020-06-25,311,6,40415,1549,PT
2020-06-26,451,6,40866,1555,PT
2020-03-07,1,0,1,0,PY
2020-03-10,4,0,5,0,PY
2020-03-12,1,0,6,0,PY
2020-03-13,1,0,7,0,PY
2020-03-15,1,0,8,0,PY
2020-03-16,1,0,9,0,PY
2020-03-17,2,0,11,0,PY
2020-03-18,0,0,11,0,PY
2020-03-19,2,0,13,0,PY
2020-03-20,5,1,18,1,PY
2020-03-21,4,0,22,1,PY
2020-03-22,0,0,22,1,PY
2020-03-23,5,0,27,1,PY
2020-03-24,10,2,37,3,PY
2020-03-25,4,0,41,3,PY
2020-03-26,11,0,52,3,PY
2020-03-27,4,0,56,3,PY
2020-03-28,3,0,59,3,PY
2020-03-29,5,0,64,3,PY
2020-03-30,1,0,65,3,PY
2020-03-31,4,0,69,3,PY
2020-04-01,0,0,69,3,PY
2020-04-02,8,0,77,3,PY
2020-04-03,19,0,96,3,PY
2020-04-04,8,0,104,3,PY
2020-04-05,9,2,113,5,PY
2020-04-06,0,0,113,5,PY
2020-04-07,2,0,115,5,PY
2020-04-08,9,0,124,5,PY
2020-04-09,5,1,129,6,PY
2020-04-10,4,0,133,6,PY
2020-04-11,1,0,134,6,PY
2020-04-12,13,0,147,6,PY
2020-04-13,12,1,159,7,PY
2020-04-14,2,1,161,8,PY
2020-04-15,13,0,174,8,PY
2020-04-16,0,0,174,8,PY
2020-04-17,28,0,202,8,PY
2020-04-18,0,0,202,8,PY
2020-04-19,4,0,206,8,PY
2020-04-20,2,0,208,8,PY
2020-04-21,5,1,213,9,PY
2020-04-22,0,0,213,9,PY
2020-04-23,7,0,220,9,PY
2020-04-24,3,0,223,9,PY
2020-04-25,5,0,228,9,PY
2020-04-26,0,0,228,9,PY
2020-04-27,2,0,230,9,PY
2020-04-28,9,0,239,9,PY
2020-04-29,10,0,249,9,PY
2020-04-30,17,1,266,10,PY
2020-05-01,67,0,333,10,PY
2020-05-02,37,0,370,10,PY
2020-05-03,26,0,396,10,PY
2020-05-04,19,0,415,10,PY
2020-05-05,16,0,431,10,PY
2020-05-06,9,0,440,10,PY
2020-05-07,22,0,462,10,PY
2020-05-08,101,0,563,10,PY
2020-05-09,126,0,689,10,PY
2020-05-10,24,0,713,10,PY
2020-05-11,11,0,724,10,PY
2020-05-12,13,0,737,10,PY
2020-05-13,3,1,740,11,PY
2020-05-14,14,0,754,11,PY
2020-05-15,5,0,759,11,PY
2020-05-16,19,0,778,11,PY
2020-05-17,8,0,786,11,PY
2020-05-18,2,0,788,11,PY
2020-05-19,41,0,829,11,PY
2020-05-20,4,0,833,11,PY
2020-05-21,3,0,836,11,PY
2020-05-22,2,0,838,11,PY
2020-05-23,12,0,850,11,PY
2020-05-24,12,0,862,11,PY
2020-05-25,3,0,865,11,PY
2020-05-26,12,0,877,11,PY
2020-05-27,7,0,884,11,PY
2020-05-28,16,0,900,11,PY
2020-05-29,17,0,917,11,PY
2020-05-30,47,0,964,11,PY
2020-05-31,22,0,986,11,PY
2020-06-01,9,0,995,11,PY
2020-06-02,18,0,1013,11,PY
2020-06-03,57,0,1070,11,PY
2020-06-04,16,0,1086,11,PY
2020-06-05,1,0,1087,11,PY
2020-06-06,3,0,1090,11,PY
2020-06-07,45,0,1135,11,PY
2020-06-08,10,0,1145,11,PY
2020-06-09,42,0,1187,11,PY
2020-06-10,15,0,1202,11,PY
2020-06-11,28,0,1230,11,PY
2020-06-12,24,0,1254,11,PY
2020-06-13,7,0,1261,11,PY
2020-06-14,28,0,1289,11,PY
2020-06-15,0,1,1289,12,PY
2020-06-16,14,1,1303,13,PY
2020-06-17,5,0,1308,13,PY
2020-06-18,22,0,1330,13,PY
2020-06-19,6,0,1336,13,PY
2020-06-20,26,0,1362,13,PY
2020-06-21,17,0,1379,13,PY
2020-06-22,13,0,1392,13,PY
2020-06-23,30,0,1422,13,PY
2020-06-24,106,0,1528,13,PY
2020-06-25,41,0,1569,13,PY
2020-06-26,142,0,1711,13,PY
2019-12-30,0,0,0,0,QA
2019-12-31,0,0,0,0,QA
2020-01-01,0,0,0,0,QA
2020-01-02,0,0,0,0,QA
2020-01-03,0,0,0,0,QA
2020-01-04,0,0,0,0,QA
2020-01-05,0,0,0,0,QA
2020-01-06,0,0,0,0,QA
2020-01-07,0,0,0,0,QA
2020-01-08,0,0,0,0,QA
2020-01-09,0,0,0,0,QA
2020-01-10,0,0,0,0,QA
2020-01-11,0,0,0,0,QA
2020-01-12,0,0,0,0,QA
2020-01-13,0,0,0,0,QA
2020-01-14,0,0,0,0,QA
2020-01-15,0,0,0,0,QA
2020-01-16,0,0,0,0,QA
2020-01-17,0,0,0,0,QA
2020-01-18,0,0,0,0,QA
2020-01-19,0,0,0,0,QA
2020-01-20,0,0,0,0,QA
2020-01-21,0,0,0,0,QA
2020-01-22,0,0,0,0,QA
2020-01-23,0,0,0,0,QA
2020-01-24,0,0,0,0,QA
2020-01-25,0,0,0,0,QA
2020-01-26,0,0,0,0,QA
2020-01-27,0,0,0,0,QA
2020-01-28,0,0,0,0,QA
2020-01-29,0,0,0,0,QA
2020-01-30,0,0,0,0,QA
2020-01-31,0,0,0,0,QA
2020-02-01,0,0,0,0,QA
2020-02-02,0,0,0,0,QA
2020-02-03,0,0,0,0,QA
2020-02-04,0,0,0,0,QA
2020-02-05,0,0,0,0,QA
2020-02-06,0,0,0,0,QA
2020-02-07,0,0,0,0,QA
2020-02-08,0,0,0,0,QA
2020-02-09,0,0,0,0,QA
2020-02-10,0,0,0,0,QA
2020-02-11,0,0,0,0,QA
2020-02-12,0,0,0,0,QA
2020-02-13,0,0,0,0,QA
2020-02-14,0,0,0,0,QA
2020-02-15,0,0,0,0,QA
2020-02-16,0,0,0,0,QA
2020-02-17,0,0,0,0,QA
2020-02-18,0,0,0,0,QA
2020-02-19,0,0,0,0,QA
2020-02-20,0,0,0,0,QA
2020-02-21,0,0,0,0,QA
2020-02-22,0,0,0,0,QA
2020-02-23,0,0,0,0,QA
2020-02-24,0,0,0,0,QA
2020-02-25,0,0,0,0,QA
2020-02-26,0,0,0,0,QA
2020-02-27,0,0,0,0,QA
2020-02-28,0,0,0,0,QA
2020-02-29,1,0,1,0,QA
2020-03-01,2,0,3,0,QA
2020-03-03,5,0,8,0,QA
2020-03-06,3,0,11,0,QA
2020-03-07,1,0,12,0,QA
2020-03-08,3,0,15,0,QA
2020-03-09,3,0,18,0,QA
2020-03-10,6,0,24,0,QA
2020-03-11,238,0,262,0,QA
2020-03-13,58,0,320,0,QA
2020-03-14,17,0,337,0,QA
2020-03-15,64,0,401,0,QA
2020-03-16,38,0,439,0,QA
2020-03-17,3,0,442,0,QA
2020-03-18,10,0,452,0,QA
2020-03-19,8,0,460,0,QA
2020-03-20,10,0,470,0,QA
2020-03-21,11,0,481,0,QA
2020-03-22,13,0,494,0,QA
2020-03-23,7,0,501,0,QA
2020-03-24,25,0,526,0,QA
2020-03-25,11,0,537,0,QA
2020-03-26,12,0,549,0,QA
2020-03-27,13,0,562,0,QA
2020-03-28,28,1,590,1,QA
2020-03-29,44,0,634,1,QA
2020-03-30,59,0,693,1,QA
2020-03-31,88,1,781,2,QA
2020-04-01,54,0,835,2,QA
2020-04-02,114,1,949,3,QA
2020-04-03,0,0,949,3,QA
2020-04-04,376,0,1325,3,QA
2020-04-05,279,1,1604,4,QA
2020-04-06,228,0,1832,4,QA
2020-04-07,225,2,2057,6,QA
2020-04-08,153,0,2210,6,QA
2020-04-09,166,0,2376,6,QA
2020-04-10,136,0,2512,6,QA
2020-04-11,216,0,2728,6,QA
2020-04-12,251,1,2979,7,QA
2020-04-13,252,0,3231,7,QA
2020-04-14,197,0,3428,7,QA
2020-04-15,283,0,3711,7,QA
2020-04-16,392,0,4103,7,QA
2020-04-17,560,0,4663,7,QA
2020-04-18,345,1,5008,8,QA
2020-04-19,440,0,5448,8,QA
2020-04-20,567,1,6015,9,QA
2020-04-21,518,0,6533,9,QA
2020-04-22,608,1,7141,10,QA
2020-04-23,623,0,7764,10,QA
2020-04-24,761,0,8525,10,QA
2020-04-25,833,0,9358,10,QA
2020-04-26,929,0,10287,10,QA
2020-04-27,957,0,11244,10,QA
2020-04-28,677,0,11921,10,QA
2020-04-29,643,0,12564,10,QA
2020-04-30,845,0,13409,10,QA
2020-05-01,687,2,14096,12,QA
2020-05-02,776,0,14872,12,QA
2020-05-03,679,0,15551,12,QA
2020-05-04,640,0,16191,12,QA
2020-05-05,951,0,17142,12,QA
2020-05-06,830,0,17972,12,QA
2020-05-07,918,0,18890,12,QA
2020-05-08,1311,0,20201,12,QA
2020-05-09,1130,1,21331,13,QA
2020-05-10,1189,1,22520,14,QA
2020-05-11,1103,0,23623,14,QA
2020-05-12,1526,0,25149,14,QA
2020-05-13,1390,0,26539,14,QA
2020-05-14,1733,0,28272,14,QA
2020-05-15,1153,0,29425,14,QA
2020-05-16,1547,1,30972,15,QA
2020-05-17,1632,0,32604,15,QA
2020-05-18,1365,0,33969,15,QA
2020-05-19,1637,0,35606,15,QA
2020-05-20,1491,1,37097,16,QA
2020-05-21,1554,1,38651,17,QA
2020-05-22,1830,2,40481,19,QA
2020-05-23,1732,2,42213,21,QA
2020-05-24,1501,2,43714,23,QA
2020-05-25,1751,3,45465,26,QA
2020-05-26,1742,2,47207,28,QA
2020-05-27,1740,2,48947,30,QA
2020-05-28,1967,3,50914,33,QA
2020-05-29,1993,3,52907,36,QA
2020-05-30,2355,0,55262,36,QA
2020-05-31,1648,2,56910,38,QA
2020-06-01,1523,2,58433,40,QA
2020-06-02,1826,3,60259,43,QA
2020-06-03,1901,2,62160,45,QA
2020-06-04,1581,0,63741,45,QA
2020-06-05,1754,4,65495,49,QA
2020-06-06,1700,2,67195,51,QA
2020-06-07,1595,3,68790,54,QA
2020-06-08,1368,3,70158,57,QA
2020-06-09,1721,5,71879,62,QA
2020-06-10,1716,4,73595,66,QA
2020-06-11,1476,3,75071,69,QA
2020-06-12,1517,1,76588,70,QA
2020-06-13,1828,0,78416,70,QA
2020-06-14,1186,3,79602,73,QA
2020-06-15,1274,3,80876,76,QA
2020-06-16,1201,4,82077,80,QA
2020-06-17,1097,2,83174,82,QA
2020-06-18,1267,4,84441,86,QA
2020-06-19,1021,7,85462,93,QA
2020-06-20,1026,1,86488,94,QA
2020-06-21,881,4,87369,98,QA
2020-06-22,1034,1,88403,99,QA
2020-06-23,1176,0,89579,99,QA
2020-06-24,1199,5,90778,104,QA
2020-06-25,1060,2,91838,106,QA
2020-06-26,946,3,92784,109,QA
2019-12-30,0,0,0,0,RO
2019-12-31,0,0,0,0,RO
2020-01-01,0,0,0,0,RO
2020-01-02,0,0,0,0,RO
2020-01-03,0,0,0,0,RO
2020-01-04,0,0,0,0,RO
2020-01-05,0,0,0,0,RO
2020-01-06,0,0,0,0,RO
2020-01-07,0,0,0,0,RO
2020-01-08,0,0,0,0,RO
2020-01-09,0,0,0,0,RO
2020-01-10,0,0,0,0,RO
2020-01-11,0,0,0,0,RO
2020-01-12,0,0,0,0,RO
2020-01-13,0,0,0,0,RO
2020-01-14,0,0,0,0,RO
2020-01-15,0,0,0,0,RO
2020-01-16,0,0,0,0,RO
2020-01-17,0,0,0,0,RO
2020-01-18,0,0,0,0,RO
2020-01-19,0,0,0,0,RO
2020-01-20,0,0,0,0,RO
2020-01-21,0,0,0,0,RO
2020-01-22,0,0,0,0,RO
2020-01-23,0,0,0,0,RO
2020-01-24,0,0,0,0,RO
2020-01-25,0,0,0,0,RO
2020-01-26,0,0,0,0,RO
2020-01-27,0,0,0,0,RO
2020-01-28,0,0,0,0,RO
2020-01-29,0,0,0,0,RO
2020-01-30,0,0,0,0,RO
2020-01-31,0,0,0,0,RO
2020-02-01,0,0,0,0,RO
2020-02-02,0,0,0,0,RO
2020-02-03,0,0,0,0,RO
2020-02-04,0,0,0,0,RO
2020-02-05,0,0,0,0,RO
2020-02-06,0,0,0,0,RO
2020-02-07,0,0,0,0,RO
2020-02-08,0,0,0,0,RO
2020-02-09,0,0,0,0,RO
2020-02-10,0,0,0,0,RO
2020-02-11,0,0,0,0,RO
2020-02-12,0,0,0,0,RO
2020-02-13,0,0,0,0,RO
2020-02-14,0,0,0,0,RO
2020-02-15,0,0,0,0,RO
2020-02-16,0,0,0,0,RO
2020-02-17,0,0,0,0,RO
2020-02-18,0,0,0,0,RO
2020-02-19,0,0,0,0,RO
2020-02-20,0,0,0,0,RO
2020-02-21,0,0,0,0,RO
2020-02-22,0,0,0,0,RO
2020-02-23,0,0,0,0,RO
2020-02-24,0,0,0,0,RO
2020-02-25,0,0,0,0,RO
2020-02-26,1,0,1,0,RO
2020-02-27,0,0,1,0,RO
2020-02-28,2,0,3,0,RO
2020-02-29,0,0,3,0,RO
2020-03-01,0,0,3,0,RO
2020-03-03,1,0,4,0,RO
2020-03-05,2,0,6,0,RO
2020-03-06,1,0,7,0,RO
2020-03-07,6,0,13,0,RO
2020-03-08,2,0,15,0,RO
2020-03-09,2,0,17,0,RO
2020-03-10,8,0,25,0,RO
2020-03-11,20,0,45,0,RO
2020-03-12,19,0,64,0,RO
2020-03-13,25,0,89,0,RO
2020-03-14,24,0,113,0,RO
2020-03-15,26,0,139,0,RO
2020-03-16,45,0,184,0,RO
2020-03-17,33,0,217,0,RO
2020-03-18,43,0,260,0,RO
2020-03-19,17,0,277,0,RO
2020-03-20,31,0,308,0,RO
2020-03-21,59,0,367,0,RO
2020-03-22,66,2,433,2,RO
2020-03-23,143,5,576,7,RO
2020-03-24,186,4,762,11,RO
2020-03-25,144,2,906,13,RO
2020-03-26,123,4,1029,17,RO
2020-03-27,263,7,1292,24,RO
2020-03-28,160,5,1452,29,RO
2020-03-29,308,11,1760,40,RO
2020-03-30,192,4,1952,44,RO
2020-03-31,293,25,2245,69,RO
2020-04-01,215,16,2460,85,RO
2020-04-02,278,9,2738,94,RO
2020-04-03,445,39,3183,133,RO
2020-04-04,430,8,3613,141,RO
2020-04-05,251,7,3864,148,RO
2020-04-06,193,9,4057,157,RO
2020-04-07,360,25,4417,182,RO
2020-04-08,344,27,4761,209,RO
2020-04-09,441,20,5202,229,RO
2020-04-10,265,28,5467,257,RO
2020-04-11,523,25,5990,282,RO
2020-04-12,310,24,6300,306,RO
2020-04-13,333,12,6633,318,RO
2020-04-14,246,26,6879,344,RO
2020-04-15,337,28,7216,372,RO
2020-04-16,491,15,7707,387,RO
2020-04-17,360,13,8067,400,RO
2020-04-18,351,17,8418,417,RO
2020-04-19,328,17,8746,434,RO
2020-04-20,190,17,8936,451,RO
2020-04-21,306,32,9242,483,RO
2020-04-22,468,25,9710,508,RO
2020-04-23,386,19,10096,527,RO
2020-04-24,321,25,10417,552,RO
2020-04-25,218,23,10635,575,RO
2020-04-26,401,33,11036,608,RO
2020-04-27,303,23,11339,631,RO
2020-04-28,277,19,11616,650,RO
2020-04-29,362,25,11978,675,RO
2020-04-30,262,42,12240,717,RO
2020-05-01,327,27,12567,744,RO
2020-05-02,165,27,12732,771,RO
2020-05-03,431,9,13163,780,RO
2020-05-04,349,23,13512,803,RO
2020-05-05,325,24,13837,827,RO
2020-05-06,270,31,14107,858,RO
2020-05-07,392,18,14499,876,RO
2020-05-08,312,22,14811,898,RO
2020-05-09,320,28,15131,926,RO
2020-05-10,231,26,15362,952,RO
2020-05-11,226,20,15588,972,RO
2020-05-12,190,30,15778,1002,RO
2020-05-13,224,14,16002,1016,RO
2020-05-14,245,30,16247,1046,RO
2020-05-15,190,10,16437,1056,RO
2020-05-16,267,25,16704,1081,RO
2020-05-17,167,16,16871,1097,RO
2020-05-18,165,10,17036,1107,RO
2020-05-19,155,19,17191,1126,RO
2020-05-20,196,15,17387,1141,RO
2020-05-21,198,10,17585,1151,RO
2020-05-22,127,8,17712,1159,RO
2020-05-23,145,11,17857,1170,RO
2020-05-24,213,9,18070,1179,RO
2020-05-25,213,18,18283,1197,RO
2020-05-26,146,13,18429,1210,RO
2020-05-27,165,9,18594,1219,RO
2020-05-28,197,10,18791,1229,RO
2020-05-29,191,11,18982,1240,RO
2020-05-30,151,13,19133,1253,RO
2020-05-31,124,9,19257,1262,RO
2020-06-01,141,17,19398,1279,RO
2020-06-02,119,0,19517,1279,RO
2020-06-03,152,9,19669,1288,RO
2020-06-04,238,11,19907,1299,RO
2020-06-05,196,9,20103,1308,RO
2020-06-06,187,10,20290,1318,RO
2020-06-07,189,8,20479,1326,RO
2020-06-08,125,8,20604,1334,RO
2020-06-09,145,11,20749,1345,RO
2020-06-10,196,15,20945,1360,RO
2020-06-11,237,9,21182,1369,RO
2020-06-12,222,11,21404,1380,RO
2020-06-13,275,11,21679,1391,RO
2020-06-14,320,19,21999,1410,RO
2020-06-15,166,17,22165,1427,RO
2020-06-16,250,10,22415,1437,RO
2020-06-17,345,14,22760,1451,RO
2020-06-18,320,22,23080,1473,RO
2020-06-19,320,11,23400,1484,RO
2020-06-20,330,16,23730,1500,RO
2020-06-21,315,12,24045,1512,RO
2020-06-22,246,11,24291,1523,RO
2020-06-23,214,16,24505,1539,RO
2020-06-24,321,16,24826,1555,RO
2020-06-25,460,10,25286,1565,RO
2020-06-26,411,14,25697,1579,RO
2020-03-06,1,0,1,0,RS
2020-03-10,4,0,5,0,RS
2020-03-11,13,0,18,0,RS
2020-03-12,6,0,24,0,RS
2020-03-13,17,0,41,0,RS
2020-03-14,5,0,46,0,RS
2020-03-15,9,0,55,0,RS
2020-03-16,2,0,57,0,RS
2020-03-17,15,0,72,0,RS
2020-03-18,22,0,94,0,RS
2020-03-19,32,0,126,0,RS
2020-03-20,9,1,135,1,RS
2020-03-21,14,0,149,1,RS
2020-03-22,39,0,188,1,RS
2020-03-23,34,0,222,1,RS
2020-03-24,27,0,249,1,RS
2020-03-25,54,1,303,2,RS
2020-03-26,81,1,384,3,RS
2020-03-27,73,3,457,6,RS
2020-03-28,202,4,659,10,RS
2020-03-29,82,3,741,13,RS
2020-03-30,0,0,741,13,RS
2020-03-31,159,10,900,23,RS
2020-04-01,160,0,1060,23,RS
2020-04-02,111,8,1171,31,RS
2020-04-03,305,8,1476,39,RS
2020-04-04,148,5,1624,44,RS
2020-04-05,284,7,1908,51,RS
2020-04-06,292,7,2200,58,RS
2020-04-07,247,3,2447,61,RS
2020-04-08,219,4,2666,65,RS
2020-04-09,201,1,2867,66,RS
2020-04-10,238,5,3105,71,RS
2020-04-11,275,3,3380,74,RS
2020-04-12,250,6,3630,80,RS
2020-04-13,424,5,4054,85,RS
2020-04-14,411,9,4465,94,RS
2020-04-15,408,5,4873,99,RS
2020-04-16,445,4,5318,103,RS
2020-04-17,372,7,5690,110,RS
2020-04-18,304,7,5994,117,RS
2020-04-19,324,5,6318,122,RS
2020-04-20,312,3,6630,125,RS
2020-04-21,260,0,6890,125,RS
2020-04-22,224,9,7114,134,RS
2020-04-23,162,5,7276,139,RS
2020-04-24,207,5,7483,144,RS
2020-04-25,296,7,7779,151,RS
2020-04-26,263,5,8042,156,RS
2020-04-27,233,6,8275,162,RS
2020-04-28,222,6,8497,168,RS
2020-04-29,227,5,8724,173,RS
2020-04-30,285,6,9009,179,RS
2020-05-01,196,6,9205,185,RS
2020-05-02,157,4,9362,189,RS
2020-05-03,102,4,9464,193,RS
2020-05-04,93,4,9557,197,RS
2020-05-05,120,3,9677,200,RS
2020-05-06,114,3,9791,203,RS
2020-05-07,57,3,9848,206,RS
2020-05-08,95,3,9943,209,RS
2020-05-09,89,4,10032,213,RS
2020-05-10,82,2,10114,215,RS
2020-05-11,62,3,10176,218,RS
2020-05-12,67,2,10243,220,RS
2020-05-13,52,2,10295,222,RS
2020-05-14,79,2,10374,224,RS
2020-05-15,64,1,10438,225,RS
2020-05-16,58,3,10496,228,RS
2020-05-17,114,2,10610,230,RS
2020-05-18,89,1,10699,231,RS
2020-05-19,34,3,10733,234,RS
2020-05-20,100,1,10833,235,RS
2020-05-21,86,2,10919,237,RS
2020-05-22,105,0,11024,237,RS
2020-05-23,68,1,11092,238,RS
2020-05-24,67,0,11159,238,RS
2020-05-25,34,1,11193,239,RS
2020-05-26,34,0,11227,239,RS
2020-05-27,48,1,11275,240,RS
2020-05-28,25,1,11300,241,RS
2020-05-29,54,1,11354,242,RS
2020-05-30,27,0,11381,242,RS
2020-05-31,31,1,11412,243,RS
2020-06-01,18,1,11430,244,RS
2020-06-02,24,1,11454,245,RS
2020-06-03,69,0,11523,245,RS
2020-06-04,48,1,11571,246,RS
2020-06-05,96,1,11667,247,RS
2020-06-06,74,1,11741,248,RS
2020-06-07,82,1,11823,249,RS
2020-06-08,73,1,11896,250,RS
2020-06-09,69,0,11965,250,RS
2020-06-10,66,1,12031,251,RS
2020-06-11,71,1,12102,252,RS
2020-06-12,73,0,12175,252,RS
2020-06-13,76,1,12251,253,RS
2020-06-14,59,1,12310,254,RS
2020-06-15,57,1,12367,255,RS
2020-06-16,59,1,12426,256,RS
2020-06-17,96,1,12522,257,RS
2020-06-18,94,1,12616,258,RS
2020-06-19,93,1,12709,259,RS
2020-06-20,94,1,12803,260,RS
2020-06-21,91,1,12894,261,RS
2020-06-22,96,1,12990,262,RS
2020-06-23,102,1,13092,263,RS
2020-06-24,143,0,13235,263,RS
2020-06-25,137,1,13372,264,RS
2020-06-26,193,1,13565,265,RS
2019-12-31,0,0,0,0,RU
2020-01-01,0,0,0,0,RU
2020-01-02,0,0,0,0,RU
2020-01-03,0,0,0,0,RU
2020-01-04,0,0,0,0,RU
2020-01-05,0,0,0,0,RU
2020-01-06,0,0,0,0,RU
2020-01-07,0,0,0,0,RU
2020-01-08,0,0,0,0,RU
2020-01-09,0,0,0,0,RU
2020-01-10,0,0,0,0,RU
2020-01-11,0,0,0,0,RU
2020-01-12,0,0,0,0,RU
2020-01-13,0,0,0,0,RU
2020-01-14,0,0,0,0,RU
2020-01-15,0,0,0,0,RU
2020-01-16,0,0,0,0,RU
2020-01-17,0,0,0,0,RU
2020-01-18,0,0,0,0,RU
2020-01-19,0,0,0,0,RU
2020-01-20,0,0,0,0,RU
2020-01-21,0,0,0,0,RU
2020-01-22,0,0,0,0,RU
2020-01-23,0,0,0,0,RU
2020-01-24,0,0,0,0,RU
2020-01-25,0,0,0,0,RU
2020-01-26,0,0,0,0,RU
2020-01-27,0,0,0,0,RU
2020-01-28,0,0,0,0,RU
2020-01-29,0,0,0,0,RU
2020-01-30,0,0,0,0,RU
2020-01-31,0,0,0,0,RU
2020-02-01,2,0,2,0,RU
2020-02-02,0,0,2,0,RU
2020-02-03,0,0,2,0,RU
2020-02-04,0,0,2,0,RU
2020-02-05,0,0,2,0,RU
2020-02-06,0,0,2,0,RU
2020-02-07,0,0,2,0,RU
2020-02-08,0,0,2,0,RU
2020-02-09,0,0,2,0,RU
2020-02-10,0,0,2,0,RU
2020-02-11,0,0,2,0,RU
2020-02-12,0,0,2,0,RU
2020-02-13,0,0,2,0,RU
2020-02-14,0,0,2,0,RU
2020-02-15,0,0,2,0,RU
2020-02-16,0,0,2,0,RU
2020-02-17,0,0,2,0,RU
2020-02-18,0,0,2,0,RU
2020-02-19,0,0,2,0,RU
2020-02-20,0,0,2,0,RU
2020-02-21,0,0,2,0,RU
2020-02-22,0,0,2,0,RU
2020-02-23,0,0,2,0,RU
2020-02-24,0,0,2,0,RU
2020-02-25,0,0,2,0,RU
2020-02-26,0,0,2,0,RU
2020-02-27,0,0,2,0,RU
2020-02-28,0,0,2,0,RU
2020-02-29,0,0,2,0,RU
2020-03-01,0,0,2,0,RU
2020-03-02,0,0,2,0,RU
2020-03-03,1,0,3,0,RU
2020-03-04,1,0,4,0,RU
2020-03-05,0,0,4,0,RU
2020-03-06,0,0,4,0,RU
2020-03-07,6,0,10,0,RU
2020-03-08,0,0,10,0,RU
2020-03-09,0,0,10,0,RU
2020-03-10,0,0,10,0,RU
2020-03-11,0,0,10,0,RU
2020-03-12,15,0,25,0,RU
2020-03-13,5,0,30,0,RU
2020-03-14,15,0,45,0,RU
2020-03-15,14,0,59,0,RU
2020-03-16,4,0,63,0,RU
2020-03-17,30,0,93,0,RU
2020-03-18,21,0,114,0,RU
2020-03-19,33,0,147,0,RU
2020-03-20,52,0,199,0,RU
2020-03-21,54,0,253,0,RU
2020-03-22,53,0,306,0,RU
2020-03-23,132,0,438,0,RU
2020-03-24,0,0,438,0,RU
2020-03-25,57,0,495,0,RU
2020-03-26,163,0,658,0,RU
2020-03-27,182,2,840,2,RU
2020-03-28,196,2,1036,4,RU
2020-03-29,228,1,1264,5,RU
2020-03-30,270,3,1534,8,RU
2020-03-31,302,2,1836,10,RU
2020-04-01,501,7,2337,17,RU
2020-04-02,440,7,2777,24,RU
2020-04-03,771,6,3548,30,RU
2020-04-04,601,4,4149,34,RU
2020-04-05,582,9,4731,43,RU
2020-04-06,658,2,5389,45,RU
2020-04-07,954,2,6343,47,RU
2020-04-08,1154,11,7497,58,RU
2020-04-09,1175,5,8672,63,RU
2020-04-10,1459,13,10131,76,RU
2020-04-11,1786,18,11917,94,RU
2020-04-12,1667,12,13584,106,RU
2020-04-13,2186,24,15770,130,RU
2020-04-14,2558,18,18328,148,RU
2020-04-15,2774,22,21102,170,RU
2020-04-16,3388,28,24490,198,RU
2020-04-17,3448,34,27938,232,RU
2020-04-18,4070,41,32008,273,RU
2020-04-19,4785,40,36793,313,RU
2020-04-20,6060,48,42853,361,RU
2020-04-21,4268,44,47121,405,RU
2020-04-22,5642,51,52763,456,RU
2020-04-23,5236,57,57999,513,RU
2020-04-24,4774,42,62773,555,RU
2020-04-25,5849,60,68622,615,RU
2020-04-26,5966,66,74588,681,RU
2020-04-27,6361,66,80949,747,RU
2020-04-28,6198,48,87147,795,RU
2020-04-29,6411,72,93558,867,RU
2020-04-30,5841,105,99399,972,RU
2020-05-01,7099,101,106498,1073,RU
2020-05-02,7933,96,114431,1169,RU
2020-05-03,9623,53,124054,1222,RU
2020-05-04,10633,58,134687,1280,RU
2020-05-05,10581,76,145268,1356,RU
2020-05-06,10102,95,155370,1451,RU
2020-05-07,10559,86,165929,1537,RU
2020-05-08,11231,88,177160,1625,RU
2020-05-09,10699,98,187859,1723,RU
2020-05-10,10817,104,198676,1827,RU
2020-05-11,11012,88,209688,1915,RU
2020-05-12,11656,94,221344,2009,RU
2020-05-13,10899,107,232243,2116,RU
2020-05-14,10028,96,242271,2212,RU
2020-05-15,9974,93,252245,2305,RU
2020-05-16,10598,113,262843,2418,RU
2020-05-17,9200,119,272043,2537,RU
2020-05-18,9709,94,281752,2631,RU
2020-05-19,8926,91,290678,2722,RU
2020-05-20,9263,115,299941,2837,RU
2020-05-21,8764,135,308705,2972,RU
2020-05-22,8849,127,317554,3099,RU
2020-05-23,8894,150,326448,3249,RU
2020-05-24,9434,139,335882,3388,RU
2020-05-25,8599,153,344481,3541,RU
2020-05-26,8946,92,353427,3633,RU
2020-05-27,8915,174,362342,3807,RU
2020-05-28,8338,161,370680,3968,RU
2020-05-29,8371,174,379051,4142,RU
2020-05-30,8572,232,387623,4374,RU
2020-05-31,8952,181,396575,4555,RU
2020-06-01,9268,138,405843,4693,RU
2020-06-02,9035,162,414878,4855,RU
2020-06-03,8863,182,423741,5037,RU
2020-06-04,8536,178,432277,5215,RU
2020-06-05,8831,169,441108,5384,RU
2020-06-06,8726,144,449834,5528,RU
2020-06-07,8855,197,458689,5725,RU
2020-06-08,8984,134,467673,5859,RU
2020-06-09,8985,112,476658,5971,RU
2020-06-10,8595,170,485253,6141,RU
2020-06-11,8404,217,493657,6358,RU
2020-06-12,8779,174,502436,6532,RU
2020-06-13,8987,183,511423,6715,RU
2020-06-14,8706,114,520129,6829,RU
2020-06-15,8835,119,528964,6948,RU
2020-06-16,8246,143,537210,7091,RU
2020-06-17,8248,193,545458,7284,RU
2020-06-18,7843,194,553301,7478,RU
2020-06-19,7790,312,561091,7790,RU
2020-06-20,7972,182,569063,7972,RU
2020-06-21,7889,30,576952,8002,RU
2020-06-22,7728,109,584680,8111,RU
2020-06-23,7600,95,592280,8206,RU
2020-06-24,7425,153,599705,8359,RU
2020-06-25,7176,154,606881,8513,RU
2020-06-26,7113,92,613994,8605,RU
2020-06-27,6800,176,620794,8781,RU
2020-03-14,1,0,1,0,RW
2020-03-15,4,0,5,0,RW
2020-03-16,0,0,5,0,RW
2020-03-17,2,0,7,0,RW
2020-03-18,4,0,11,0,RW
2020-03-19,0,0,11,0,RW
2020-03-20,6,0,17,0,RW
2020-03-21,0,0,17,0,RW
2020-03-22,2,0,19,0,RW
2020-03-23,17,0,36,0,RW
2020-03-24,4,0,40,0,RW
2020-03-25,1,0,41,0,RW
2020-03-26,9,0,50,0,RW
2020-03-27,4,0,54,0,RW
2020-03-28,6,0,60,0,RW
2020-03-29,10,0,70,0,RW
2020-03-30,0,0,70,0,RW
2020-03-31,5,0,75,0,RW
2020-04-01,7,0,82,0,RW
2020-04-02,0,0,82,0,RW
2020-04-03,7,0,89,0,RW
2020-04-04,13,0,102,0,RW
2020-04-05,2,0,104,0,RW
2020-04-06,1,0,105,0,RW
2020-04-07,0,0,105,0,RW
2020-04-08,5,0,110,0,RW
2020-04-09,3,0,113,0,RW
2020-04-10,5,0,118,0,RW
2020-04-11,2,0,120,0,RW
2020-04-12,6,0,126,0,RW
2020-04-13,1,0,127,0,RW
2020-04-14,7,0,134,0,RW
2020-04-15,2,0,136,0,RW
2020-04-16,2,0,138,0,RW
2020-04-17,5,0,143,0,RW
2020-04-18,1,0,144,0,RW
2020-04-19,3,0,147,0,RW
2020-04-20,0,0,147,0,RW
2020-04-21,3,0,150,0,RW
2020-04-22,3,0,153,0,RW
2020-04-23,1,0,154,0,RW
2020-04-24,22,0,176,0,RW
2020-04-25,7,0,183,0,RW
2020-04-26,8,0,191,0,RW
2020-04-27,16,0,207,0,RW
2020-04-28,5,0,212,0,RW
2020-04-29,13,0,225,0,RW
2020-04-30,18,0,243,0,RW
2020-05-01,6,0,249,0,RW
2020-05-02,6,0,255,0,RW
2020-05-03,4,0,259,0,RW
2020-05-04,2,0,261,0,RW
2020-05-05,0,0,261,0,RW
2020-05-06,7,0,268,0,RW
2020-05-07,3,0,271,0,RW
2020-05-08,2,0,273,0,RW
2020-05-09,7,0,280,0,RW
2020-05-10,4,0,284,0,RW
2020-05-11,1,0,285,0,RW
2020-05-12,1,0,286,0,RW
2020-05-13,1,0,287,0,RW
2020-05-14,0,0,287,0,RW
2020-05-15,0,0,287,0,RW
2020-05-16,2,0,289,0,RW
2020-05-17,3,0,292,0,RW
2020-05-18,5,0,297,0,RW
2020-05-19,11,0,308,0,RW
2020-05-20,6,0,314,0,RW
2020-05-21,6,0,320,0,RW
2020-05-22,1,0,321,0,RW
2020-05-23,4,0,325,0,RW
2020-05-24,2,0,327,0,RW
2020-05-25,9,0,336,0,RW
2020-05-26,3,0,339,0,RW
2020-05-27,7,0,346,0,RW
2020-05-28,3,0,349,0,RW
2020-05-29,6,0,355,0,RW
2020-05-30,4,1,359,1,RW
2020-05-31,11,0,370,1,RW
2020-06-01,7,0,377,1,RW
2020-06-02,7,1,384,2,RW
2020-06-03,13,0,397,2,RW
2020-06-04,13,0,410,2,RW
2020-06-05,10,0,420,2,RW
2020-06-06,11,0,431,2,RW
2020-06-07,8,0,439,2,RW
2020-06-08,12,0,451,2,RW
2020-06-09,12,0,463,2,RW
2020-06-10,13,0,476,2,RW
2020-06-11,18,0,494,2,RW
2020-06-12,16,0,510,2,RW
2020-06-13,31,0,541,2,RW
2020-06-14,41,0,582,2,RW
2020-06-15,30,0,612,2,RW
2020-06-16,24,0,636,2,RW
2020-06-17,3,0,639,2,RW
2020-06-18,7,0,646,2,RW
2020-06-19,15,0,661,2,RW
2020-06-20,41,0,702,2,RW
2020-06-21,26,0,728,2,RW
2020-06-22,59,0,787,2,RW
2020-06-23,11,0,798,2,RW
2020-06-24,32,0,830,2,RW
2020-06-25,20,0,850,2,RW
2020-06-26,8,0,858,2,RW
2020-03-02,1,0,1,0,SA
2020-03-05,4,0,5,0,SA
2020-03-07,2,0,7,0,SA
2020-03-08,4,0,11,0,SA
2020-03-09,4,0,15,0,SA
2020-03-10,5,0,20,0,SA
2020-03-11,25,0,45,0,SA
2020-03-12,17,0,62,0,SA
2020-03-13,24,0,86,0,SA
2020-03-14,0,0,86,0,SA
2020-03-15,32,0,118,0,SA
2020-03-16,15,0,133,0,SA
2020-03-17,0,0,133,0,SA
2020-03-18,38,0,171,0,SA
2020-03-19,67,0,238,0,SA
2020-03-20,36,0,274,0,SA
2020-03-21,118,0,392,0,SA
2020-03-22,119,0,511,0,SA
2020-03-23,51,0,562,0,SA
2020-03-24,205,1,767,1,SA
2020-03-25,133,1,900,2,SA
2020-03-26,112,1,1012,3,SA
2020-03-27,92,0,1104,3,SA
2020-03-28,99,1,1203,4,SA
2020-03-29,26,4,1229,8,SA
2020-03-30,224,0,1453,8,SA
2020-03-31,110,2,1563,10,SA
2020-04-01,157,6,1720,16,SA
2020-04-02,165,5,1885,21,SA
2020-04-03,0,0,1885,21,SA
2020-04-04,294,8,2179,29,SA
2020-04-05,206,5,2385,34,SA
2020-04-06,138,4,2523,38,SA
2020-04-07,272,3,2795,41,SA
2020-04-08,137,0,2932,41,SA
2020-04-09,355,3,3287,44,SA
2020-04-10,364,3,3651,47,SA
2020-04-11,382,5,4033,52,SA
2020-04-12,429,7,4462,59,SA
2020-04-13,472,6,4934,65,SA
2020-04-14,435,8,5369,73,SA
2020-04-15,493,6,5862,79,SA
2020-04-16,518,4,6380,83,SA
2020-04-17,762,4,7142,87,SA
2020-04-18,1132,5,8274,92,SA
2020-04-19,1088,5,9362,97,SA
2020-04-20,1122,6,10484,103,SA
2020-04-21,1147,6,11631,109,SA
2020-04-22,1141,5,12772,114,SA
2020-04-23,1158,7,13930,121,SA
2020-04-24,1172,6,15102,127,SA
2020-04-25,1197,9,16299,136,SA
2020-04-26,1223,3,17522,139,SA
2020-04-27,1289,5,18811,144,SA
2020-04-28,1266,8,20077,152,SA
2020-04-29,1325,5,21402,157,SA
2020-04-30,1351,5,22753,162,SA
2020-05-01,1344,7,24097,169,SA
2020-05-02,1362,7,25459,176,SA
2020-05-03,1552,8,27011,184,SA
2020-05-04,1645,7,28656,191,SA
2020-05-05,1595,9,30251,200,SA
2020-05-06,1687,9,31938,209,SA
2020-05-07,1793,10,33731,219,SA
2020-05-08,1701,10,35432,229,SA
2020-05-09,1704,10,37136,239,SA
2020-05-10,1912,7,39048,246,SA
2020-05-11,1966,9,41014,255,SA
2020-05-12,1911,9,42925,264,SA
2020-05-13,1905,9,44830,273,SA
2020-05-14,2039,10,46869,283,SA
2020-05-15,2307,9,49176,292,SA
2020-05-16,2840,10,52016,302,SA
2020-05-17,2736,10,54752,312,SA
2020-05-18,2593,8,57345,320,SA
2020-05-19,2509,9,59854,329,SA
2020-05-20,2691,10,62545,339,SA
2020-05-21,2532,12,65077,351,SA
2020-05-22,2642,13,67719,364,SA
2020-05-23,2442,15,70161,379,SA
2020-05-24,2399,11,72560,390,SA
2020-05-25,2235,9,74795,399,SA
2020-05-26,1931,12,76726,411,SA
2020-05-27,1815,14,78541,425,SA
2020-05-28,1644,16,80185,441,SA
2020-05-29,1581,17,81766,458,SA
2020-05-30,1618,22,83384,480,SA
2020-05-31,1877,23,85261,503,SA
2020-06-01,1881,22,87142,525,SA
2020-06-02,1869,24,89011,549,SA
2020-06-03,2171,30,91182,579,SA
2020-06-04,1975,32,93157,611,SA
2020-06-05,2591,31,95748,642,SA
2020-06-06,3121,34,98869,676,SA
2020-06-07,3045,36,101914,712,SA
2020-06-08,3369,34,105283,746,SA
2020-06-09,3288,37,108571,783,SA
2020-06-10,3717,36,112288,819,SA
2020-06-11,3733,38,116021,857,SA
2020-06-12,3921,36,119942,893,SA
2020-06-13,3366,39,123308,932,SA
2020-06-14,4233,40,127541,972,SA
2020-06-15,4507,39,132048,1011,SA
2020-06-16,4267,41,136315,1052,SA
2020-06-17,4919,39,141234,1091,SA
2020-06-18,4757,48,145991,1139,SA
2020-06-19,4301,45,150292,1184,SA
2020-06-20,3941,46,154233,1230,SA
2020-06-21,3379,37,157612,1267,SA
2020-06-22,3393,40,161005,1307,SA
2020-06-23,3139,39,164144,1346,SA
2020-06-24,3123,41,167267,1387,SA
2020-06-25,3372,41,170639,1428,SA
2020-06-26,3938,46,174577,1474,SA
2020-03-14,2,0,2,0,SC
2020-03-15,1,0,3,0,SC
2020-03-16,1,0,4,0,SC
2020-03-17,0,0,4,0,SC
2020-03-18,2,0,6,0,SC
2020-03-19,0,0,6,0,SC
2020-03-20,1,0,7,0,SC
2020-03-21,0,0,7,0,SC
2020-03-22,0,0,7,0,SC
2020-03-23,0,0,7,0,SC
2020-03-24,0,0,7,0,SC
2020-03-25,0,0,7,0,SC
2020-03-26,0,0,7,0,SC
2020-03-27,0,0,7,0,SC
2020-03-28,0,0,7,0,SC
2020-03-29,1,0,8,0,SC
2020-03-30,2,0,10,0,SC
2020-03-31,0,0,10,0,SC
2020-04-01,0,0,10,0,SC
2020-04-02,0,0,10,0,SC
2020-04-03,0,0,10,0,SC
2020-04-04,0,0,10,0,SC
2020-04-05,0,0,10,0,SC
2020-04-06,0,0,10,0,SC
2020-04-07,0,0,10,0,SC
2020-04-08,0,0,10,0,SC
2020-04-09,0,0,10,0,SC
2020-04-10,0,0,10,0,SC
2020-04-11,0,0,10,0,SC
2020-04-12,0,0,10,0,SC
2020-04-13,0,0,10,0,SC
2020-04-14,1,0,11,0,SC
2020-04-15,0,0,11,0,SC
2020-04-16,0,0,11,0,SC
2020-04-17,0,0,11,0,SC
2020-04-18,0,0,11,0,SC
2020-04-19,0,0,11,0,SC
2020-04-20,0,0,11,0,SC
2020-04-21,0,0,11,0,SC
2020-04-22,0,0,11,0,SC
2020-04-23,0,0,11,0,SC
2020-04-24,0,0,11,0,SC
2020-04-25,0,0,11,0,SC
2020-04-26,0,0,11,0,SC
2020-04-27,0,0,11,0,SC
2020-04-28,0,0,11,0,SC
2020-04-29,0,0,11,0,SC
2020-04-30,0,0,11,0,SC
2020-05-01,0,0,11,0,SC
2020-05-02,0,0,11,0,SC
2020-05-03,0,0,11,0,SC
2020-05-04,0,0,11,0,SC
2020-05-05,0,0,11,0,SC
2020-05-06,0,0,11,0,SC
2020-05-07,0,0,11,0,SC
2020-05-08,0,0,11,0,SC
2020-05-09,0,0,11,0,SC
2020-05-10,0,0,11,0,SC
2020-05-11,0,0,11,0,SC
2020-05-12,0,0,11,0,SC
2020-05-13,0,0,11,0,SC
2020-05-14,0,0,11,0,SC
2020-05-15,0,0,11,0,SC
2020-05-16,0,0,11,0,SC
2020-05-17,0,0,11,0,SC
2020-05-18,0,0,11,0,SC
2020-05-19,0,0,11,0,SC
2020-05-20,0,0,11,0,SC
2020-05-21,0,0,11,0,SC
2020-05-22,0,0,11,0,SC
2020-05-23,0,0,11,0,SC
2020-05-24,0,0,11,0,SC
2020-05-25,0,0,11,0,SC
2020-05-26,0,0,11,0,SC
2020-05-27,0,0,11,0,SC
2020-05-28,0,0,11,0,SC
2020-05-29,0,0,11,0,SC
2020-05-30,0,0,11,0,SC
2020-05-31,0,0,11,0,SC
2020-06-01,0,0,11,0,SC
2020-06-02,0,0,11,0,SC
2020-06-03,0,0,11,0,SC
2020-06-04,0,0,11,0,SC
2020-06-05,0,0,11,0,SC
2020-06-06,0,0,11,0,SC
2020-06-07,0,0,11,0,SC
2020-06-08,0,0,11,0,SC
2020-06-09,0,0,11,0,SC
2020-06-10,0,0,11,0,SC
2020-06-11,0,0,11,0,SC
2020-06-12,0,0,11,0,SC
2020-06-13,0,0,11,0,SC
2020-06-14,0,0,11,0,SC
2020-06-15,0,0,11,0,SC
2020-06-16,0,0,11,0,SC
2020-06-17,0,0,11,0,SC
2020-06-18,0,0,11,0,SC
2020-06-19,0,0,11,0,SC
2020-06-20,0,0,11,0,SC
2020-06-21,0,0,11,0,SC
2020-06-22,0,0,11,0,SC
2020-06-23,0,0,11,0,SC
2020-06-24,0,0,11,0,SC
2020-06-25,0,0,11,0,SC
2020-06-26,0,0,11,0,SC
2020-03-13,1,0,1,0,SD
2020-03-14,0,1,1,1,SD
2020-03-15,0,0,1,1,SD
2020-03-16,0,0,1,1,SD
2020-03-17,0,0,1,1,SD
2020-03-18,1,0,2,1,SD
2020-03-19,0,0,2,1,SD
2020-03-20,0,0,2,1,SD
2020-03-21,0,0,2,1,SD
2020-03-22,0,0,2,1,SD
2020-03-23,0,0,2,1,SD
2020-03-24,1,0,3,1,SD
2020-03-25,0,0,3,1,SD
2020-03-26,0,0,3,1,SD
2020-03-27,0,0,3,1,SD
2020-03-28,2,0,5,1,SD
2020-03-29,0,0,5,1,SD
2020-03-30,1,1,6,2,SD
2020-03-31,1,0,7,2,SD
2020-04-01,0,0,7,2,SD
2020-04-02,0,0,7,2,SD
2020-04-03,0,0,7,2,SD
2020-04-04,3,0,10,2,SD
2020-04-05,2,0,12,2,SD
2020-04-06,0,0,12,2,SD
2020-04-07,2,0,14,2,SD
2020-04-08,0,0,14,2,SD
2020-04-09,0,0,14,2,SD
2020-04-10,1,0,15,2,SD
2020-04-11,4,0,19,2,SD
2020-04-12,0,0,19,2,SD
2020-04-13,10,2,29,4,SD
2020-04-14,3,1,32,5,SD
2020-04-15,0,0,32,5,SD
2020-04-16,0,0,32,5,SD
2020-04-17,0,0,32,5,SD
2020-04-18,34,5,66,10,SD
2020-04-19,0,0,66,10,SD
2020-04-20,26,2,92,12,SD
2020-04-21,15,0,107,12,SD
2020-04-22,33,1,140,13,SD
2020-04-23,22,0,162,13,SD
2020-04-24,12,3,174,16,SD
2020-04-25,39,1,213,17,SD
2020-04-26,24,4,237,21,SD
2020-04-27,38,1,275,22,SD
2020-04-28,43,3,318,25,SD
2020-04-29,57,3,375,28,SD
2020-04-30,67,3,442,31,SD
2020-05-01,0,0,442,31,SD
2020-05-02,150,10,592,41,SD
2020-05-03,86,0,678,41,SD
2020-05-04,0,0,678,41,SD
2020-05-05,100,4,778,45,SD
2020-05-06,74,4,852,49,SD
2020-05-07,78,3,930,52,SD
2020-05-08,181,7,1111,59,SD
2020-05-09,53,5,1164,64,SD
2020-05-10,199,6,1363,70,SD
2020-05-11,163,4,1526,74,SD
2020-05-12,135,6,1661,80,SD
2020-05-13,157,10,1818,90,SD
2020-05-14,146,1,1964,91,SD
2020-05-15,0,0,1964,91,SD
2020-05-16,0,0,1964,91,SD
2020-05-17,325,6,2289,97,SD
2020-05-18,302,8,2591,105,SD
2020-05-19,0,0,2591,105,SD
2020-05-20,137,6,2728,111,SD
2020-05-21,410,10,3138,121,SD
2020-05-22,240,16,3378,137,SD
2020-05-23,250,9,3628,146,SD
2020-05-24,6,0,3634,146,SD
2020-05-25,192,19,3826,165,SD
2020-05-26,150,5,3976,170,SD
2020-05-27,170,14,4146,184,SD
2020-05-28,200,11,4346,195,SD
2020-05-29,175,38,4521,233,SD
2020-05-30,279,29,4800,262,SD
2020-05-31,226,24,5026,286,SD
2020-06-01,147,12,5173,298,SD
2020-06-02,137,9,5310,307,SD
2020-06-03,0,0,5310,307,SD
2020-06-04,189,7,5499,314,SD
2020-06-05,215,19,5714,333,SD
2020-06-06,151,14,5865,347,SD
2020-06-07,218,12,6083,359,SD
2020-06-08,159,13,6242,372,SD
2020-06-09,0,0,6242,372,SD
2020-06-10,185,17,6427,389,SD
2020-06-11,303,24,6730,413,SD
2020-06-12,149,20,6879,433,SD
2020-06-13,0,0,6879,433,SD
2020-06-14,341,26,7220,459,SD
2020-06-15,0,0,7220,459,SD
2020-06-16,520,18,7740,477,SD
2020-06-17,280,10,8020,487,SD
2020-06-18,0,0,8020,487,SD
2020-06-19,296,19,8316,506,SD
2020-06-20,264,15,8580,521,SD
2020-06-21,0,0,8580,521,SD
2020-06-22,118,12,8698,533,SD
2020-06-23,191,15,8889,548,SD
2020-06-24,0,0,8889,548,SD
2020-06-25,95,8,8984,556,SD
2020-06-26,273,16,9257,572,SD
2019-12-30,0,0,0,0,SE
2019-12-31,0,0,0,0,SE
2020-01-01,0,0,0,0,SE
2020-01-02,0,0,0,0,SE
2020-01-03,0,0,0,0,SE
2020-01-04,0,0,0,0,SE
2020-01-05,0,0,0,0,SE
2020-01-06,0,0,0,0,SE
2020-01-07,0,0,0,0,SE
2020-01-08,0,0,0,0,SE
2020-01-09,0,0,0,0,SE
2020-01-10,0,0,0,0,SE
2020-01-11,0,0,0,0,SE
2020-01-12,0,0,0,0,SE
2020-01-13,0,0,0,0,SE
2020-01-14,0,0,0,0,SE
2020-01-15,0,0,0,0,SE
2020-01-16,0,0,0,0,SE
2020-01-17,0,0,0,0,SE
2020-01-18,0,0,0,0,SE
2020-01-19,0,0,0,0,SE
2020-01-20,0,0,0,0,SE
2020-01-21,0,0,0,0,SE
2020-01-22,0,0,0,0,SE
2020-01-23,0,0,0,0,SE
2020-01-24,0,0,0,0,SE
2020-01-25,0,0,0,0,SE
2020-01-26,0,0,0,0,SE
2020-01-27,0,0,0,0,SE
2020-01-28,0,0,0,0,SE
2020-01-29,0,0,0,0,SE
2020-01-30,0,0,0,0,SE
2020-01-31,1,0,1,0,SE
2020-02-01,0,0,1,0,SE
2020-02-02,0,0,1,0,SE
2020-02-03,0,0,1,0,SE
2020-02-04,0,0,1,0,SE
2020-02-05,0,0,1,0,SE
2020-02-06,0,0,1,0,SE
2020-02-07,0,0,1,0,SE
2020-02-08,0,0,1,0,SE
2020-02-09,0,0,1,0,SE
2020-02-10,0,0,1,0,SE
2020-02-11,0,0,1,0,SE
2020-02-12,0,0,1,0,SE
2020-02-13,0,0,1,0,SE
2020-02-14,0,0,1,0,SE
2020-02-15,0,0,1,0,SE
2020-02-16,0,0,1,0,SE
2020-02-17,0,0,1,0,SE
2020-02-18,0,0,1,0,SE
2020-02-19,0,0,1,0,SE
2020-02-20,0,0,1,0,SE
2020-02-21,0,0,1,0,SE
2020-02-22,0,0,1,0,SE
2020-02-23,0,0,1,0,SE
2020-02-24,0,0,1,0,SE
2020-02-25,0,0,1,0,SE
2020-02-26,1,0,2,0,SE
2020-02-27,5,0,7,0,SE
2020-02-28,5,0,12,0,SE
2020-02-29,1,0,13,0,SE
2020-03-01,1,0,14,0,SE
2020-03-02,1,0,15,0,SE
2020-03-03,9,0,24,0,SE
2020-03-04,11,0,35,0,SE
2020-03-05,26,0,61,0,SE
2020-03-06,76,0,137,0,SE
2020-03-07,24,0,161,0,SE
2020-03-08,42,0,203,0,SE
2020-03-09,45,0,248,0,SE
2020-03-10,78,0,326,0,SE
2020-03-11,136,1,462,1,SE
2020-03-12,158,0,620,1,SE
2020-03-13,155,0,775,1,SE
2020-03-14,149,0,924,1,SE
2020-03-15,108,2,1032,3,SE
2020-03-16,89,4,1121,7,SE
2020-03-17,46,1,1167,8,SE
2020-03-18,134,2,1301,10,SE
2020-03-19,122,0,1423,10,SE
2020-03-20,200,6,1623,16,SE
2020-03-21,123,4,1746,20,SE
2020-03-22,160,1,1906,21,SE
2020-03-23,110,4,2016,25,SE
2020-03-24,256,11,2272,36,SE
2020-03-25,238,6,2510,42,SE
2020-03-26,296,24,2806,66,SE
2020-03-27,240,26,3046,92,SE
2020-03-28,401,10,3447,102,SE
2020-03-29,253,8,3700,110,SE
2020-03-30,328,36,4028,146,SE
2020-03-31,407,34,4435,180,SE
2020-04-01,512,59,4947,239,SE
2020-04-02,519,43,5466,282,SE
2020-04-03,612,51,6078,333,SE
2020-04-04,365,40,6443,373,SE
2020-04-05,387,28,6830,401,SE
2020-04-06,376,76,7206,477,SE
2020-04-07,487,114,7693,591,SE
2020-04-08,726,96,8419,687,SE
2020-04-09,722,106,9141,793,SE
2020-04-10,544,77,9685,870,SE
2020-04-11,466,17,10151,887,SE
2020-04-12,332,12,10483,899,SE
2020-04-13,465,20,10948,919,SE
2020-04-14,497,114,11445,1033,SE
2020-04-15,482,170,11927,1203,SE
2020-04-16,613,130,12540,1333,SE
2020-04-17,676,67,13216,1400,SE
2020-04-18,606,111,13822,1511,SE
2020-04-19,563,29,14385,1540,SE
2020-04-20,392,40,14777,1580,SE
2020-04-21,545,185,15322,1765,SE
2020-04-22,682,172,16004,1937,SE
2020-04-23,751,84,16755,2021,SE
2020-04-24,812,131,17567,2152,SE
2020-04-25,610,40,18177,2192,SE
2020-04-26,463,2,18640,2194,SE
2020-04-27,286,80,18926,2274,SE
2020-04-28,695,81,19621,2355,SE
2020-04-29,681,107,20302,2462,SE
2020-04-30,790,124,21092,2586,SE
2020-05-01,428,67,21520,2653,SE
2020-05-02,562,16,22082,2669,SE
2020-05-03,235,10,22317,2679,SE
2020-05-04,404,90,22721,2769,SE
2020-05-05,495,85,23216,2854,SE
2020-05-06,702,87,23918,2941,SE
2020-05-07,705,99,24623,3040,SE
2020-05-08,642,135,25265,3175,SE
2020-05-09,656,45,25921,3220,SE
2020-05-10,401,5,26322,3225,SE
2020-05-11,348,31,26670,3256,SE
2020-05-12,602,57,27272,3313,SE
2020-05-13,637,147,27909,3460,SE
2020-05-14,673,69,28582,3529,SE
2020-05-15,625,117,29207,3646,SE
2020-05-16,470,28,29677,3674,SE
2020-05-17,466,5,30143,3679,SE
2020-05-18,234,19,30377,3698,SE
2020-05-19,422,45,30799,3743,SE
2020-05-20,724,88,31523,3831,SE
2020-05-21,649,40,32172,3871,SE
2020-05-22,637,54,32809,3925,SE
2020-05-23,379,67,33188,3992,SE
2020-05-24,271,6,33459,3998,SE
2020-05-25,384,31,33843,4029,SE
2020-05-26,597,96,34440,4125,SE
2020-05-27,648,95,35088,4220,SE
2020-05-28,639,46,35727,4266,SE
2020-05-29,749,84,36476,4350,SE
2020-05-30,637,45,37113,4395,SE
2020-05-31,429,0,37542,4395,SE
2020-06-01,272,8,37814,4403,SE
2020-06-02,775,65,38589,4468,SE
2020-06-03,2214,74,40803,4542,SE
2020-06-04,1080,20,41883,4562,SE
2020-06-05,1056,77,42939,4639,SE
2020-06-06,948,17,43887,4656,SE
2020-06-07,843,3,44730,4659,SE
2020-06-08,403,35,45133,4694,SE
2020-06-09,791,23,45924,4717,SE
2020-06-10,890,78,46814,4795,SE
2020-06-11,1474,19,48288,4814,SE
2020-06-12,1396,40,49684,4854,SE
2020-06-13,1247,20,50931,4874,SE
2020-06-14,683,0,51614,4874,SE
2020-06-15,769,17,52383,4891,SE
2020-06-16,940,48,53323,4939,SE
2020-06-17,1239,102,54562,5041,SE
2020-06-18,1481,12,56043,5053,SE
2020-06-19,0,0,56043,5053,SE
2020-06-20,0,0,56043,5053,SE
2020-06-21,0,0,56043,5053,SE
2020-06-22,2889,69,58932,5122,SE
2020-06-23,1905,39,60837,5161,SE
2020-06-24,1487,48,62324,5209,SE
2020-06-25,1566,21,63890,5230,SE
2020-06-26,1247,50,65137,5280,SE
2019-12-30,0,0,0,0,SG
2019-12-31,0,0,0,0,SG
2020-01-01,0,0,0,0,SG
2020-01-02,0,0,0,0,SG
2020-01-03,0,0,0,0,SG
2020-01-04,0,0,0,0,SG
2020-01-05,0,0,0,0,SG
2020-01-06,0,0,0,0,SG
2020-01-07,0,0,0,0,SG
2020-01-08,0,0,0,0,SG
2020-01-09,0,0,0,0,SG
2020-01-10,0,0,0,0,SG
2020-01-11,0,0,0,0,SG
2020-01-12,0,0,0,0,SG
2020-01-13,0,0,0,0,SG
2020-01-14,0,0,0,0,SG
2020-01-15,0,0,0,0,SG
2020-01-16,0,0,0,0,SG
2020-01-17,0,0,0,0,SG
2020-01-18,0,0,0,0,SG
2020-01-19,0,0,0,0,SG
2020-01-20,0,0,0,0,SG
2020-01-21,0,0,0,0,SG
2020-01-22,0,0,0,0,SG
2020-01-23,3,0,3,0,SG
2020-01-24,0,0,3,0,SG
2020-01-25,1,0,4,0,SG
2020-01-26,0,0,4,0,SG
2020-01-27,1,0,5,0,SG
2020-01-28,2,0,7,0,SG
2020-01-29,3,0,10,0,SG
2020-01-30,3,0,13,0,SG
2020-01-31,3,0,16,0,SG
2020-02-01,2,0,18,0,SG
2020-02-02,0,0,18,0,SG
2020-02-03,0,0,18,0,SG
2020-02-04,6,0,24,0,SG
2020-02-05,4,0,28,0,SG
2020-02-06,2,0,30,0,SG
2020-02-07,3,0,33,0,SG
2020-02-08,7,0,40,0,SG
2020-02-09,3,0,43,0,SG
2020-02-10,2,0,45,0,SG
2020-02-11,2,0,47,0,SG
2020-02-12,3,0,50,0,SG
2020-02-13,8,0,58,0,SG
2020-02-14,9,0,67,0,SG
2020-02-15,5,0,72,0,SG
2020-02-16,3,0,75,0,SG
2020-02-17,2,0,77,0,SG
2020-02-18,4,0,81,0,SG
2020-02-19,3,0,84,0,SG
2020-02-20,1,0,85,0,SG
2020-02-21,1,0,86,0,SG
2020-02-22,3,0,89,0,SG
2020-02-23,0,0,89,0,SG
2020-02-24,1,0,90,0,SG
2020-02-25,1,0,91,0,SG
2020-02-26,2,0,93,0,SG
2020-02-27,3,0,96,0,SG
2020-02-28,2,0,98,0,SG
2020-02-29,4,0,102,0,SG
2020-03-01,4,0,106,0,SG
2020-03-02,2,0,108,0,SG
2020-03-03,2,0,110,0,SG
2020-03-04,2,0,112,0,SG
2020-03-05,5,0,117,0,SG
2020-03-06,13,0,130,0,SG
2020-03-07,8,0,138,0,SG
2020-03-08,12,0,150,0,SG
2020-03-09,10,0,160,0,SG
2020-03-10,6,0,166,0,SG
2020-03-11,12,0,178,0,SG
2020-03-12,9,0,187,0,SG
2020-03-13,13,0,200,0,SG
2020-03-14,14,0,214,0,SG
2020-03-15,12,0,226,0,SG
2020-03-16,17,0,243,0,SG
2020-03-17,23,0,266,0,SG
2020-03-18,47,0,313,0,SG
2020-03-19,32,0,345,0,SG
2020-03-20,40,0,385,0,SG
2020-03-21,47,2,432,2,SG
2020-03-22,23,0,455,2,SG
2020-03-23,54,0,509,2,SG
2020-03-24,49,0,558,2,SG
2020-03-25,10,0,568,2,SG
2020-03-26,26,0,594,2,SG
2020-03-27,138,0,732,2,SG
2020-03-28,71,1,803,3,SG
2020-03-29,41,0,844,3,SG
2020-03-30,0,0,844,3,SG
2020-03-31,35,0,879,3,SG
2020-04-01,121,1,1000,4,SG
2020-04-02,49,1,1049,5,SG
2020-04-03,65,0,1114,5,SG
2020-04-04,75,1,1189,6,SG
2020-04-05,120,0,1309,6,SG
2020-04-06,66,0,1375,6,SG
2020-04-07,106,0,1481,6,SG
2020-04-08,142,0,1623,6,SG
2020-04-09,286,0,1909,6,SG
2020-04-10,0,0,1909,6,SG
2020-04-11,390,2,2299,8,SG
2020-04-12,233,0,2532,8,SG
2020-04-13,386,1,2918,9,SG
2020-04-14,334,1,3252,10,SG
2020-04-15,447,0,3699,10,SG
2020-04-16,728,0,4427,10,SG
2020-04-17,623,1,5050,11,SG
2020-04-18,942,0,5992,11,SG
2020-04-19,596,0,6588,11,SG
2020-04-20,1426,0,8014,11,SG
2020-04-21,1111,0,9125,11,SG
2020-04-22,1016,1,10141,12,SG
2020-04-23,1037,0,11178,12,SG
2020-04-24,897,0,12075,12,SG
2020-04-25,618,0,12693,12,SG
2020-04-26,931,0,13624,12,SG
2020-04-27,799,2,14423,14,SG
2020-04-28,528,0,14951,14,SG
2020-04-29,690,0,15641,14,SG
2020-04-30,528,1,16169,15,SG
2020-05-01,932,1,17101,16,SG
2020-05-02,447,1,17548,17,SG
2020-05-03,657,1,18205,18,SG
2020-05-04,573,0,18778,18,SG
2020-05-05,632,0,19410,18,SG
2020-05-06,788,2,20198,20,SG
2020-05-07,741,0,20939,20,SG
2020-05-08,768,0,21707,20,SG
2020-05-09,753,0,22460,20,SG
2020-05-10,876,0,23336,20,SG
2020-05-11,451,1,23787,21,SG
2020-05-12,884,0,24671,21,SG
2020-05-13,675,0,25346,21,SG
2020-05-14,752,0,26098,21,SG
2020-05-15,793,0,26891,21,SG
2020-05-16,465,1,27356,22,SG
2020-05-17,682,0,28038,22,SG
2020-05-18,305,0,28343,22,SG
2020-05-19,451,0,28794,22,SG
2020-05-20,570,0,29364,22,SG
2020-05-21,448,1,29812,23,SG
2020-05-22,614,0,30426,23,SG
2020-05-23,642,0,31068,23,SG
2020-05-24,548,0,31616,23,SG
2020-05-25,344,0,31960,23,SG
2020-05-26,383,0,32343,23,SG
2020-05-27,533,0,32876,23,SG
2020-05-28,373,0,33249,23,SG
2020-05-29,611,0,33860,23,SG
2020-05-30,506,0,34366,23,SG
2020-05-31,518,0,34884,23,SG
2020-06-01,408,1,35292,24,SG
2020-06-02,544,0,35836,24,SG
2020-06-03,569,0,36405,24,SG
2020-06-04,517,0,36922,24,SG
2020-06-05,261,0,37183,24,SG
2020-06-06,344,1,37527,25,SG
2020-06-07,383,0,37910,25,SG
2020-06-08,386,0,38296,25,SG
2020-06-09,218,0,38514,25,SG
2020-06-10,451,0,38965,25,SG
2020-06-11,422,0,39387,25,SG
2020-06-12,463,0,39850,25,SG
2020-06-13,347,1,40197,26,SG
2020-06-14,407,0,40604,26,SG
2020-06-15,214,0,40818,26,SG
2020-06-16,151,0,40969,26,SG
2020-06-17,247,0,41216,26,SG
2020-06-18,257,0,41473,26,SG
2020-06-19,142,0,41615,26,SG
2020-06-20,218,0,41833,26,SG
2020-06-21,262,0,42095,26,SG
2020-06-22,218,0,42313,26,SG
2020-06-23,119,0,42432,26,SG
2020-06-24,191,0,42623,26,SG
2020-06-25,113,0,42736,26,SG
2020-06-26,219,0,42955,26,SG
2020-03-04,1,0,1,0,SI
2020-03-05,5,0,6,0,SI
2020-03-06,3,0,9,0,SI
2020-03-07,3,0,12,0,SI
2020-03-08,4,0,16,0,SI
2020-03-10,15,0,31,0,SI
2020-03-11,26,0,57,0,SI
2020-03-12,39,0,96,0,SI
2020-03-13,45,0,141,0,SI
2020-03-14,40,0,181,0,SI
2020-03-15,38,0,219,0,SI
2020-03-16,34,0,253,0,SI
2020-03-17,22,1,275,1,SI
2020-03-18,11,0,286,1,SI
2020-03-19,33,0,319,1,SI
2020-03-20,22,0,341,1,SI
2020-03-21,42,0,383,1,SI
2020-03-22,31,0,414,1,SI
2020-03-23,28,0,442,1,SI
2020-03-24,38,2,480,3,SI
2020-03-25,48,1,528,4,SI
2020-03-26,49,1,577,5,SI
2020-03-27,55,4,632,9,SI
2020-03-28,59,0,691,9,SI
2020-03-29,39,2,730,11,SI
2020-03-30,33,0,763,11,SI
2020-03-31,51,2,814,13,SI
2020-04-01,27,2,841,15,SI
2020-04-02,56,1,897,16,SI
2020-04-03,37,4,934,20,SI
2020-04-04,43,2,977,22,SI
2020-04-05,20,6,997,28,SI
2020-04-06,24,2,1021,30,SI
2020-04-07,34,6,1055,36,SI
2020-04-08,36,4,1091,40,SI
2020-04-09,33,3,1124,43,SI
2020-04-10,36,2,1160,45,SI
2020-04-11,28,5,1188,50,SI
2020-04-12,17,3,1205,53,SI
2020-04-13,7,2,1212,55,SI
2020-04-14,8,1,1220,56,SI
2020-04-15,28,5,1248,61,SI
2020-04-16,20,0,1268,61,SI
2020-04-17,36,5,1304,66,SI
2020-04-18,13,4,1317,70,SI
2020-04-19,13,4,1330,74,SI
2020-04-20,5,0,1335,74,SI
2020-04-21,5,3,1340,77,SI
2020-04-22,13,2,1353,79,SI
2020-04-23,13,0,1366,79,SI
2020-04-24,7,1,1373,80,SI
2020-04-25,15,1,1388,81,SI
2020-04-26,19,1,1407,82,SI
2020-04-27,0,1,1407,83,SI
2020-04-28,1,3,1408,86,SI
2020-04-29,10,3,1418,89,SI
2020-04-30,11,2,1429,91,SI
2020-05-01,5,2,1434,93,SI
2020-05-02,5,1,1439,94,SI
2020-05-03,0,2,1439,96,SI
2020-05-04,6,1,1445,97,SI
2020-05-05,3,1,1448,98,SI
2020-05-06,1,1,1449,99,SI
2020-05-07,1,0,1450,99,SI
2020-05-08,4,1,1454,100,SI
2020-05-09,3,1,1457,101,SI
2020-05-10,3,1,1460,102,SI
2020-05-11,1,0,1461,102,SI
2020-05-12,2,0,1463,102,SI
2020-05-13,1,1,1464,103,SI
2020-05-14,1,0,1465,103,SI
2020-05-15,0,0,1465,103,SI
2020-05-16,1,0,1466,103,SI
2020-05-17,0,1,1466,104,SI
2020-05-18,1,0,1467,104,SI
2020-05-19,1,0,1468,104,SI
2020-05-20,0,2,1468,106,SI
2020-05-21,0,0,1468,106,SI
2020-05-22,0,0,1468,106,SI
2020-05-23,0,0,1468,106,SI
2020-05-24,1,0,1469,106,SI
2020-05-25,0,0,1469,106,SI
2020-05-26,0,0,1469,106,SI
2020-05-27,2,1,1471,107,SI
2020-05-28,2,1,1473,108,SI
2020-05-29,0,0,1473,108,SI
2020-05-30,0,0,1473,108,SI
2020-05-31,0,0,1473,108,SI
2020-06-01,2,0,1475,108,SI
2020-06-02,0,0,1475,108,SI
2020-06-03,2,0,1477,108,SI
2020-06-04,2,0,1479,108,SI
2020-06-05,5,0,1484,108,SI
2020-06-06,1,0,1485,108,SI
2020-06-07,0,0,1485,108,SI
2020-06-08,0,0,1485,108,SI
2020-06-09,1,0,1486,108,SI
2020-06-10,2,1,1488,109,SI
2020-06-11,0,0,1488,109,SI
2020-06-12,2,0,1490,109,SI
2020-06-13,2,0,1492,109,SI
2020-06-14,3,0,1495,109,SI
2020-06-15,1,0,1496,109,SI
2020-06-16,3,0,1499,109,SI
2020-06-17,4,0,1503,109,SI
2020-06-18,8,0,1511,109,SI
2020-06-19,2,0,1513,109,SI
2020-06-20,6,0,1519,109,SI
2020-06-21,1,0,1520,109,SI
2020-06-22,1,0,1521,109,SI
2020-06-23,13,2,1534,111,SI
2020-06-24,7,0,1541,111,SI
2020-06-25,6,0,1547,111,SI
2020-06-26,11,0,1558,111,SI
2020-03-06,1,0,1,0,SK
2020-03-07,2,0,3,0,SK
2020-03-08,2,0,5,0,SK
2020-03-10,2,0,7,0,SK
2020-03-11,3,0,10,0,SK
2020-03-12,11,0,21,0,SK
2020-03-13,9,0,30,0,SK
2020-03-14,14,0,44,0,SK
2020-03-15,17,0,61,0,SK
2020-03-16,23,0,84,0,SK
2020-03-17,13,0,97,0,SK
2020-03-18,10,0,107,0,SK
2020-03-19,16,0,123,0,SK
2020-03-20,14,0,137,0,SK
2020-03-21,41,0,178,0,SK
2020-03-22,7,0,185,0,SK
2020-03-23,6,0,191,0,SK
2020-03-24,13,0,204,0,SK
2020-03-25,12,0,216,0,SK
2020-03-26,10,0,226,0,SK
2020-03-27,69,0,295,0,SK
2020-03-28,0,0,295,0,SK
2020-03-29,41,0,336,0,SK
2020-03-30,0,0,336,0,SK
2020-03-31,27,0,363,0,SK
2020-04-01,37,0,400,0,SK
2020-04-02,26,0,426,0,SK
2020-04-03,24,0,450,0,SK
2020-04-04,21,0,471,0,SK
2020-04-05,14,0,485,0,SK
2020-04-06,49,2,534,2,SK
2020-04-07,47,0,581,2,SK
2020-04-08,101,0,682,2,SK
2020-04-09,19,0,701,2,SK
2020-04-10,14,0,715,2,SK
2020-04-11,13,0,728,2,SK
2020-04-12,14,0,742,2,SK
2020-04-13,27,0,769,2,SK
2020-04-14,66,0,835,2,SK
2020-04-15,28,4,863,6,SK
2020-04-16,114,2,977,8,SK
2020-04-17,72,1,1049,9,SK
2020-04-18,40,2,1089,11,SK
2020-04-19,72,1,1161,12,SK
2020-04-20,12,1,1173,13,SK
2020-04-21,26,1,1199,14,SK
2020-04-22,45,0,1244,14,SK
2020-04-23,81,1,1325,15,SK
2020-04-24,35,2,1360,17,SK
2020-04-25,13,0,1373,17,SK
2020-04-26,6,1,1379,18,SK
2020-04-27,2,0,1381,18,SK
2020-04-28,3,2,1384,20,SK
2020-04-29,7,2,1391,22,SK
2020-04-30,5,1,1396,23,SK
2020-05-01,7,0,1403,23,SK
2020-05-02,4,1,1407,24,SK
2020-05-03,1,0,1408,24,SK
2020-05-04,5,1,1413,25,SK
2020-05-05,8,0,1421,25,SK
2020-05-06,8,0,1429,25,SK
2020-05-07,16,1,1445,26,SK
2020-05-08,10,0,1455,26,SK
2020-05-09,0,0,1455,26,SK
2020-05-10,2,0,1457,26,SK
2020-05-11,0,0,1457,26,SK
2020-05-12,8,1,1465,27,SK
2020-05-13,4,0,1469,27,SK
2020-05-14,8,0,1477,27,SK
2020-05-15,3,0,1480,27,SK
2020-05-16,13,1,1493,28,SK
2020-05-17,1,0,1494,28,SK
2020-05-18,1,0,1495,28,SK
2020-05-19,0,0,1495,28,SK
2020-05-20,1,0,1496,28,SK
2020-05-21,6,0,1502,28,SK
2020-05-22,1,0,1503,28,SK
2020-05-23,1,0,1504,28,SK
2020-05-24,5,0,1509,28,SK
2020-05-25,2,0,1511,28,SK
2020-05-26,2,0,1513,28,SK
2020-05-27,2,0,1515,28,SK
2020-05-28,5,0,1520,28,SK
2020-05-29,0,0,1520,28,SK
2020-05-30,1,0,1521,28,SK
2020-05-31,1,0,1522,28,SK
2020-06-01,0,0,1522,28,SK
2020-06-02,0,0,1522,28,SK
2020-06-03,3,0,1525,28,SK
2020-06-04,1,0,1526,28,SK
2020-06-05,0,0,1526,28,SK
2020-06-06,2,0,1528,28,SK
2020-06-07,0,0,1528,28,SK
2020-06-08,2,0,1530,28,SK
2020-06-09,1,0,1531,28,SK
2020-06-10,2,0,1533,28,SK
2020-06-11,8,0,1541,28,SK
2020-06-12,1,0,1542,28,SK
2020-06-13,3,0,1545,28,SK
2020-06-14,3,0,1548,28,SK
2020-06-15,4,0,1552,28,SK
2020-06-16,0,0,1552,28,SK
2020-06-17,9,0,1561,28,SK
2020-06-18,1,0,1562,28,SK
2020-06-19,14,0,1576,28,SK
2020-06-20,10,0,1586,28,SK
2020-06-21,1,0,1587,28,SK
2020-06-22,1,0,1588,28,SK
2020-06-23,1,0,1589,28,SK
2020-06-24,18,0,1607,28,SK
2020-06-25,23,0,1630,28,SK
2020-06-26,13,0,1643,28,SK
2020-03-31,1,0,1,0,SL
2020-04-01,0,0,1,0,SL
2020-04-02,1,0,2,0,SL
2020-04-03,0,0,2,0,SL
2020-04-04,2,0,4,0,SL
2020-04-05,2,0,6,0,SL
2020-04-06,0,0,6,0,SL
2020-04-07,0,0,6,0,SL
2020-04-08,1,0,7,0,SL
2020-04-09,0,0,7,0,SL
2020-04-10,1,0,8,0,SL
2020-04-11,2,0,10,0,SL
2020-04-12,0,0,10,0,SL
2020-04-13,1,0,11,0,SL
2020-04-14,0,0,11,0,SL
2020-04-15,2,0,13,0,SL
2020-04-16,2,0,15,0,SL
2020-04-17,11,0,26,0,SL
2020-04-18,4,0,30,0,SL
2020-04-19,5,0,35,0,SL
2020-04-20,8,0,43,0,SL
2020-04-21,7,0,50,0,SL
2020-04-22,11,0,61,0,SL
2020-04-23,3,1,64,1,SL
2020-04-24,18,2,82,3,SL
2020-04-25,0,0,82,3,SL
2020-04-26,11,1,93,4,SL
2020-04-27,6,0,99,4,SL
2020-04-28,5,0,104,4,SL
2020-04-29,12,0,116,4,SL
2020-04-30,8,3,124,7,SL
2020-05-01,12,0,136,7,SL
2020-05-02,19,1,155,8,SL
2020-05-03,2,0,157,8,SL
2020-05-04,21,1,178,9,SL
2020-05-05,21,2,199,11,SL
2020-05-06,26,3,225,14,SL
2020-05-07,6,2,231,16,SL
2020-05-08,26,1,257,17,SL
2020-05-09,34,1,291,18,SL
2020-05-10,16,0,307,18,SL
2020-05-11,31,1,338,19,SL
2020-05-12,0,1,338,20,SL
2020-05-13,49,1,387,21,SL
2020-05-14,21,5,408,26,SL
2020-05-15,39,1,447,27,SL
2020-05-16,15,2,462,29,SL
2020-05-17,43,3,505,32,SL
2020-05-18,14,1,519,33,SL
2020-05-19,15,0,534,33,SL
2020-05-20,36,1,570,34,SL
2020-05-21,15,1,585,35,SL
2020-05-22,21,3,606,38,SL
2020-05-23,15,1,621,39,SL
2020-05-24,86,1,707,40,SL
2020-05-25,28,2,735,42,SL
2020-05-26,19,2,754,44,SL
2020-05-27,28,1,782,45,SL
2020-05-28,30,0,812,45,SL
2020-05-29,17,0,829,45,SL
2020-05-30,23,1,852,46,SL
2020-05-31,9,0,861,46,SL
2020-06-01,0,0,861,46,SL
2020-06-02,35,0,896,46,SL
2020-06-03,13,1,909,47,SL
2020-06-04,5,0,914,47,SL
2020-06-05,15,0,929,47,SL
2020-06-06,17,1,946,48,SL
2020-06-07,23,0,969,48,SL
2020-06-08,32,1,1001,49,SL
2020-06-09,24,1,1025,50,SL
2020-06-10,37,0,1062,50,SL
2020-06-11,23,0,1085,50,SL
2020-06-12,18,1,1103,51,SL
2020-06-13,29,0,1132,51,SL
2020-06-14,37,0,1169,51,SL
2020-06-15,7,0,1176,51,SL
2020-06-16,49,0,1225,51,SL
2020-06-17,24,0,1249,51,SL
2020-06-18,23,0,1272,51,SL
2020-06-19,26,2,1298,53,SL
2020-06-20,11,0,1309,53,SL
2020-06-21,18,2,1327,55,SL
2020-06-22,13,0,1340,55,SL
2020-06-23,7,0,1347,55,SL
2020-06-24,7,1,1354,56,SL
2020-06-25,27,0,1381,56,SL
2020-06-26,13,3,1394,59,SL
2019-12-30,0,0,0,0,SM
2019-12-31,0,0,0,0,SM
2020-01-01,0,0,0,0,SM
2020-01-02,0,0,0,0,SM
2020-01-03,0,0,0,0,SM
2020-01-04,0,0,0,0,SM
2020-01-05,0,0,0,0,SM
2020-01-06,0,0,0,0,SM
2020-01-07,0,0,0,0,SM
2020-01-08,0,0,0,0,SM
2020-01-09,0,0,0,0,SM
2020-01-10,0,0,0,0,SM
2020-01-11,0,0,0,0,SM
2020-01-12,0,0,0,0,SM
2020-01-13,0,0,0,0,SM
2020-01-14,0,0,0,0,SM
2020-01-15,0,0,0,0,SM
2020-01-16,0,0,0,0,SM
2020-01-17,0,0,0,0,SM
2020-01-18,0,0,0,0,SM
2020-01-19,0,0,0,0,SM
2020-01-20,0,0,0,0,SM
2020-01-21,0,0,0,0,SM
2020-01-22,0,0,0,0,SM
2020-01-23,0,0,0,0,SM
2020-01-24,0,0,0,0,SM
2020-01-25,0,0,0,0,SM
2020-01-26,0,0,0,0,SM
2020-01-27,0,0,0,0,SM
2020-01-28,0,0,0,0,SM
2020-01-29,0,0,0,0,SM
2020-01-30,0,0,0,0,SM
2020-01-31,0,0,0,0,SM
2020-02-01,0,0,0,0,SM
2020-02-02,0,0,0,0,SM
2020-02-03,0,0,0,0,SM
2020-02-04,0,0,0,0,SM
2020-02-05,0,0,0,0,SM
2020-02-06,0,0,0,0,SM
2020-02-07,0,0,0,0,SM
2020-02-08,0,0,0,0,SM
2020-02-09,0,0,0,0,SM
2020-02-10,0,0,0,0,SM
2020-02-11,0,0,0,0,SM
2020-02-12,0,0,0,0,SM
2020-02-13,0,0,0,0,SM
2020-02-14,0,0,0,0,SM
2020-02-15,0,0,0,0,SM
2020-02-16,0,0,0,0,SM
2020-02-17,0,0,0,0,SM
2020-02-18,0,0,0,0,SM
2020-02-19,0,0,0,0,SM
2020-02-20,0,0,0,0,SM
2020-02-21,0,0,0,0,SM
2020-02-22,0,0,0,0,SM
2020-02-23,0,0,0,0,SM
2020-02-24,0,0,0,0,SM
2020-02-25,0,0,0,0,SM
2020-02-26,0,0,0,0,SM
2020-02-27,1,0,1,0,SM
2020-02-28,0,0,1,0,SM
2020-02-29,0,0,1,0,SM
2020-03-01,7,1,8,1,SM
2020-03-03,2,0,10,1,SM
2020-03-04,5,0,15,1,SM
2020-03-05,7,0,22,1,SM
2020-03-06,1,0,23,1,SM
2020-03-07,3,0,26,1,SM
2020-03-08,11,0,37,1,SM
2020-03-09,12,1,49,2,SM
2020-03-10,13,0,62,2,SM
2020-03-11,4,1,66,3,SM
2020-03-12,1,2,67,5,SM
2020-03-13,6,0,73,5,SM
2020-03-14,19,0,92,5,SM
2020-03-15,6,2,98,7,SM
2020-03-16,4,2,102,9,SM
2020-03-17,2,2,104,11,SM
2020-03-18,5,3,109,14,SM
2020-03-19,17,0,126,14,SM
2020-03-20,25,0,151,14,SM
2020-03-21,0,6,151,20,SM
2020-03-22,0,0,151,20,SM
2020-03-23,36,0,187,20,SM
2020-03-24,0,1,187,21,SM
2020-03-25,21,0,208,21,SM
2020-03-26,10,0,218,21,SM
2020-03-27,5,0,223,21,SM
2020-03-28,1,1,224,22,SM
2020-03-29,5,2,229,24,SM
2020-03-30,0,1,229,25,SM
2020-03-31,1,1,230,26,SM
2020-04-01,6,0,236,26,SM
2020-04-02,9,4,245,30,SM
2020-04-03,6,2,251,32,SM
2020-04-04,8,0,259,32,SM
2020-04-05,7,0,266,32,SM
2020-04-06,11,0,277,32,SM
2020-04-07,2,2,279,34,SM
2020-04-08,29,0,308,34,SM
2020-04-09,25,0,333,34,SM
2020-04-10,11,0,344,34,SM
2020-04-11,12,1,356,35,SM
2020-04-12,0,0,356,35,SM
2020-04-13,0,1,356,36,SM
2020-04-14,16,0,372,36,SM
2020-04-15,20,0,392,36,SM
2020-04-16,34,2,426,38,SM
2020-04-17,9,1,435,39,SM
2020-04-18,20,0,455,39,SM
2020-04-19,6,0,461,39,SM
2020-04-20,1,0,462,39,SM
2020-04-21,14,1,476,40,SM
2020-04-22,12,0,488,40,SM
2020-04-23,13,0,501,40,SM
2020-04-24,12,0,513,40,SM
2020-04-25,0,0,513,40,SM
2020-04-26,25,1,538,41,SM
2020-04-27,0,0,538,41,SM
2020-04-28,15,0,553,41,SM
2020-04-29,10,0,563,41,SM
2020-04-30,6,0,569,41,SM
2020-05-01,11,0,580,41,SM
2020-05-02,0,0,580,41,SM
2020-05-03,2,0,582,41,SM
2020-05-04,0,0,582,41,SM
2020-05-05,7,0,589,41,SM
2020-05-06,19,0,608,41,SM
2020-05-07,14,0,622,41,SM
2020-05-08,1,0,623,41,SM
2020-05-09,14,0,637,41,SM
2020-05-10,-9,0,628,41,SM
2020-05-11,0,0,628,41,SM
2020-05-12,10,0,638,41,SM
2020-05-13,5,0,643,41,SM
2020-05-14,5,0,648,41,SM
2020-05-15,4,0,652,41,SM
2020-05-16,1,0,653,41,SM
2020-05-17,1,0,654,41,SM
2020-05-18,0,0,654,41,SM
2020-05-19,1,0,655,41,SM
2020-05-20,1,0,656,41,SM
2020-05-21,2,0,658,41,SM
2020-05-22,3,0,661,41,SM
2020-05-23,4,1,665,42,SM
2020-05-24,0,0,665,42,SM
2020-05-25,1,0,666,42,SM
2020-05-26,0,0,666,42,SM
2020-05-27,1,0,667,42,SM
2020-05-28,3,0,670,42,SM
2020-05-29,1,0,671,42,SM
2020-05-30,0,0,671,42,SM
2020-05-31,0,0,671,42,SM
2020-06-01,16,0,687,42,SM
2020-06-02,0,0,687,42,SM
2020-06-03,0,0,687,42,SM
2020-06-04,0,0,687,42,SM
2020-06-05,0,0,687,42,SM
2020-06-06,0,0,687,42,SM
2020-06-07,0,0,687,42,SM
2020-06-08,0,0,687,42,SM
2020-06-09,1,0,688,42,SM
2020-06-10,3,0,691,42,SM
2020-06-11,0,0,691,42,SM
2020-06-12,3,0,694,42,SM
2020-06-13,0,0,694,42,SM
2020-06-14,0,0,694,42,SM
2020-06-15,0,0,694,42,SM
2020-06-16,0,0,694,42,SM
2020-06-17,2,0,696,42,SM
2020-06-18,0,0,696,42,SM
2020-06-19,0,0,696,42,SM
2020-06-20,0,0,696,42,SM
2020-06-21,0,0,696,42,SM
2020-06-22,2,0,698,42,SM
2020-06-23,0,0,698,42,SM
2020-06-24,0,0,698,42,SM
2020-06-25,0,0,698,42,SM
2020-06-26,0,0,698,42,SM
2020-03-02,1,0,1,0,SN
2020-03-04,2,0,3,0,SN
2020-03-05,1,0,4,0,SN
2020-03-12,2,0,6,0,SN
2020-03-13,13,0,19,0,SN
2020-03-14,2,0,21,0,SN
2020-03-15,5,0,26,0,SN
2020-03-16,1,0,27,0,SN
2020-03-17,4,0,31,0,SN
2020-03-18,5,0,36,0,SN
2020-03-19,0,0,36,0,SN
2020-03-20,11,0,47,0,SN
2020-03-21,9,0,56,0,SN
2020-03-22,11,0,67,0,SN
2020-03-23,12,0,79,0,SN
2020-03-24,7,0,86,0,SN
2020-03-25,13,0,99,0,SN
2020-03-26,6,0,105,0,SN
2020-03-27,14,0,119,0,SN
2020-03-28,11,0,130,0,SN
2020-03-29,12,0,142,0,SN
2020-03-30,20,0,162,0,SN
2020-03-31,13,0,175,0,SN
2020-04-01,15,1,190,1,SN
2020-04-02,5,0,195,1,SN
2020-04-03,12,0,207,1,SN
2020-04-04,12,1,219,2,SN
2020-04-05,3,0,222,2,SN
2020-04-06,4,0,226,2,SN
2020-04-07,11,0,237,2,SN
2020-04-08,7,0,244,2,SN
2020-04-09,6,0,250,2,SN
2020-04-10,15,0,265,2,SN
2020-04-11,13,0,278,2,SN
2020-04-12,2,0,280,2,SN
2020-04-13,11,0,291,2,SN
2020-04-14,8,0,299,2,SN
2020-04-15,15,0,314,2,SN
2020-04-16,21,0,335,2,SN
2020-04-17,7,1,342,3,SN
2020-04-18,8,0,350,3,SN
2020-04-19,17,1,367,4,SN
2020-04-20,10,1,377,5,SN
2020-04-21,35,0,412,5,SN
2020-04-22,30,1,442,6,SN
2020-04-23,37,0,479,6,SN
2020-04-24,66,1,545,7,SN
2020-04-25,69,0,614,7,SN
2020-04-26,57,2,671,9,SN
2020-04-27,64,0,735,9,SN
2020-04-28,88,0,823,9,SN
2020-04-29,59,0,882,9,SN
2020-04-30,51,0,933,9,SN
2020-05-01,91,0,1024,9,SN
2020-05-02,91,0,1115,9,SN
2020-05-03,67,0,1182,9,SN
2020-05-04,89,1,1271,10,SN
2020-05-05,58,1,1329,11,SN
2020-05-06,104,1,1433,12,SN
2020-05-07,59,1,1492,13,SN
2020-05-08,59,1,1551,14,SN
2020-05-09,83,3,1634,17,SN
2020-05-10,75,2,1709,19,SN
2020-05-11,177,0,1886,19,SN
2020-05-12,109,0,1995,19,SN
2020-05-13,110,3,2105,22,SN
2020-05-14,84,1,2189,23,SN
2020-05-15,121,2,2310,25,SN
2020-05-16,119,0,2429,25,SN
2020-05-17,51,1,2480,26,SN
2020-05-18,64,0,2544,26,SN
2020-05-19,73,4,2617,30,SN
2020-05-20,97,0,2714,30,SN
2020-05-21,98,3,2812,33,SN
2020-05-22,97,0,2909,33,SN
2020-05-23,67,2,2976,35,SN
2020-05-24,71,0,3047,35,SN
2020-05-25,83,1,3130,36,SN
2020-05-26,31,1,3161,37,SN
2020-05-27,92,2,3253,39,SN
2020-05-28,95,2,3348,41,SN
2020-05-29,81,0,3429,41,SN
2020-05-30,106,1,3535,42,SN
2020-05-31,110,0,3645,42,SN
2020-06-01,94,0,3739,42,SN
2020-06-02,97,1,3836,43,SN
2020-06-03,96,2,3932,45,SN
2020-06-04,89,0,4021,45,SN
2020-06-05,134,0,4155,45,SN
2020-06-06,94,2,4249,47,SN
2020-06-07,79,2,4328,49,SN
2020-06-08,99,3,4427,52,SN
2020-06-09,89,0,4516,52,SN
2020-06-10,124,2,4640,54,SN
2020-06-11,119,2,4759,56,SN
2020-06-12,92,0,4851,56,SN
2020-06-13,145,4,4996,60,SN
2020-06-14,94,0,5090,60,SN
2020-06-15,83,4,5173,64,SN
2020-06-16,74,6,5247,70,SN
2020-06-17,122,3,5369,73,SN
2020-06-18,106,3,5475,76,SN
2020-06-19,164,3,5639,79,SN
2020-06-20,99,3,5738,82,SN
2020-06-21,150,2,5888,84,SN
2020-06-22,82,2,5970,86,SN
2020-06-23,64,3,6034,89,SN
2020-06-24,95,4,6129,93,SN
2020-06-25,104,1,6233,94,SN
2020-06-26,121,4,6354,98,SN
2020-03-16,1,0,1,0,SO
2020-03-17,0,0,1,0,SO
2020-03-18,0,0,1,0,SO
2020-03-19,0,0,1,0,SO
2020-03-20,0,0,1,0,SO
2020-03-21,0,0,1,0,SO
2020-03-22,0,0,1,0,SO
2020-03-23,0,0,1,0,SO
2020-03-24,0,0,1,0,SO
2020-03-25,0,0,1,0,SO
2020-03-26,1,0,2,0,SO
2020-03-27,1,0,3,0,SO
2020-03-28,0,0,3,0,SO
2020-03-29,0,0,3,0,SO
2020-03-30,0,0,3,0,SO
2020-03-31,0,0,3,0,SO
2020-04-01,2,0,5,0,SO
2020-04-02,0,0,5,0,SO
2020-04-03,0,0,5,0,SO
2020-04-04,2,0,7,0,SO
2020-04-05,0,0,7,0,SO
2020-04-06,0,0,7,0,SO
2020-04-07,1,0,8,0,SO
2020-04-08,0,0,8,0,SO
2020-04-09,4,1,12,1,SO
2020-04-10,9,0,21,1,SO
2020-04-11,0,0,21,1,SO
2020-04-12,4,1,25,2,SO
2020-04-13,0,0,25,2,SO
2020-04-14,35,0,60,2,SO
2020-04-15,20,3,80,5,SO
2020-04-16,0,0,80,5,SO
2020-04-17,36,0,116,5,SO
2020-04-18,19,2,135,7,SO
2020-04-19,29,0,164,7,SO
2020-04-20,73,1,237,8,SO
2020-04-21,49,0,286,8,SO
2020-04-22,0,6,286,14,SO
2020-04-23,42,0,328,14,SO
2020-04-24,0,2,328,16,SO
2020-04-25,62,2,390,18,SO
2020-04-26,46,5,436,23,SO
2020-04-27,44,3,480,26,SO
2020-04-28,48,2,528,28,SO
2020-04-29,54,0,582,28,SO
2020-04-30,19,0,601,28,SO
2020-05-01,0,0,601,28,SO
2020-05-02,70,3,671,31,SO
2020-05-03,51,1,722,32,SO
2020-05-04,34,3,756,35,SO
2020-05-05,79,3,835,38,SO
2020-05-06,38,1,873,39,SO
2020-05-07,55,5,928,44,SO
2020-05-08,0,0,928,44,SO
2020-05-09,69,4,997,48,SO
2020-05-10,57,3,1054,51,SO
2020-05-11,35,1,1089,52,SO
2020-05-12,81,0,1170,52,SO
2020-05-13,49,0,1219,52,SO
2020-05-14,65,1,1284,53,SO
2020-05-15,0,0,1284,53,SO
2020-05-16,73,2,1357,55,SO
2020-05-17,64,1,1421,56,SO
2020-05-18,34,1,1455,57,SO
2020-05-19,47,2,1502,59,SO
2020-05-20,71,2,1573,61,SO
2020-05-21,21,0,1594,61,SO
2020-05-22,0,0,1594,61,SO
2020-05-23,0,0,1594,61,SO
2020-05-24,0,0,1594,61,SO
2020-05-25,95,5,1689,66,SO
2020-05-26,22,1,1711,67,SO
2020-05-27,20,0,1731,67,SO
2020-05-28,97,5,1828,72,SO
2020-05-29,0,0,1828,72,SO
2020-05-30,88,1,1916,73,SO
2020-05-31,60,5,1976,78,SO
2020-06-01,47,1,2023,79,SO
2020-06-02,66,0,2089,79,SO
2020-06-03,57,0,2146,79,SO
2020-06-04,58,0,2204,79,SO
2020-06-05,0,0,2204,79,SO
2020-06-06,85,3,2289,82,SO
2020-06-07,45,1,2334,83,SO
2020-06-08,34,1,2368,84,SO
2020-06-09,48,1,2416,85,SO
2020-06-10,36,0,2452,85,SO
2020-06-11,61,0,2513,85,SO
2020-06-12,0,0,2513,85,SO
2020-06-13,66,2,2579,87,SO
2020-06-14,24,1,2603,88,SO
2020-06-15,39,0,2642,88,SO
2020-06-16,16,0,2658,88,SO
2020-06-17,38,0,2696,88,SO
2020-06-18,23,0,2719,88,SO
2020-06-19,0,0,2719,88,SO
2020-06-20,36,0,2755,88,SO
2020-06-21,24,2,2779,90,SO
2020-06-22,33,0,2812,90,SO
2020-06-23,23,0,2835,90,SO
2020-06-24,25,0,2860,90,SO
2020-06-25,18,0,2878,90,SO
2020-06-26,0,0,2878,90,SO
2020-03-14,1,0,1,0,SR
2020-03-20,0,0,1,0,SR
2020-03-21,4,0,5,0,SR
2020-03-22,0,0,5,0,SR
2020-03-23,1,0,6,0,SR
2020-03-24,2,0,8,0,SR
2020-03-25,0,0,8,0,SR
2020-03-26,0,0,8,0,SR
2020-03-27,0,0,8,0,SR
2020-03-28,0,0,8,0,SR
2020-03-29,0,0,8,0,SR
2020-03-30,0,0,8,0,SR
2020-03-31,2,0,10,0,SR
2020-04-01,0,0,10,0,SR
2020-04-02,0,0,10,0,SR
2020-04-03,0,1,10,1,SR
2020-04-04,0,0,10,1,SR
2020-04-05,0,0,10,1,SR
2020-04-06,0,0,10,1,SR
2020-04-07,0,0,10,1,SR
2020-04-08,0,0,10,1,SR
2020-04-09,0,0,10,1,SR
2020-04-10,0,0,10,1,SR
2020-04-11,0,0,10,1,SR
2020-04-12,0,0,10,1,SR
2020-04-13,0,0,10,1,SR
2020-04-14,0,0,10,1,SR
2020-04-15,0,0,10,1,SR
2020-04-16,0,0,10,1,SR
2020-04-17,0,0,10,1,SR
2020-04-18,0,0,10,1,SR
2020-04-19,0,0,10,1,SR
2020-04-20,0,0,10,1,SR
2020-04-21,0,0,10,1,SR
2020-04-22,0,0,10,1,SR
2020-04-23,0,0,10,1,SR
2020-04-24,0,0,10,1,SR
2020-04-25,0,0,10,1,SR
2020-04-26,0,0,10,1,SR
2020-04-27,0,0,10,1,SR
2020-04-28,0,0,10,1,SR
2020-04-29,0,0,10,1,SR
2020-04-30,0,0,10,1,SR
2020-05-01,0,0,10,1,SR
2020-05-02,0,0,10,1,SR
2020-05-03,0,0,10,1,SR
2020-05-04,0,0,10,1,SR
2020-05-05,0,0,10,1,SR
2020-05-06,0,0,10,1,SR
2020-05-07,0,0,10,1,SR
2020-05-08,0,0,10,1,SR
2020-05-09,0,0,10,1,SR
2020-05-10,0,0,10,1,SR
2020-05-11,0,0,10,1,SR
2020-05-12,0,0,10,1,SR
2020-05-13,0,0,10,1,SR
2020-05-14,0,0,10,1,SR
2020-05-15,0,0,10,1,SR
2020-05-16,0,0,10,1,SR
2020-05-17,0,0,10,1,SR
2020-05-18,1,0,11,1,SR
2020-05-19,0,0,11,1,SR
2020-05-20,0,0,11,1,SR
2020-05-21,0,0,11,1,SR
2020-05-22,0,0,11,1,SR
2020-05-23,0,0,11,1,SR
2020-05-24,0,0,11,1,SR
2020-05-25,0,0,11,1,SR
2020-05-26,0,0,11,1,SR
2020-05-27,1,0,12,1,SR
2020-05-28,0,0,12,1,SR
2020-05-29,0,0,12,1,SR
2020-05-30,2,0,14,1,SR
2020-05-31,9,0,23,1,SR
2020-06-01,21,0,44,1,SR
2020-06-02,10,0,54,1,SR
2020-06-03,20,0,74,1,SR
2020-06-04,8,0,82,1,SR
2020-06-05,9,0,91,1,SR
2020-06-06,9,0,100,1,SR
2020-06-07,22,0,122,1,SR
2020-06-08,8,1,130,2,SR
2020-06-09,7,0,137,2,SR
2020-06-10,0,0,137,2,SR
2020-06-11,31,0,168,2,SR
2020-06-12,19,1,187,3,SR
2020-06-13,9,0,196,3,SR
2020-06-14,12,0,208,3,SR
2020-06-15,21,2,229,5,SR
2020-06-16,7,1,236,6,SR
2020-06-17,25,0,261,6,SR
2020-06-18,16,1,277,7,SR
2020-06-19,16,1,293,8,SR
2020-06-20,9,0,302,8,SR
2020-06-21,12,0,314,8,SR
2020-06-22,5,0,319,8,SR
2020-06-23,0,1,319,9,SR
2020-06-24,38,1,357,10,SR
2020-06-25,16,0,373,10,SR
2020-06-26,18,0,391,10,SR
2020-04-05,1,0,1,0,SS
2020-04-06,0,0,1,0,SS
2020-04-07,0,0,1,0,SS
2020-04-08,1,0,2,0,SS
2020-04-09,0,0,2,0,SS
2020-04-10,1,0,3,0,SS
2020-04-11,1,0,4,0,SS
2020-04-12,0,0,4,0,SS
2020-04-13,0,0,4,0,SS
2020-04-14,0,0,4,0,SS
2020-04-15,0,0,4,0,SS
2020-04-16,0,0,4,0,SS
2020-04-17,0,0,4,0,SS
2020-04-18,0,0,4,0,SS
2020-04-19,0,0,4,0,SS
2020-04-20,0,0,4,0,SS
2020-04-21,0,0,4,0,SS
2020-04-22,0,0,4,0,SS
2020-04-23,0,0,4,0,SS
2020-04-24,1,0,5,0,SS
2020-04-25,0,0,5,0,SS
2020-04-26,1,0,6,0,SS
2020-04-27,0,0,6,0,SS
2020-04-28,28,0,34,0,SS
2020-04-29,0,0,34,0,SS
2020-04-30,1,0,35,0,SS
2020-05-01,10,0,45,0,SS
2020-05-02,0,0,45,0,SS
2020-05-03,1,0,46,0,SS
2020-05-04,0,0,46,0,SS
2020-05-05,6,0,52,0,SS
2020-05-06,22,0,74,0,SS
2020-05-07,16,0,90,0,SS
2020-05-08,30,0,120,0,SS
2020-05-09,23,0,143,0,SS
2020-05-10,13,0,156,0,SS
2020-05-11,0,0,156,0,SS
2020-05-12,38,0,194,0,SS
2020-05-13,9,0,203,0,SS
2020-05-14,28,1,231,1,SS
2020-05-15,5,3,236,4,SS
2020-05-16,0,0,236,4,SS
2020-05-17,46,0,282,4,SS
2020-05-18,0,0,282,4,SS
2020-05-19,3,2,285,6,SS
2020-05-20,0,0,285,6,SS
2020-05-21,54,0,339,6,SS
2020-05-22,0,0,339,6,SS
2020-05-23,224,0,563,6,SS
2020-05-24,0,0,563,6,SS
2020-05-25,92,2,655,8,SS
2020-05-26,151,0,806,8,SS
2020-05-27,0,0,806,8,SS
2020-05-28,0,0,806,8,SS
2020-05-29,188,2,994,10,SS
2020-05-30,0,0,994,10,SS
2020-05-31,0,0,994,10,SS
2020-06-01,0,0,994,10,SS
2020-06-02,0,0,994,10,SS
2020-06-03,0,0,994,10,SS
2020-06-04,323,4,1317,14,SS
2020-06-05,0,0,1317,14,SS
2020-06-06,0,0,1317,14,SS
2020-06-07,0,0,1317,14,SS
2020-06-08,287,5,1604,19,SS
2020-06-09,0,0,1604,19,SS
2020-06-10,0,0,1604,19,SS
2020-06-11,0,0,1604,19,SS
2020-06-12,66,3,1670,22,SS
2020-06-13,23,5,1693,27,SS
2020-06-14,0,0,1693,27,SS
2020-06-15,62,3,1755,30,SS
2020-06-16,21,0,1776,30,SS
2020-06-17,31,1,1807,31,SS
2020-06-18,6,0,1813,31,SS
2020-06-19,0,0,1813,31,SS
2020-06-20,51,3,1864,34,SS
2020-06-21,18,0,1882,34,SS
2020-06-22,10,0,1892,34,SS
2020-06-23,24,1,1916,35,SS
2020-06-24,14,1,1930,36,SS
2020-06-25,12,0,1942,36,SS
2020-06-26,10,0,1952,36,SS
2020-04-08,4,0,4,0,ST
2020-04-09,0,0,4,0,ST
2020-04-10,0,0,4,0,ST
2020-04-11,0,0,4,0,ST
2020-04-12,0,0,4,0,ST
2020-04-13,0,0,4,0,ST
2020-04-14,0,0,4,0,ST
2020-04-15,0,0,4,0,ST
2020-04-16,0,0,4,0,ST
2020-04-17,0,0,4,0,ST
2020-04-18,0,0,4,0,ST
2020-04-19,0,0,4,0,ST
2020-04-20,0,0,4,0,ST
2020-04-21,0,0,4,0,ST
2020-04-22,3,0,7,0,ST
2020-04-23,1,0,8,0,ST
2020-04-24,0,0,8,0,ST
2020-04-25,0,0,8,0,ST
2020-04-26,0,0,8,0,ST
2020-04-27,0,0,8,0,ST
2020-04-28,3,0,11,0,ST
2020-04-29,3,0,14,0,ST
2020-04-30,2,1,16,1,ST
2020-05-01,2,0,18,1,ST
2020-05-02,0,0,18,1,ST
2020-05-03,0,0,18,1,ST
2020-05-04,156,2,174,3,ST
2020-05-05,0,0,174,3,ST
2020-05-06,0,0,174,3,ST
2020-05-07,13,1,187,4,ST
2020-05-08,21,1,208,5,ST
2020-05-09,0,0,208,5,ST
2020-05-10,0,0,208,5,ST
2020-05-11,4,0,212,5,ST
2020-05-12,8,1,220,6,ST
2020-05-13,15,1,235,7,ST
2020-05-14,0,0,235,7,ST
2020-05-15,0,0,235,7,ST
2020-05-16,0,0,235,7,ST
2020-05-17,0,0,235,7,ST
2020-05-18,11,0,246,7,ST
2020-05-19,5,1,251,8,ST
2020-05-20,0,0,251,8,ST
2020-05-21,0,0,251,8,ST
2020-05-22,0,0,251,8,ST
2020-05-23,40,0,291,8,ST
2020-05-24,8,1,299,9,ST
2020-05-25,0,2,299,11,ST
2020-05-26,142,1,441,12,ST
2020-05-27,2,0,443,12,ST
2020-05-28,15,0,458,12,ST
2020-05-29,5,0,463,12,ST
2020-05-30,16,0,479,12,ST
2020-05-31,4,0,483,12,ST
2020-06-01,1,0,484,12,ST
2020-06-02,0,0,484,12,ST
2020-06-03,0,0,484,12,ST
2020-06-04,15,0,499,12,ST
2020-06-05,10,0,509,12,ST
2020-06-06,4,0,513,12,ST
2020-06-07,1,0,514,12,ST
2020-06-08,0,0,514,12,ST
2020-06-09,0,0,514,12,ST
2020-06-10,118,0,632,12,ST
2020-06-11,7,0,639,12,ST
2020-06-12,11,0,650,12,ST
2020-06-13,9,0,659,12,ST
2020-06-14,2,0,661,12,ST
2020-06-15,0,0,661,12,ST
2020-06-16,10,0,671,12,ST
2020-06-17,12,0,683,12,ST
2020-06-18,5,0,688,12,ST
2020-06-19,5,0,693,12,ST
2020-06-20,5,0,698,12,ST
2020-06-21,0,0,698,12,ST
2020-06-22,4,0,702,12,ST
2020-06-23,5,0,707,12,ST
2020-06-24,3,1,710,13,ST
2020-06-25,1,0,711,13,ST
2020-06-26,1,0,712,13,ST
2020-03-18,1,0,1,0,SV
2020-03-19,0,0,1,0,SV
2020-03-20,2,0,3,0,SV
2020-03-21,0,0,3,0,SV
2020-03-22,0,0,3,0,SV
2020-03-23,2,0,5,0,SV
2020-03-24,4,0,9,0,SV
2020-03-25,4,0,13,0,SV
2020-03-26,0,0,13,0,SV
2020-03-27,0,0,13,0,SV
2020-03-28,6,0,19,0,SV
2020-03-29,11,0,30,0,SV
2020-03-30,2,0,32,0,SV
2020-03-31,0,1,32,1,SV
2020-04-01,9,1,41,2,SV
2020-04-02,5,0,46,2,SV
2020-04-03,10,1,56,3,SV
2020-04-04,6,0,62,3,SV
2020-04-05,7,0,69,3,SV
2020-04-06,9,1,78,4,SV
2020-04-07,0,0,78,4,SV
2020-04-08,25,1,103,5,SV
2020-04-09,14,1,117,6,SV
2020-04-10,1,0,118,6,SV
2020-04-11,0,0,118,6,SV
2020-04-12,7,0,125,6,SV
2020-04-13,24,0,149,6,SV
2020-04-14,10,0,159,6,SV
2020-04-15,0,0,159,6,SV
2020-04-16,5,0,164,6,SV
2020-04-17,13,1,177,7,SV
2020-04-18,13,0,190,7,SV
2020-04-19,11,0,201,7,SV
2020-04-20,17,0,218,7,SV
2020-04-21,7,0,225,7,SV
2020-04-22,12,1,237,8,SV
2020-04-23,13,0,250,8,SV
2020-04-24,11,0,261,8,SV
2020-04-25,37,0,298,8,SV
2020-04-26,0,0,298,8,SV
2020-04-27,25,0,323,8,SV
2020-04-28,22,1,345,9,SV
2020-04-29,32,0,377,9,SV
2020-04-30,47,1,424,10,SV
2020-05-01,22,0,446,10,SV
2020-05-02,0,1,446,11,SV
2020-05-03,109,1,555,12,SV
2020-05-04,32,1,587,13,SV
2020-05-05,0,1,587,14,SV
2020-05-06,108,1,695,15,SV
2020-05-07,0,0,695,15,SV
2020-05-08,89,1,784,16,SV
2020-05-09,105,1,889,17,SV
2020-05-10,69,0,958,17,SV
2020-05-11,40,1,998,18,SV
2020-05-12,39,2,1037,20,SV
2020-05-13,75,0,1112,20,SV
2020-05-14,98,3,1210,23,SV
2020-05-15,55,2,1265,25,SV
2020-05-16,0,1,1265,26,SV
2020-05-17,73,4,1338,30,SV
2020-05-18,75,0,1413,30,SV
2020-05-19,85,1,1498,31,SV
2020-05-20,73,1,1571,32,SV
2020-05-21,69,1,1640,33,SV
2020-05-22,85,0,1725,33,SV
2020-05-23,94,2,1819,35,SV
2020-05-24,96,0,1915,35,SV
2020-05-25,68,1,1983,36,SV
2020-05-26,59,0,2042,36,SV
2020-05-27,67,3,2109,39,SV
2020-05-28,85,0,2194,39,SV
2020-05-29,84,4,2278,43,SV
2020-05-30,239,3,2517,46,SV
2020-05-31,0,0,2517,46,SV
2020-06-01,65,0,2582,46,SV
2020-06-02,71,3,2653,49,SV
2020-06-03,52,2,2705,51,SV
2020-06-04,76,1,2781,52,SV
2020-06-05,68,1,2849,53,SV
2020-06-06,85,0,2934,53,SV
2020-06-07,81,2,3015,55,SV
2020-06-08,89,3,3104,58,SV
2020-06-09,87,2,3191,60,SV
2020-06-10,83,4,3274,64,SV
2020-06-11,207,4,3481,68,SV
2020-06-12,0,4,3481,72,SV
2020-06-13,122,0,3603,72,SV
2020-06-14,117,2,3720,74,SV
2020-06-15,106,2,3826,76,SV
2020-06-16,115,2,3941,78,SV
2020-06-17,125,4,4066,82,SV
2020-06-18,134,4,4200,86,SV
2020-06-19,129,7,4329,93,SV
2020-06-20,297,5,4626,98,SV
2020-06-21,0,9,4626,107,SV
2020-06-22,182,0,4808,107,SV
2020-06-23,165,6,4973,113,SV
2020-06-24,177,13,5150,126,SV
2020-06-25,186,7,5336,133,SV
2020-06-26,181,10,5517,143,SV
2020-03-02,1,0,1,0,SX
2020-03-25,1,0,2,0,SX
2020-03-26,0,0,2,0,SX
2020-03-27,1,0,3,0,SX
2020-03-28,0,0,3,0,SX
2020-03-29,0,0,3,0,SX
2020-03-31,3,0,6,0,SX
2020-04-01,10,1,16,1,SX
2020-04-02,7,1,23,2,SX
2020-04-03,0,0,23,2,SX
2020-04-04,0,0,23,2,SX
2020-04-05,2,2,25,4,SX
2020-04-06,0,0,25,4,SX
2020-04-07,15,4,40,8,SX
2020-04-08,0,0,40,8,SX
2020-04-09,10,0,50,8,SX
2020-04-10,0,1,50,9,SX
2020-04-11,0,0,50,9,SX
2020-04-12,0,0,50,9,SX
2020-04-13,2,0,52,9,SX
2020-04-14,0,0,52,9,SX
2020-04-15,5,0,57,9,SX
2020-04-16,0,0,57,9,SX
2020-04-17,0,0,57,9,SX
2020-04-18,7,0,64,9,SX
2020-04-19,3,1,67,10,SX
2020-04-20,1,0,68,10,SX
2020-04-21,0,0,68,10,SX
2020-04-22,5,2,73,12,SX
2020-04-23,0,0,73,12,SX
2020-04-24,0,0,73,12,SX
2020-04-25,0,0,73,12,SX
2020-04-26,1,1,74,13,SX
2020-04-27,1,0,75,13,SX
2020-04-28,0,0,75,13,SX
2020-04-29,1,0,76,13,SX
2020-04-30,0,0,76,13,SX
2020-05-01,0,0,76,13,SX
2020-05-02,0,0,76,13,SX
2020-05-03,0,0,76,13,SX
2020-05-04,0,0,76,13,SX
2020-05-05,0,1,76,14,SX
2020-05-06,0,0,76,14,SX
2020-05-07,0,0,76,14,SX
2020-05-08,0,1,76,15,SX
2020-05-09,0,0,76,15,SX
2020-05-10,0,0,76,15,SX
2020-05-11,0,0,76,15,SX
2020-05-12,1,0,77,15,SX
2020-05-13,0,0,77,15,SX
2020-05-14,0,0,77,15,SX
2020-05-15,0,0,77,15,SX
2020-05-16,0,0,77,15,SX
2020-05-17,0,0,77,15,SX
2020-05-18,0,0,77,15,SX
2020-05-19,0,0,77,15,SX
2020-05-20,0,0,77,15,SX
2020-05-21,0,0,77,15,SX
2020-05-22,0,0,77,15,SX
2020-05-23,0,0,77,15,SX
2020-05-24,0,0,77,15,SX
2020-05-25,0,0,77,15,SX
2020-05-26,0,0,77,15,SX
2020-05-27,0,0,77,15,SX
2020-05-28,0,0,77,15,SX
2020-05-29,0,0,77,15,SX
2020-05-30,0,0,77,15,SX
2020-05-31,0,0,77,15,SX
2020-06-01,0,0,77,15,SX
2020-06-02,0,0,77,15,SX
2020-06-03,0,0,77,15,SX
2020-06-04,0,0,77,15,SX
2020-06-05,0,0,77,15,SX
2020-06-06,0,0,77,15,SX
2020-06-07,0,0,77,15,SX
2020-06-08,0,0,77,15,SX
2020-06-09,0,0,77,15,SX
2020-06-10,0,0,77,15,SX
2020-06-11,0,0,77,15,SX
2020-06-12,0,0,77,15,SX
2020-06-13,0,0,77,15,SX
2020-06-14,0,0,77,15,SX
2020-06-15,0,0,77,15,SX
2020-06-16,0,0,77,15,SX
2020-06-17,0,0,77,15,SX
2020-06-18,0,0,77,15,SX
2020-06-19,0,0,77,15,SX
2020-06-20,0,0,77,15,SX
2020-06-21,0,0,77,15,SX
2020-06-22,0,0,77,15,SX
2020-06-23,0,0,77,15,SX
2020-06-24,0,0,77,15,SX
2020-06-25,0,0,77,15,SX
2020-06-26,0,0,77,15,SX
2020-03-22,1,0,1,0,SY
2020-03-23,0,0,1,0,SY
2020-03-24,0,0,1,0,SY
2020-03-25,0,0,1,0,SY
2020-03-26,4,0,5,0,SY
2020-03-27,0,0,5,0,SY
2020-03-28,0,0,5,0,SY
2020-03-29,4,1,9,1,SY
2020-03-30,1,1,10,2,SY
2020-03-31,0,0,10,2,SY
2020-04-01,0,0,10,2,SY
2020-04-02,6,0,16,2,SY
2020-04-03,0,0,16,2,SY
2020-04-04,0,0,16,2,SY
2020-04-05,3,0,19,2,SY
2020-04-06,0,0,19,2,SY
2020-04-07,0,0,19,2,SY
2020-04-08,0,0,19,2,SY
2020-04-09,0,0,19,2,SY
2020-04-10,0,0,19,2,SY
2020-04-11,6,0,25,2,SY
2020-04-12,0,0,25,2,SY
2020-04-13,0,0,25,2,SY
2020-04-14,4,0,29,2,SY
2020-04-15,4,0,33,2,SY
2020-04-16,0,0,33,2,SY
2020-04-17,5,0,38,2,SY
2020-04-18,0,0,38,2,SY
2020-04-19,1,1,39,3,SY
2020-04-20,0,0,39,3,SY
2020-04-21,3,0,42,3,SY
2020-04-22,0,0,42,3,SY
2020-04-23,0,0,42,3,SY
2020-04-24,0,0,42,3,SY
2020-04-25,0,0,42,3,SY
2020-04-26,1,0,43,3,SY
2020-04-27,0,0,43,3,SY
2020-04-28,0,0,43,3,SY
2020-04-29,0,0,43,3,SY
2020-04-30,0,0,43,3,SY
2020-05-01,1,0,44,3,SY
2020-05-02,0,0,44,3,SY
2020-05-03,0,0,44,3,SY
2020-05-04,0,0,44,3,SY
2020-05-05,0,0,44,3,SY
2020-05-06,1,0,45,3,SY
2020-05-07,0,0,45,3,SY
2020-05-08,2,0,47,3,SY
2020-05-09,0,0,47,3,SY
2020-05-10,0,0,47,3,SY
2020-05-11,0,0,47,3,SY
2020-05-12,0,0,47,3,SY
2020-05-13,1,0,48,3,SY
2020-05-14,0,0,48,3,SY
2020-05-15,2,0,50,3,SY
2020-05-16,1,0,51,3,SY
2020-05-17,7,0,58,3,SY
2020-05-18,0,0,58,3,SY
2020-05-19,0,0,58,3,SY
2020-05-20,0,0,58,3,SY
2020-05-21,0,0,58,3,SY
2020-05-22,1,1,59,4,SY
2020-05-23,11,0,70,4,SY
2020-05-24,16,0,86,4,SY
2020-05-25,20,0,106,4,SY
2020-05-26,15,0,121,4,SY
2020-05-27,0,0,121,4,SY
2020-05-28,0,0,121,4,SY
2020-05-29,1,0,122,4,SY
2020-05-30,0,0,122,4,SY
2020-05-31,0,0,122,4,SY
2020-06-01,1,1,123,5,SY
2020-06-02,0,1,123,6,SY
2020-06-03,0,0,123,6,SY
2020-06-04,1,0,124,6,SY
2020-06-05,0,0,124,6,SY
2020-06-06,0,0,124,6,SY
2020-06-07,17,0,141,6,SY
2020-06-08,3,0,144,6,SY
2020-06-09,2,0,146,6,SY
2020-06-10,6,0,152,6,SY
2020-06-11,12,0,164,6,SY
2020-06-12,0,0,164,6,SY
2020-06-13,6,0,170,6,SY
2020-06-14,7,0,177,6,SY
2020-06-15,0,0,177,6,SY
2020-06-16,0,0,177,6,SY
2020-06-17,1,1,178,7,SY
2020-06-18,9,0,187,7,SY
2020-06-19,0,0,187,7,SY
2020-06-20,11,0,198,7,SY
2020-06-21,6,0,204,7,SY
2020-06-22,15,0,219,7,SY
2020-06-23,12,0,231,7,SY
2020-06-24,0,0,231,7,SY
2020-06-25,11,0,242,7,SY
2020-06-26,13,1,255,8,SY
2020-03-14,1,0,1,0,SZ
2020-03-15,0,0,1,0,SZ
2020-03-16,0,0,1,0,SZ
2020-03-17,0,0,1,0,SZ
2020-03-18,0,0,1,0,SZ
2020-03-19,0,0,1,0,SZ
2020-03-20,0,0,1,0,SZ
2020-03-21,0,0,1,0,SZ
2020-03-22,3,0,4,0,SZ
2020-03-23,0,0,4,0,SZ
2020-03-24,0,0,4,0,SZ
2020-03-25,0,0,4,0,SZ
2020-03-26,2,0,6,0,SZ
2020-03-27,3,0,9,0,SZ
2020-03-28,0,0,9,0,SZ
2020-03-29,0,0,9,0,SZ
2020-03-30,0,0,9,0,SZ
2020-03-31,0,0,9,0,SZ
2020-04-01,0,0,9,0,SZ
2020-04-02,0,0,9,0,SZ
2020-04-03,0,0,9,0,SZ
2020-04-04,0,0,9,0,SZ
2020-04-05,0,0,9,0,SZ
2020-04-06,1,0,10,0,SZ
2020-04-07,0,0,10,0,SZ
2020-04-08,2,0,12,0,SZ
2020-04-09,0,0,12,0,SZ
2020-04-10,0,0,12,0,SZ
2020-04-11,2,0,14,0,SZ
2020-04-12,0,0,14,0,SZ
2020-04-13,1,0,15,0,SZ
2020-04-14,0,0,15,0,SZ
2020-04-15,1,0,16,0,SZ
2020-04-16,0,0,16,0,SZ
2020-04-17,3,1,19,1,SZ
2020-04-18,0,0,19,1,SZ
2020-04-19,3,0,22,1,SZ
2020-04-20,2,0,24,1,SZ
2020-04-21,0,0,24,1,SZ
2020-04-22,7,0,31,1,SZ
2020-04-23,1,0,32,1,SZ
2020-04-24,8,0,40,1,SZ
2020-04-25,0,0,40,1,SZ
2020-04-26,19,0,59,1,SZ
2020-04-27,6,0,65,1,SZ
2020-04-28,6,0,71,1,SZ
2020-04-29,20,0,91,1,SZ
2020-04-30,9,0,100,1,SZ
2020-05-01,6,0,106,1,SZ
2020-05-02,2,0,108,1,SZ
2020-05-03,4,0,112,1,SZ
2020-05-04,4,0,116,1,SZ
2020-05-05,0,0,116,1,SZ
2020-05-06,7,1,123,2,SZ
2020-05-07,30,0,153,2,SZ
2020-05-08,6,0,159,2,SZ
2020-05-09,4,0,163,2,SZ
2020-05-10,9,0,172,2,SZ
2020-05-11,3,0,175,2,SZ
2020-05-12,9,0,184,2,SZ
2020-05-13,3,0,187,2,SZ
2020-05-14,0,0,187,2,SZ
2020-05-15,3,0,190,2,SZ
2020-05-16,12,0,202,2,SZ
2020-05-17,1,0,203,2,SZ
2020-05-18,0,0,203,2,SZ
2020-05-19,5,0,208,2,SZ
2020-05-20,9,0,217,2,SZ
2020-05-21,3,0,220,2,SZ
2020-05-22,0,0,220,2,SZ
2020-05-23,18,0,238,2,SZ
2020-05-24,12,0,250,2,SZ
2020-05-25,6,0,256,2,SZ
2020-05-26,5,0,261,2,SZ
2020-05-27,11,0,272,2,SZ
2020-05-28,7,0,279,2,SZ
2020-05-29,0,0,279,2,SZ
2020-05-30,4,0,283,2,SZ
2020-05-31,2,0,285,2,SZ
2020-06-01,8,1,293,3,SZ
2020-06-02,0,0,293,3,SZ
2020-06-03,2,0,295,3,SZ
2020-06-04,5,0,300,3,SZ
2020-06-05,5,0,305,3,SZ
2020-06-06,17,0,322,3,SZ
2020-06-07,11,0,333,3,SZ
2020-06-08,7,0,340,3,SZ
2020-06-09,31,0,371,3,SZ
2020-06-10,27,0,398,3,SZ
2020-06-11,51,0,449,3,SZ
2020-06-12,23,0,472,3,SZ
2020-06-13,14,0,486,3,SZ
2020-06-14,4,1,490,4,SZ
2020-06-15,16,0,506,4,SZ
2020-06-16,14,0,520,4,SZ
2020-06-17,43,0,563,4,SZ
2020-06-18,23,0,586,4,SZ
2020-06-19,37,0,623,4,SZ
2020-06-20,4,1,627,5,SZ
2020-06-21,8,0,635,5,SZ
2020-06-22,8,1,643,6,SZ
2020-06-23,31,1,674,7,SZ
2020-06-24,16,0,690,7,SZ
2020-06-25,16,1,706,8,SZ
2020-06-26,22,0,728,8,SZ
2020-03-24,1,0,1,0,TC
2020-03-25,0,0,1,0,TC
2020-03-26,1,0,2,0,TC
2020-03-27,0,0,2,0,TC
2020-03-28,3,0,5,0,TC
2020-03-29,0,0,5,0,TC
2020-03-30,0,0,5,0,TC
2020-03-31,0,0,5,0,TC
2020-04-01,0,0,5,0,TC
2020-04-02,0,0,5,0,TC
2020-04-03,0,0,5,0,TC
2020-04-04,0,0,5,0,TC
2020-04-05,0,1,5,1,TC
2020-04-06,3,0,8,1,TC
2020-04-07,0,0,8,1,TC
2020-04-08,0,0,8,1,TC
2020-04-09,0,0,8,1,TC
2020-04-10,1,0,9,1,TC
2020-04-11,0,0,9,1,TC
2020-04-12,0,0,9,1,TC
2020-04-13,1,0,10,1,TC
2020-04-14,0,0,10,1,TC
2020-04-15,1,0,11,1,TC
2020-04-16,0,0,11,1,TC
2020-04-17,0,0,11,1,TC
2020-04-18,0,0,11,1,TC
2020-04-19,0,0,11,1,TC
2020-04-20,0,0,11,1,TC
2020-04-21,0,0,11,1,TC
2020-04-22,0,0,11,1,TC
2020-04-23,0,0,11,1,TC
2020-04-24,0,0,11,1,TC
2020-04-25,0,0,11,1,TC
2020-04-26,0,0,11,1,TC
2020-04-27,1,0,12,1,TC
2020-04-28,0,0,12,1,TC
2020-04-29,0,0,12,1,TC
2020-04-30,0,0,12,1,TC
2020-05-01,0,0,12,1,TC
2020-05-02,0,0,12,1,TC
2020-05-03,0,0,12,1,TC
2020-05-04,0,0,12,1,TC
2020-05-05,0,0,12,1,TC
2020-05-06,0,0,12,1,TC
2020-05-07,0,0,12,1,TC
2020-05-08,0,0,12,1,TC
2020-05-09,0,0,12,1,TC
2020-05-10,0,0,12,1,TC
2020-05-11,0,0,12,1,TC
2020-05-12,0,0,12,1,TC
2020-05-13,0,0,12,1,TC
2020-05-14,0,0,12,1,TC
2020-05-15,0,0,12,1,TC
2020-05-16,0,0,12,1,TC
2020-05-17,0,0,12,1,TC
2020-05-18,0,0,12,1,TC
2020-05-19,0,0,12,1,TC
2020-05-20,0,0,12,1,TC
2020-05-21,0,0,12,1,TC
2020-05-22,0,0,12,1,TC
2020-05-23,0,0,12,1,TC
2020-05-24,0,0,12,1,TC
2020-05-25,0,0,12,1,TC
2020-05-26,0,0,12,1,TC
2020-05-27,0,0,12,1,TC
2020-05-28,0,0,12,1,TC
2020-05-29,0,0,12,1,TC
2020-05-30,0,0,12,1,TC
2020-05-31,0,0,12,1,TC
2020-06-01,0,0,12,1,TC
2020-06-02,0,0,12,1,TC
2020-06-03,0,0,12,1,TC
2020-06-04,0,0,12,1,TC
2020-06-05,0,0,12,1,TC
2020-06-06,0,0,12,1,TC
2020-06-07,0,0,12,1,TC
2020-06-08,0,0,12,1,TC
2020-06-09,0,0,12,1,TC
2020-06-10,0,0,12,1,TC
2020-06-11,0,0,12,1,TC
2020-06-12,0,0,12,1,TC
2020-06-13,0,0,12,1,TC
2020-06-14,0,0,12,1,TC
2020-06-15,0,0,12,1,TC
2020-06-16,0,0,12,1,TC
2020-06-17,0,0,12,1,TC
2020-06-18,0,0,12,1,TC
2020-06-19,0,0,12,1,TC
2020-06-20,0,0,12,1,TC
2020-06-21,2,0,14,1,TC
2020-06-22,0,0,14,1,TC
2020-06-23,0,0,14,1,TC
2020-06-24,1,0,15,1,TC
2020-06-25,0,0,15,1,TC
2020-06-26,0,0,15,1,TC
2020-03-19,1,0,1,0,TD
2020-03-20,0,0,1,0,TD
2020-03-21,1,0,2,0,TD
2020-03-22,0,0,2,0,TD
2020-03-23,0,0,2,0,TD
2020-03-24,1,0,3,0,TD
2020-03-25,0,0,3,0,TD
2020-03-26,2,0,5,0,TD
2020-03-27,0,0,5,0,TD
2020-03-28,0,0,5,0,TD
2020-03-29,0,0,5,0,TD
2020-03-30,2,0,7,0,TD
2020-03-31,0,0,7,0,TD
2020-04-01,0,0,7,0,TD
2020-04-02,0,0,7,0,TD
2020-04-03,0,0,7,0,TD
2020-04-04,1,0,8,0,TD
2020-04-05,1,0,9,0,TD
2020-04-06,0,0,9,0,TD
2020-04-07,0,0,9,0,TD
2020-04-08,1,0,10,0,TD
2020-04-09,1,0,11,0,TD
2020-04-10,0,0,11,0,TD
2020-04-11,0,0,11,0,TD
2020-04-12,4,0,15,0,TD
2020-04-13,8,0,23,0,TD
2020-04-14,0,0,23,0,TD
2020-04-15,4,0,27,0,TD
2020-04-16,0,0,27,0,TD
2020-04-17,6,0,33,0,TD
2020-04-18,0,0,33,0,TD
2020-04-19,0,0,33,0,TD
2020-04-20,0,0,33,0,TD
2020-04-21,1,0,34,0,TD
2020-04-22,0,0,34,0,TD
2020-04-23,6,0,40,0,TD
2020-04-24,0,0,40,0,TD
2020-04-25,0,0,40,0,TD
2020-04-26,6,0,46,0,TD
2020-04-27,0,0,46,0,TD
2020-04-28,6,2,52,2,TD
2020-04-29,0,0,52,2,TD
2020-04-30,21,3,73,5,TD
2020-05-01,0,0,73,5,TD
2020-05-02,44,5,117,10,TD
2020-05-03,0,0,117,10,TD
2020-05-04,0,0,117,10,TD
2020-05-05,53,7,170,17,TD
2020-05-06,0,0,170,17,TD
2020-05-07,83,10,253,27,TD
2020-05-08,7,1,260,28,TD
2020-05-09,62,3,322,31,TD
2020-05-10,0,0,322,31,TD
2020-05-11,0,0,322,31,TD
2020-05-12,35,9,357,40,TD
2020-05-13,15,2,372,42,TD
2020-05-14,27,4,399,46,TD
2020-05-15,29,2,428,48,TD
2020-05-16,46,2,474,50,TD
2020-05-17,29,3,503,53,TD
2020-05-18,16,0,519,53,TD
2020-05-19,26,3,545,56,TD
2020-05-20,20,1,565,57,TD
2020-05-21,23,1,588,58,TD
2020-05-22,23,1,611,59,TD
2020-05-23,37,1,648,60,TD
2020-05-24,27,0,675,60,TD
2020-05-25,12,1,687,61,TD
2020-05-26,13,1,700,62,TD
2020-05-27,15,2,715,64,TD
2020-05-28,11,1,726,65,TD
2020-05-29,33,0,759,65,TD
2020-05-30,0,0,759,65,TD
2020-05-31,19,0,778,65,TD
2020-06-01,12,1,790,66,TD
2020-06-02,13,0,803,66,TD
2020-06-03,17,0,820,66,TD
2020-06-04,8,0,828,66,TD
2020-06-05,8,2,836,68,TD
2020-06-06,0,1,836,69,TD
2020-06-07,1,0,837,69,TD
2020-06-08,2,1,839,70,TD
2020-06-09,5,1,844,71,TD
2020-06-10,2,1,846,72,TD
2020-06-11,2,0,848,72,TD
2020-06-12,0,0,848,72,TD
2020-06-13,0,0,848,72,TD
2020-06-14,2,1,850,73,TD
2020-06-15,0,0,850,73,TD
2020-06-16,3,1,853,74,TD
2020-06-17,1,0,854,74,TD
2020-06-18,0,0,854,74,TD
2020-06-19,4,0,858,74,TD
2020-06-20,0,0,858,74,TD
2020-06-21,0,0,858,74,TD
2020-06-22,0,0,858,74,TD
2020-06-23,2,0,860,74,TD
2020-06-24,0,0,860,74,TD
2020-06-25,3,0,863,74,TD
2020-06-26,2,0,865,74,TD
2020-03-06,1,0,1,0,TG
2020-03-14,0,0,1,0,TG
2020-03-15,0,0,1,0,TG
2020-03-16,0,0,1,0,TG
2020-03-17,0,0,1,0,TG
2020-03-18,0,0,1,0,TG
2020-03-19,0,0,1,0,TG
2020-03-20,8,0,9,0,TG
2020-03-21,6,0,15,0,TG
2020-03-22,0,0,15,0,TG
2020-03-23,3,0,18,0,TG
2020-03-24,0,0,18,0,TG
2020-03-25,5,0,23,0,TG
2020-03-26,1,0,24,0,TG
2020-03-27,1,1,25,1,TG
2020-03-28,3,0,28,1,TG
2020-03-29,2,0,30,1,TG
2020-03-30,4,0,34,1,TG
2020-03-31,0,0,34,1,TG
2020-04-01,2,1,36,2,TG
2020-04-02,3,0,39,2,TG
2020-04-03,1,1,40,3,TG
2020-04-04,1,0,41,3,TG
2020-04-05,3,0,44,3,TG
2020-04-06,14,0,58,3,TG
2020-04-07,7,0,65,3,TG
2020-04-08,5,0,70,3,TG
2020-04-09,3,0,73,3,TG
2020-04-10,3,0,76,3,TG
2020-04-11,0,0,76,3,TG
2020-04-12,0,0,76,3,TG
2020-04-13,1,0,77,3,TG
2020-04-14,0,0,77,3,TG
2020-04-15,4,0,81,3,TG
2020-04-16,0,2,81,5,TG
2020-04-17,2,0,83,5,TG
2020-04-18,1,0,84,5,TG
2020-04-19,0,0,84,5,TG
2020-04-20,0,1,84,6,TG
2020-04-21,2,0,86,6,TG
2020-04-22,2,0,88,6,TG
2020-04-23,0,0,88,6,TG
2020-04-24,2,0,90,6,TG
2020-04-25,6,0,96,6,TG
2020-04-26,2,0,98,6,TG
2020-04-27,1,0,99,6,TG
2020-04-28,0,0,99,6,TG
2020-04-29,10,1,109,7,TG
2020-04-30,7,2,116,9,TG
2020-05-01,7,0,123,9,TG
2020-05-02,0,0,123,9,TG
2020-05-03,1,0,124,9,TG
2020-05-04,2,0,126,9,TG
2020-05-05,2,0,128,9,TG
2020-05-06,0,0,128,9,TG
2020-05-07,7,0,135,9,TG
2020-05-08,10,1,145,10,TG
2020-05-09,8,0,153,10,TG
2020-05-10,21,1,174,11,TG
2020-05-11,7,0,181,11,TG
2020-05-12,18,0,199,11,TG
2020-05-13,20,0,219,11,TG
2020-05-14,19,0,238,11,TG
2020-05-15,25,0,263,11,TG
2020-05-16,35,0,298,11,TG
2020-05-17,3,0,301,11,TG
2020-05-18,29,1,330,12,TG
2020-05-19,8,0,338,12,TG
2020-05-20,2,0,340,12,TG
2020-05-21,14,0,354,12,TG
2020-05-22,9,0,363,12,TG
2020-05-23,10,0,373,12,TG
2020-05-24,8,0,381,12,TG
2020-05-25,5,1,386,13,TG
2020-05-26,5,0,391,13,TG
2020-05-27,4,0,395,13,TG
2020-05-28,27,0,422,13,TG
2020-05-29,6,0,428,13,TG
2020-05-30,5,0,433,13,TG
2020-05-31,9,0,442,13,TG
2020-06-01,1,0,443,13,TG
2020-06-02,2,0,445,13,TG
2020-06-03,7,0,452,13,TG
2020-06-04,13,0,465,13,TG
2020-06-05,20,0,485,13,TG
2020-06-06,2,0,487,13,TG
2020-06-07,8,0,495,13,TG
2020-06-08,2,0,497,13,TG
2020-06-09,4,0,501,13,TG
2020-06-10,21,0,522,13,TG
2020-06-11,2,0,524,13,TG
2020-06-12,1,0,525,13,TG
2020-06-13,5,0,530,13,TG
2020-06-14,1,0,531,13,TG
2020-06-15,1,0,532,13,TG
2020-06-16,5,0,537,13,TG
2020-06-17,7,0,544,13,TG
2020-06-18,3,0,547,13,TG
2020-06-19,8,0,555,13,TG
2020-06-20,6,0,561,13,TG
2020-06-21,8,0,569,13,TG
2020-06-22,0,0,569,13,TG
2020-06-23,7,0,576,13,TG
2020-06-24,7,1,583,14,TG
2020-06-25,5,0,588,14,TG
2020-06-26,3,0,591,14,TG
2019-12-30,0,0,0,0,TH
2019-12-31,0,0,0,0,TH
2020-01-01,0,0,0,0,TH
2020-01-02,0,0,0,0,TH
2020-01-03,0,0,0,0,TH
2020-01-04,0,0,0,0,TH
2020-01-05,0,0,0,0,TH
2020-01-06,0,0,0,0,TH
2020-01-07,0,0,0,0,TH
2020-01-08,0,0,0,0,TH
2020-01-09,0,0,0,0,TH
2020-01-10,0,0,0,0,TH
2020-01-11,0,0,0,0,TH
2020-01-12,1,0,1,0,TH
2020-01-13,0,0,1,0,TH
2020-01-14,0,0,1,0,TH
2020-01-15,0,0,1,0,TH
2020-01-16,1,0,2,0,TH
2020-01-17,0,0,2,0,TH
2020-01-18,0,0,2,0,TH
2020-01-19,0,0,2,0,TH
2020-01-20,0,0,2,0,TH
2020-01-21,2,0,4,0,TH
2020-01-22,0,0,4,0,TH
2020-01-23,0,0,4,0,TH
2020-01-24,1,0,5,0,TH
2020-01-25,0,0,5,0,TH
2020-01-26,3,0,8,0,TH
2020-01-27,6,0,14,0,TH
2020-01-28,0,0,14,0,TH
2020-01-29,0,0,14,0,TH
2020-01-30,0,0,14,0,TH
2020-01-31,5,0,19,0,TH
2020-02-01,0,0,19,0,TH
2020-02-02,0,0,19,0,TH
2020-02-03,0,0,19,0,TH
2020-02-04,6,0,25,0,TH
2020-02-05,0,0,25,0,TH
2020-02-06,0,0,25,0,TH
2020-02-07,7,0,32,0,TH
2020-02-08,0,0,32,0,TH
2020-02-09,0,0,32,0,TH
2020-02-10,0,0,32,0,TH
2020-02-11,1,0,33,0,TH
2020-02-12,0,0,33,0,TH
2020-02-13,0,0,33,0,TH
2020-02-14,1,0,34,0,TH
2020-02-15,0,0,34,0,TH
2020-02-16,0,0,34,0,TH
2020-02-17,1,0,35,0,TH
2020-02-18,0,0,35,0,TH
2020-02-19,0,0,35,0,TH
2020-02-20,0,0,35,0,TH
2020-02-21,0,0,35,0,TH
2020-02-22,0,0,35,0,TH
2020-02-23,0,0,35,0,TH
2020-02-24,2,0,37,0,TH
2020-02-25,3,0,40,0,TH
2020-02-26,0,0,40,0,TH
2020-02-27,0,0,40,0,TH
2020-02-28,2,0,42,0,TH
2020-02-29,0,1,42,1,TH
2020-03-01,1,0,43,1,TH
2020-03-04,4,0,47,1,TH
2020-03-06,3,0,50,1,TH
2020-03-10,9,0,59,1,TH
2020-03-11,11,0,70,1,TH
2020-03-13,12,0,82,1,TH
2020-03-14,0,0,82,1,TH
2020-03-15,32,0,114,1,TH
2020-03-16,63,0,177,1,TH
2020-03-17,0,0,177,1,TH
2020-03-18,0,0,177,1,TH
2020-03-19,35,0,212,1,TH
2020-03-20,154,0,366,1,TH
2020-03-21,233,0,599,1,TH
2020-03-22,122,0,721,1,TH
2020-03-23,106,3,827,4,TH
2020-03-24,107,0,934,4,TH
2020-03-25,111,0,1045,4,TH
2020-03-26,91,1,1136,5,TH
2020-03-27,0,0,1136,5,TH
2020-03-28,109,1,1245,6,TH
2020-03-29,143,1,1388,7,TH
2020-03-30,263,3,1651,10,TH
2020-03-31,0,0,1651,10,TH
2020-04-01,120,2,1771,12,TH
2020-04-02,104,3,1875,15,TH
2020-04-03,103,4,1978,19,TH
2020-04-04,191,4,2169,23,TH
2020-04-05,51,3,2220,26,TH
2020-04-06,38,0,2258,26,TH
2020-04-07,111,4,2369,30,TH
2020-04-08,54,2,2423,32,TH
2020-04-09,50,1,2473,33,TH
2020-04-10,45,2,2518,35,TH
2020-04-11,33,3,2551,38,TH
2020-04-12,28,2,2579,40,TH
2020-04-13,34,1,2613,41,TH
2020-04-14,30,2,2643,43,TH
2020-04-15,29,3,2672,46,TH
2020-04-16,28,1,2700,47,TH
2020-04-17,0,0,2700,47,TH
2020-04-18,33,0,2733,47,TH
2020-04-19,32,0,2765,47,TH
2020-04-20,27,0,2792,47,TH
2020-04-21,19,1,2811,48,TH
2020-04-22,28,2,2839,50,TH
2020-04-23,0,0,2839,50,TH
2020-04-24,15,0,2854,50,TH
2020-04-25,68,1,2922,51,TH
2020-04-26,0,0,2922,51,TH
2020-04-27,16,3,2938,54,TH
2020-04-28,0,0,2938,54,TH
2020-04-29,16,0,2954,54,TH
2020-04-30,6,0,2960,54,TH
2020-05-01,0,0,2960,54,TH
2020-05-02,6,0,2966,54,TH
2020-05-03,3,0,2969,54,TH
2020-05-04,18,0,2987,54,TH
2020-05-05,1,0,2988,54,TH
2020-05-06,1,1,2989,55,TH
2020-05-07,3,0,2992,55,TH
2020-05-08,8,0,3000,55,TH
2020-05-09,4,1,3004,56,TH
2020-05-10,11,0,3015,56,TH
2020-05-11,0,0,3015,56,TH
2020-05-12,2,0,3017,56,TH
2020-05-13,0,0,3017,56,TH
2020-05-14,1,0,3018,56,TH
2020-05-15,7,0,3025,56,TH
2020-05-16,3,0,3028,56,TH
2020-05-17,0,0,3028,56,TH
2020-05-18,3,0,3031,56,TH
2020-05-19,3,0,3034,56,TH
2020-05-20,0,0,3034,56,TH
2020-05-21,3,0,3037,56,TH
2020-05-22,3,0,3040,56,TH
2020-05-23,0,0,3040,56,TH
2020-05-24,2,1,3042,57,TH
2020-05-25,0,0,3042,57,TH
2020-05-26,3,0,3045,57,TH
2020-05-27,9,0,3054,57,TH
2020-05-28,11,0,3065,57,TH
2020-05-29,11,0,3076,57,TH
2020-05-30,5,0,3081,57,TH
2020-05-31,0,0,3081,57,TH
2020-06-01,1,0,3082,57,TH
2020-06-02,1,1,3083,58,TH
2020-06-03,18,0,3101,58,TH
2020-06-04,1,0,3102,58,TH
2020-06-05,2,0,3104,58,TH
2020-06-06,8,0,3112,58,TH
2020-06-07,7,0,3119,58,TH
2020-06-08,0,0,3119,58,TH
2020-06-09,6,0,3125,58,TH
2020-06-10,0,0,3125,58,TH
2020-06-11,0,0,3125,58,TH
2020-06-12,4,0,3129,58,TH
2020-06-13,5,0,3134,58,TH
2020-06-14,1,0,3135,58,TH
2020-06-15,0,0,3135,58,TH
2020-06-16,0,0,3135,58,TH
2020-06-17,6,0,3141,58,TH
2020-06-18,0,0,3141,58,TH
2020-06-19,5,0,3146,58,TH
2020-06-20,1,0,3147,58,TH
2020-06-21,1,0,3148,58,TH
2020-06-22,3,0,3151,58,TH
2020-06-23,5,0,3156,58,TH
2020-06-24,2,0,3158,58,TH
2020-06-25,0,0,3158,58,TH
2020-06-26,4,0,3162,58,TH
2020-04-30,15,0,15,0,TJ
2020-05-01,0,0,15,0,TJ
2020-05-02,17,0,32,0,TJ
2020-05-03,44,2,76,2,TJ
2020-05-04,154,1,230,3,TJ
2020-05-05,63,2,293,5,TJ
2020-05-06,86,3,379,8,TJ
2020-05-07,82,4,461,12,TJ
2020-05-08,61,0,522,12,TJ
2020-05-09,90,8,612,20,TJ
2020-05-10,0,0,612,20,TJ
2020-05-11,49,1,661,21,TJ
2020-05-12,68,2,729,23,TJ
2020-05-13,72,0,801,23,TJ
2020-05-14,106,6,907,29,TJ
2020-05-15,211,4,1118,33,TJ
2020-05-16,204,3,1322,36,TJ
2020-05-17,202,3,1524,39,TJ
2020-05-18,205,2,1729,41,TJ
2020-05-19,0,0,1729,41,TJ
2020-05-20,207,3,1936,44,TJ
2020-05-21,204,0,2140,44,TJ
2020-05-22,210,0,2350,44,TJ
2020-05-23,201,0,2551,44,TJ
2020-05-24,187,0,2738,44,TJ
2020-05-25,362,2,3100,46,TJ
2020-05-26,0,0,3100,46,TJ
2020-05-27,0,0,3100,46,TJ
2020-05-28,463,1,3563,47,TJ
2020-05-29,0,0,3563,47,TJ
2020-05-30,244,0,3807,47,TJ
2020-05-31,0,0,3807,47,TJ
2020-06-01,123,0,3930,47,TJ
2020-06-02,83,0,4013,47,TJ
2020-06-03,87,0,4100,47,TJ
2020-06-04,189,1,4289,48,TJ
2020-06-05,81,0,4370,48,TJ
2020-06-06,83,0,4453,48,TJ
2020-06-07,76,0,4529,48,TJ
2020-06-08,80,0,4609,48,TJ
2020-06-09,81,0,4690,48,TJ
2020-06-10,73,0,4763,48,TJ
2020-06-11,71,1,4834,49,TJ
2020-06-12,68,0,4902,49,TJ
2020-06-13,69,1,4971,50,TJ
2020-06-14,64,0,5035,50,TJ
2020-06-15,62,0,5097,50,TJ
2020-06-16,63,0,5160,50,TJ
2020-06-17,61,1,5221,51,TJ
2020-06-18,58,0,5279,51,TJ
2020-06-19,59,0,5338,51,TJ
2020-06-20,61,1,5399,52,TJ
2020-06-21,58,0,5457,52,TJ
2020-06-22,56,0,5513,52,TJ
2020-06-23,54,0,5567,52,TJ
2020-06-24,63,0,5630,52,TJ
2020-06-25,61,0,5691,52,TJ
2020-06-26,56,0,5747,52,TJ
2020-03-21,1,0,1,0,TL
2020-03-22,0,0,1,0,TL
2020-03-23,0,0,1,0,TL
2020-03-24,0,0,1,0,TL
2020-03-25,0,0,1,0,TL
2020-03-26,0,0,1,0,TL
2020-03-27,0,0,1,0,TL
2020-03-28,0,0,1,0,TL
2020-03-29,0,0,1,0,TL
2020-03-30,0,0,1,0,TL
2020-03-31,0,0,1,0,TL
2020-04-01,0,0,1,0,TL
2020-04-02,0,0,1,0,TL
2020-04-03,0,0,1,0,TL
2020-04-04,0,0,1,0,TL
2020-04-05,0,0,1,0,TL
2020-04-06,0,0,1,0,TL
2020-04-07,0,0,1,0,TL
2020-04-08,0,0,1,0,TL
2020-04-09,1,0,2,0,TL
2020-04-10,0,0,2,0,TL
2020-04-11,0,0,2,0,TL
2020-04-12,0,0,2,0,TL
2020-04-13,2,0,4,0,TL
2020-04-14,2,0,6,0,TL
2020-04-15,0,0,6,0,TL
2020-04-16,12,0,18,0,TL
2020-04-17,0,0,18,0,TL
2020-04-18,0,0,18,0,TL
2020-04-19,1,0,19,0,TL
2020-04-20,3,0,22,0,TL
2020-04-21,1,0,23,0,TL
2020-04-22,0,0,23,0,TL
2020-04-23,0,0,23,0,TL
2020-04-24,1,0,24,0,TL
2020-04-25,0,0,24,0,TL
2020-04-26,0,0,24,0,TL
2020-04-27,0,0,24,0,TL
2020-04-28,0,0,24,0,TL
2020-04-29,0,0,24,0,TL
2020-04-30,0,0,24,0,TL
2020-05-01,0,0,24,0,TL
2020-05-02,0,0,24,0,TL
2020-05-03,0,0,24,0,TL
2020-05-04,0,0,24,0,TL
2020-05-05,0,0,24,0,TL
2020-05-06,0,0,24,0,TL
2020-05-07,0,0,24,0,TL
2020-05-08,0,0,24,0,TL
2020-05-09,0,0,24,0,TL
2020-05-10,0,0,24,0,TL
2020-05-11,0,0,24,0,TL
2020-05-12,0,0,24,0,TL
2020-05-13,0,0,24,0,TL
2020-05-14,0,0,24,0,TL
2020-05-15,0,0,24,0,TL
2020-05-16,0,0,24,0,TL
2020-05-17,0,0,24,0,TL
2020-05-18,0,0,24,0,TL
2020-05-19,0,0,24,0,TL
2020-05-20,0,0,24,0,TL
2020-05-21,0,0,24,0,TL
2020-05-22,0,0,24,0,TL
2020-05-23,0,0,24,0,TL
2020-05-24,0,0,24,0,TL
2020-05-25,0,0,24,0,TL
2020-05-26,0,0,24,0,TL
2020-05-27,0,0,24,0,TL
2020-05-28,0,0,24,0,TL
2020-05-29,0,0,24,0,TL
2020-05-30,0,0,24,0,TL
2020-05-31,0,0,24,0,TL
2020-06-01,0,0,24,0,TL
2020-06-02,0,0,24,0,TL
2020-06-03,0,0,24,0,TL
2020-06-04,0,0,24,0,TL
2020-06-05,0,0,24,0,TL
2020-06-06,0,0,24,0,TL
2020-06-07,0,0,24,0,TL
2020-06-08,0,0,24,0,TL
2020-06-09,0,0,24,0,TL
2020-06-10,0,0,24,0,TL
2020-06-11,0,0,24,0,TL
2020-06-12,0,0,24,0,TL
2020-06-13,0,0,24,0,TL
2020-06-14,0,0,24,0,TL
2020-06-15,0,0,24,0,TL
2020-06-16,0,0,24,0,TL
2020-06-17,0,0,24,0,TL
2020-06-18,0,0,24,0,TL
2020-06-19,0,0,24,0,TL
2020-06-20,0,0,24,0,TL
2020-06-21,0,0,24,0,TL
2020-06-22,0,0,24,0,TL
2020-06-23,0,0,24,0,TL
2020-06-24,0,0,24,0,TL
2020-06-25,0,0,24,0,TL
2020-06-26,0,0,24,0,TL
2020-03-02,1,0,1,0,TN
2020-03-09,1,0,2,0,TN
2020-03-10,3,0,5,0,TN
2020-03-11,2,0,7,0,TN
2020-03-12,6,0,13,0,TN
2020-03-13,3,0,16,0,TN
2020-03-14,0,0,16,0,TN
2020-03-15,2,0,18,0,TN
2020-03-16,2,0,20,0,TN
2020-03-17,4,0,24,0,TN
2020-03-18,5,0,29,0,TN
2020-03-19,10,0,39,0,TN
2020-03-20,15,1,54,1,TN
2020-03-21,6,0,60,1,TN
2020-03-22,15,2,75,3,TN
2020-03-23,14,0,89,3,TN
2020-03-24,25,0,114,3,TN
2020-03-25,59,2,173,5,TN
2020-03-26,0,0,173,5,TN
2020-03-27,54,1,227,6,TN
2020-03-28,0,0,227,6,TN
2020-03-29,51,2,278,8,TN
2020-03-30,34,0,312,8,TN
2020-03-31,50,1,362,9,TN
2020-04-01,32,1,394,10,TN
2020-04-02,61,3,455,13,TN
2020-04-03,0,0,455,13,TN
2020-04-04,40,5,495,18,TN
2020-04-05,58,1,553,19,TN
2020-04-06,21,3,574,22,TN
2020-04-07,22,0,596,22,TN
2020-04-08,27,1,623,23,TN
2020-04-09,20,2,643,25,TN
2020-04-10,28,0,671,25,TN
2020-04-11,14,3,685,28,TN
2020-04-12,22,3,707,31,TN
2020-04-13,19,3,726,34,TN
2020-04-14,21,0,747,34,TN
2020-04-15,33,1,780,35,TN
2020-04-16,42,2,822,37,TN
2020-04-17,42,0,864,37,TN
2020-04-18,2,0,866,37,TN
2020-04-19,13,1,879,38,TN
2020-04-20,5,0,884,38,TN
2020-04-21,17,0,901,38,TN
2020-04-22,0,0,901,38,TN
2020-04-23,17,0,918,38,TN
2020-04-24,4,0,922,38,TN
2020-04-25,17,0,939,38,TN
2020-04-26,10,0,949,38,TN
2020-04-27,18,1,967,39,TN
2020-04-28,8,1,975,40,TN
2020-04-29,5,0,980,40,TN
2020-04-30,14,0,994,40,TN
2020-05-01,4,1,998,41,TN
2020-05-02,11,1,1009,42,TN
2020-05-03,4,0,1013,42,TN
2020-05-04,5,1,1018,43,TN
2020-05-05,4,0,1022,43,TN
2020-05-06,3,0,1025,43,TN
2020-05-07,1,1,1026,44,TN
2020-05-08,4,1,1030,45,TN
2020-05-09,2,0,1032,45,TN
2020-05-10,0,0,1032,45,TN
2020-05-11,0,0,1032,45,TN
2020-05-12,0,0,1032,45,TN
2020-05-13,0,0,1032,45,TN
2020-05-14,0,0,1032,45,TN
2020-05-15,3,0,1035,45,TN
2020-05-16,0,0,1035,45,TN
2020-05-17,2,0,1037,45,TN
2020-05-18,6,1,1043,46,TN
2020-05-19,1,1,1044,47,TN
2020-05-20,1,0,1045,47,TN
2020-05-21,1,0,1046,47,TN
2020-05-22,2,0,1048,47,TN
2020-05-23,0,1,1048,48,TN
2020-05-24,3,0,1051,48,TN
2020-05-25,0,0,1051,48,TN
2020-05-26,0,0,1051,48,TN
2020-05-27,0,0,1051,48,TN
2020-05-28,17,0,1068,48,TN
2020-05-29,3,0,1071,48,TN
2020-05-30,5,0,1076,48,TN
2020-05-31,1,0,1077,48,TN
2020-06-01,7,0,1084,48,TN
2020-06-02,2,0,1086,48,TN
2020-06-03,1,1,1087,49,TN
2020-06-04,0,0,1087,49,TN
2020-06-05,0,0,1087,49,TN
2020-06-06,0,0,1087,49,TN
2020-06-07,0,0,1087,49,TN
2020-06-08,0,0,1087,49,TN
2020-06-09,0,0,1087,49,TN
2020-06-10,0,0,1087,49,TN
2020-06-11,0,0,1087,49,TN
2020-06-12,6,0,1093,49,TN
2020-06-13,1,0,1094,49,TN
2020-06-14,2,0,1096,49,TN
2020-06-15,14,0,1110,49,TN
2020-06-16,15,0,1125,49,TN
2020-06-17,3,1,1128,50,TN
2020-06-18,4,0,1132,50,TN
2020-06-19,14,0,1146,50,TN
2020-06-20,10,0,1156,50,TN
2020-06-21,1,0,1157,50,TN
2020-06-22,2,0,1159,50,TN
2020-06-23,0,0,1159,50,TN
2020-06-24,1,0,1160,50,TN
2020-06-25,2,0,1162,50,TN
2020-06-26,2,0,1164,50,TN
2020-03-11,1,0,1,0,TR
2020-03-12,1,0,2,0,TR
2020-03-15,16,0,18,0,TR
2020-03-16,29,0,47,0,TR
2020-03-17,51,0,98,0,TR
2020-03-18,93,1,191,1,TR
2020-03-19,168,3,359,4,TR
2020-03-20,311,5,670,9,TR
2020-03-21,277,12,947,21,TR
2020-03-22,289,9,1236,30,TR
2020-03-23,293,7,1529,37,TR
2020-03-24,343,7,1872,44,TR
2020-03-25,561,15,2433,59,TR
2020-03-26,1196,16,3629,75,TR
2020-03-27,2069,17,5698,92,TR
2020-03-28,1704,16,7402,108,TR
2020-03-29,1815,23,9217,131,TR
2020-03-30,1610,37,10827,168,TR
2020-03-31,2704,46,13531,214,TR
2020-04-01,2148,63,15679,277,TR
2020-04-02,2456,79,18135,356,TR
2020-04-03,2786,69,20921,425,TR
2020-04-04,3013,76,23934,501,TR
2020-04-05,3135,73,27069,574,TR
2020-04-06,3148,75,30217,649,TR
2020-04-07,3892,76,34109,725,TR
2020-04-08,4117,87,38226,812,TR
2020-04-09,4056,96,42282,908,TR
2020-04-10,4747,98,47029,1006,TR
2020-04-11,5138,95,52167,1101,TR
2020-04-12,4789,97,56956,1198,TR
2020-04-13,4093,98,61049,1296,TR
2020-04-14,4062,107,65111,1403,TR
2020-04-15,4281,115,69392,1518,TR
2020-04-16,4801,125,74193,1643,TR
2020-04-17,4353,126,78546,1769,TR
2020-04-18,3783,121,82329,1890,TR
2020-04-19,3977,127,86306,2017,TR
2020-04-20,4674,123,90980,2140,TR
2020-04-21,4611,119,95591,2259,TR
2020-04-22,3083,117,98674,2376,TR
2020-04-23,3116,115,101790,2491,TR
2020-04-24,3122,109,104912,2600,TR
2020-04-25,2861,106,107773,2706,TR
2020-04-26,2357,99,110130,2805,TR
2020-04-27,2131,95,112261,2900,TR
2020-04-28,2392,92,114653,2992,TR
2020-04-29,2936,89,117589,3081,TR
2020-04-30,2615,93,120204,3174,TR
2020-05-01,2188,84,122392,3258,TR
2020-05-02,1983,78,124375,3336,TR
2020-05-03,1670,61,126045,3397,TR
2020-05-04,1614,64,127659,3461,TR
2020-05-05,1832,59,129491,3520,TR
2020-05-06,2253,64,131744,3584,TR
2020-05-07,1977,57,133721,3641,TR
2020-05-08,1848,48,135569,3689,TR
2020-05-09,1546,50,137115,3739,TR
2020-05-10,1542,47,138657,3786,TR
2020-05-11,1114,55,139771,3841,TR
2020-05-12,1704,53,141475,3894,TR
2020-05-13,1639,58,143114,3952,TR
2020-05-14,1635,55,144749,4007,TR
2020-05-15,1708,48,146457,4055,TR
2020-05-16,1610,41,148067,4096,TR
2020-05-17,1368,44,149435,4140,TR
2020-05-18,1158,31,150593,4171,TR
2020-05-19,1022,28,151615,4199,TR
2020-05-20,972,23,152587,4222,TR
2020-05-21,961,27,153548,4249,TR
2020-05-22,952,27,154500,4276,TR
2020-05-23,1186,32,155686,4308,TR
2020-05-24,1141,32,156827,4340,TR
2020-05-25,987,29,157814,4369,TR
2020-05-26,948,28,158762,4397,TR
2020-05-27,1035,34,159797,4431,TR
2020-05-28,1182,30,160979,4461,TR
2020-05-29,1141,28,162120,4489,TR
2020-05-30,983,26,163103,4515,TR
2020-05-31,839,25,163942,4540,TR
2020-06-01,827,23,164769,4563,TR
2020-06-02,786,22,165555,4585,TR
2020-06-03,867,24,166422,4609,TR
2020-06-04,988,21,167410,4630,TR
2020-06-05,930,18,168340,4648,TR
2020-06-06,878,21,169218,4669,TR
2020-06-07,914,23,170132,4692,TR
2020-06-08,989,19,171121,4711,TR
2020-06-09,993,18,172114,4729,TR
2020-06-10,922,17,173036,4746,TR
2020-06-11,987,17,174023,4763,TR
2020-06-12,1195,15,175218,4778,TR
2020-06-13,1459,14,176677,4792,TR
2020-06-14,1562,15,178239,4807,TR
2020-06-15,1592,18,179831,4825,TR
2020-06-16,1467,17,181298,4842,TR
2020-06-17,1429,19,182727,4861,TR
2020-06-18,1304,21,184031,4882,TR
2020-06-19,1214,23,185245,4905,TR
2020-06-20,1248,22,186493,4927,TR
2020-06-21,1192,23,187685,4950,TR
2020-06-22,1212,24,188897,4974,TR
2020-06-23,1268,27,190165,5001,TR
2020-06-24,1492,24,191657,5025,TR
2020-06-25,1458,21,193115,5046,TR
2020-06-26,1396,19,194511,5065,TR
2020-03-12,1,0,1,0,TT
2020-03-13,1,0,2,0,TT
2020-03-14,0,0,2,0,TT
2020-03-15,2,0,4,0,TT
2020-03-16,1,0,5,0,TT
2020-03-17,2,0,7,0,TT
2020-03-18,2,0,9,0,TT
2020-03-19,0,0,9,0,TT
2020-03-20,0,0,9,0,TT
2020-03-21,40,0,49,0,TT
2020-03-22,1,0,50,0,TT
2020-03-23,1,0,51,0,TT
2020-03-24,6,0,57,0,TT
2020-03-25,3,1,60,1,TT
2020-03-26,5,0,65,1,TT
2020-03-27,1,1,66,2,TT
2020-03-28,8,0,74,2,TT
2020-03-29,4,1,78,3,TT
2020-03-30,7,0,85,3,TT
2020-03-31,2,0,87,3,TT
2020-04-01,2,2,89,5,TT
2020-04-02,8,1,97,6,TT
2020-04-03,3,0,100,6,TT
2020-04-04,3,0,103,6,TT
2020-04-05,1,1,104,7,TT
2020-04-06,1,1,105,8,TT
2020-04-07,2,0,107,8,TT
2020-04-08,0,0,107,8,TT
2020-04-09,2,0,109,8,TT
2020-04-10,0,0,109,8,TT
2020-04-11,3,0,112,8,TT
2020-04-12,1,0,113,8,TT
2020-04-13,0,0,113,8,TT
2020-04-14,0,0,113,8,TT
2020-04-15,1,0,114,8,TT
2020-04-16,0,0,114,8,TT
2020-04-17,0,0,114,8,TT
2020-04-18,0,0,114,8,TT
2020-04-19,0,0,114,8,TT
2020-04-20,0,0,114,8,TT
2020-04-21,1,0,115,8,TT
2020-04-22,0,0,115,8,TT
2020-04-23,0,0,115,8,TT
2020-04-24,0,0,115,8,TT
2020-04-25,0,0,115,8,TT
2020-04-26,1,0,116,8,TT
2020-04-27,0,0,116,8,TT
2020-04-28,0,0,116,8,TT
2020-04-29,0,0,116,8,TT
2020-04-30,0,0,116,8,TT
2020-05-01,0,0,116,8,TT
2020-05-02,0,0,116,8,TT
2020-05-03,0,0,116,8,TT
2020-05-04,0,0,116,8,TT
2020-05-05,0,0,116,8,TT
2020-05-06,0,0,116,8,TT
2020-05-07,0,0,116,8,TT
2020-05-08,0,0,116,8,TT
2020-05-09,0,0,116,8,TT
2020-05-10,0,0,116,8,TT
2020-05-11,0,0,116,8,TT
2020-05-12,0,0,116,8,TT
2020-05-13,0,0,116,8,TT
2020-05-14,0,0,116,8,TT
2020-05-15,0,0,116,8,TT
2020-05-16,0,0,116,8,TT
2020-05-17,0,0,116,8,TT
2020-05-18,0,0,116,8,TT
2020-05-19,0,0,116,8,TT
2020-05-20,0,0,116,8,TT
2020-05-21,0,0,116,8,TT
2020-05-22,0,0,116,8,TT
2020-05-23,0,0,116,8,TT
2020-05-24,0,0,116,8,TT
2020-05-25,0,0,116,8,TT
2020-05-26,0,0,116,8,TT
2020-05-27,0,0,116,8,TT
2020-05-28,0,0,116,8,TT
2020-05-29,0,0,116,8,TT
2020-05-30,1,0,117,8,TT
2020-05-31,0,0,117,8,TT
2020-06-01,0,0,117,8,TT
2020-06-02,0,0,117,8,TT
2020-06-03,0,0,117,8,TT
2020-06-04,0,0,117,8,TT
2020-06-05,0,0,117,8,TT
2020-06-06,0,0,117,8,TT
2020-06-07,0,0,117,8,TT
2020-06-08,0,0,117,8,TT
2020-06-09,0,0,117,8,TT
2020-06-10,0,0,117,8,TT
2020-06-11,0,0,117,8,TT
2020-06-12,0,0,117,8,TT
2020-06-13,0,0,117,8,TT
2020-06-14,6,0,123,8,TT
2020-06-15,0,0,123,8,TT
2020-06-16,0,0,123,8,TT
2020-06-17,0,0,123,8,TT
2020-06-18,0,0,123,8,TT
2020-06-19,0,0,123,8,TT
2020-06-20,0,0,123,8,TT
2020-06-21,0,0,123,8,TT
2020-06-22,0,0,123,8,TT
2020-06-23,0,0,123,8,TT
2020-06-24,0,0,123,8,TT
2020-06-25,0,0,123,8,TT
2020-06-26,1,0,124,8,TT
2019-12-30,0,0,0,0,TW
2019-12-31,0,0,0,0,TW
2020-01-01,0,0,0,0,TW
2020-01-02,0,0,0,0,TW
2020-01-03,0,0,0,0,TW
2020-01-04,0,0,0,0,TW
2020-01-05,0,0,0,0,TW
2020-01-06,0,0,0,0,TW
2020-01-07,0,0,0,0,TW
2020-01-08,0,0,0,0,TW
2020-01-09,0,0,0,0,TW
2020-01-10,0,0,0,0,TW
2020-01-11,0,0,0,0,TW
2020-01-12,0,0,0,0,TW
2020-01-13,0,0,0,0,TW
2020-01-14,0,0,0,0,TW
2020-01-15,0,0,0,0,TW
2020-01-16,0,0,0,0,TW
2020-01-17,0,0,0,0,TW
2020-01-18,0,0,0,0,TW
2020-01-19,0,0,0,0,TW
2020-01-20,1,0,1,0,TW
2020-01-21,0,0,1,0,TW
2020-01-22,0,0,1,0,TW
2020-01-23,0,0,1,0,TW
2020-01-24,2,0,3,0,TW
2020-01-25,0,0,3,0,TW
2020-01-26,2,0,5,0,TW
2020-01-27,2,0,7,0,TW
2020-01-28,1,0,8,0,TW
2020-01-29,0,0,8,0,TW
2020-01-30,1,0,9,0,TW
2020-01-31,1,0,10,0,TW
2020-02-01,0,0,10,0,TW
2020-02-02,0,0,10,0,TW
2020-02-03,0,0,10,0,TW
2020-02-04,1,0,11,0,TW
2020-02-05,0,0,11,0,TW
2020-02-06,5,0,16,0,TW
2020-02-07,1,0,17,0,TW
2020-02-08,1,0,18,0,TW
2020-02-09,0,0,18,0,TW
2020-02-10,0,0,18,0,TW
2020-02-11,0,0,18,0,TW
2020-02-12,0,0,18,0,TW
2020-02-13,0,0,18,0,TW
2020-02-14,0,0,18,0,TW
2020-02-15,0,0,18,0,TW
2020-02-16,2,1,20,1,TW
2020-02-17,2,0,22,1,TW
2020-02-18,0,0,22,1,TW
2020-02-19,2,0,24,1,TW
2020-02-20,0,0,24,1,TW
2020-02-21,2,0,26,1,TW
2020-02-22,0,0,26,1,TW
2020-02-23,2,0,28,1,TW
2020-02-24,2,0,30,1,TW
2020-02-25,1,0,31,1,TW
2020-02-26,1,0,32,1,TW
2020-02-27,2,0,34,1,TW
2020-02-28,5,0,39,1,TW
2020-02-29,1,0,40,1,TW
2020-03-01,0,0,40,1,TW
2020-03-02,1,0,41,1,TW
2020-03-03,1,0,42,1,TW
2020-03-05,2,0,44,1,TW
2020-03-06,1,0,45,1,TW
2020-03-07,0,0,45,1,TW
2020-03-08,0,0,45,1,TW
2020-03-10,3,0,48,1,TW
2020-03-11,0,0,48,1,TW
2020-03-12,1,0,49,1,TW
2020-03-13,4,0,53,1,TW
2020-03-14,6,0,59,1,TW
2020-03-15,0,0,59,1,TW
2020-03-16,8,0,67,1,TW
2020-03-17,10,0,77,1,TW
2020-03-18,31,0,108,1,TW
2020-03-19,0,0,108,1,TW
2020-03-20,27,1,135,2,TW
2020-03-21,18,0,153,2,TW
2020-03-22,12,0,165,2,TW
2020-03-23,30,0,195,2,TW
2020-03-24,21,0,216,2,TW
2020-03-25,19,0,235,2,TW
2020-03-26,17,0,252,2,TW
2020-03-27,15,0,267,2,TW
2020-03-28,16,0,283,2,TW
2020-03-29,23,3,306,5,TW
2020-03-30,0,0,306,5,TW
2020-03-31,16,0,322,5,TW
2020-04-01,17,0,339,5,TW
2020-04-02,0,0,339,5,TW
2020-04-03,16,0,355,5,TW
2020-04-04,8,0,363,5,TW
2020-04-05,0,0,363,5,TW
2020-04-06,10,0,373,5,TW
2020-04-07,3,0,376,5,TW
2020-04-08,3,0,379,5,TW
2020-04-09,1,0,380,5,TW
2020-04-10,0,0,380,5,TW
2020-04-11,5,1,385,6,TW
2020-04-12,3,0,388,6,TW
2020-04-13,5,0,393,6,TW
2020-04-14,2,0,395,6,TW
2020-04-15,0,0,395,6,TW
2020-04-16,0,0,395,6,TW
2020-04-17,0,0,395,6,TW
2020-04-18,3,0,398,6,TW
2020-04-19,22,0,420,6,TW
2020-04-20,2,0,422,6,TW
2020-04-21,3,0,425,6,TW
2020-04-22,1,0,426,6,TW
2020-04-23,1,0,427,6,TW
2020-04-24,1,0,428,6,TW
2020-04-25,1,0,429,6,TW
2020-04-26,0,0,429,6,TW
2020-04-27,0,0,429,6,TW
2020-04-28,0,0,429,6,TW
2020-04-29,0,0,429,6,TW
2020-04-30,0,0,429,6,TW
2020-05-01,0,0,429,6,TW
2020-05-02,3,0,432,6,TW
2020-05-03,4,0,436,6,TW
2020-05-04,2,0,438,6,TW
2020-05-05,0,0,438,6,TW
2020-05-06,1,0,439,6,TW
2020-05-07,1,0,440,6,TW
2020-05-08,0,0,440,6,TW
2020-05-09,0,0,440,6,TW
2020-05-10,0,0,440,6,TW
2020-05-11,0,1,440,7,TW
2020-05-12,0,0,440,7,TW
2020-05-13,0,0,440,7,TW
2020-05-14,0,0,440,7,TW
2020-05-15,0,0,440,7,TW
2020-05-16,0,0,440,7,TW
2020-05-17,0,0,440,7,TW
2020-05-18,0,0,440,7,TW
2020-05-19,0,0,440,7,TW
2020-05-20,1,0,441,7,TW
2020-05-21,0,0,441,7,TW
2020-05-22,0,0,441,7,TW
2020-05-23,0,0,441,7,TW
2020-05-24,0,0,441,7,TW
2020-05-25,0,0,441,7,TW
2020-05-26,0,0,441,7,TW
2020-05-27,0,0,441,7,TW
2020-05-28,0,0,441,7,TW
2020-05-29,1,0,442,7,TW
2020-05-30,0,0,442,7,TW
2020-05-31,0,0,442,7,TW
2020-06-01,1,0,443,7,TW
2020-06-02,0,0,443,7,TW
2020-06-03,0,0,443,7,TW
2020-06-04,0,0,443,7,TW
2020-06-05,0,0,443,7,TW
2020-06-06,0,0,443,7,TW
2020-06-07,0,0,443,7,TW
2020-06-08,0,0,443,7,TW
2020-06-09,0,0,443,7,TW
2020-06-10,0,0,443,7,TW
2020-06-11,0,0,443,7,TW
2020-06-12,0,0,443,7,TW
2020-06-13,0,0,443,7,TW
2020-06-14,0,0,443,7,TW
2020-06-15,2,0,445,7,TW
2020-06-16,0,0,445,7,TW
2020-06-17,0,0,445,7,TW
2020-06-18,1,0,446,7,TW
2020-06-19,0,0,446,7,TW
2020-06-20,0,0,446,7,TW
2020-06-21,0,0,446,7,TW
2020-06-22,0,0,446,7,TW
2020-06-23,0,0,446,7,TW
2020-06-24,0,0,446,7,TW
2020-06-25,1,0,447,7,TW
2020-06-26,0,0,447,7,TW
2020-03-16,1,0,1,0,TZ
2020-03-17,0,0,1,0,TZ
2020-03-18,2,0,3,0,TZ
2020-03-19,0,0,3,0,TZ
2020-03-20,0,0,3,0,TZ
2020-03-21,3,0,6,0,TZ
2020-03-22,6,0,12,0,TZ
2020-03-23,0,0,12,0,TZ
2020-03-24,0,0,12,0,TZ
2020-03-25,0,0,12,0,TZ
2020-03-26,1,0,13,0,TZ
2020-03-27,0,0,13,0,TZ
2020-03-28,0,1,13,1,TZ
2020-03-29,1,0,14,1,TZ
2020-03-30,5,0,19,1,TZ
2020-03-31,0,0,19,1,TZ
2020-04-01,1,0,20,1,TZ
2020-04-02,1,0,21,1,TZ
2020-04-03,0,0,21,1,TZ
2020-04-04,0,0,21,1,TZ
2020-04-05,1,0,22,1,TZ
2020-04-06,2,0,24,1,TZ
2020-04-07,0,0,24,1,TZ
2020-04-08,1,0,25,1,TZ
2020-04-09,0,0,25,1,TZ
2020-04-10,7,2,32,3,TZ
2020-04-11,0,0,32,3,TZ
2020-04-12,0,0,32,3,TZ
2020-04-13,14,0,46,3,TZ
2020-04-14,7,0,53,3,TZ
2020-04-15,35,1,88,4,TZ
2020-04-16,6,0,94,4,TZ
2020-04-17,53,1,147,5,TZ
2020-04-18,1,0,148,5,TZ
2020-04-19,22,0,170,5,TZ
2020-04-20,0,0,170,5,TZ
2020-04-21,84,3,254,8,TZ
2020-04-22,31,2,285,10,TZ
2020-04-23,0,0,285,10,TZ
2020-04-24,15,0,300,10,TZ
2020-04-25,0,0,300,10,TZ
2020-04-26,0,0,300,10,TZ
2020-04-27,0,0,300,10,TZ
2020-04-28,6,0,306,10,TZ
2020-04-29,174,6,480,16,TZ
2020-04-30,0,0,480,16,TZ
2020-05-01,0,0,480,16,TZ
2020-05-02,0,0,480,16,TZ
2020-05-03,0,0,480,16,TZ
2020-05-04,0,2,480,18,TZ
2020-05-05,0,0,480,18,TZ
2020-05-06,0,0,480,18,TZ
2020-05-07,29,3,509,21,TZ
2020-05-08,0,0,509,21,TZ
2020-05-09,0,0,509,21,TZ
2020-05-10,0,0,509,21,TZ
2020-05-11,0,0,509,21,TZ
2020-05-12,0,0,509,21,TZ
2020-05-13,0,0,509,21,TZ
2020-05-14,0,0,509,21,TZ
2020-05-15,0,0,509,21,TZ
2020-05-16,0,0,509,21,TZ
2020-05-17,0,0,509,21,TZ
2020-05-18,0,0,509,21,TZ
2020-05-19,0,0,509,21,TZ
2020-05-20,0,0,509,21,TZ
2020-05-21,0,0,509,21,TZ
2020-05-22,0,0,509,21,TZ
2020-05-23,0,0,509,21,TZ
2020-05-24,0,0,509,21,TZ
2020-05-25,0,0,509,21,TZ
2020-05-26,0,0,509,21,TZ
2020-05-27,0,0,509,21,TZ
2020-05-28,0,0,509,21,TZ
2020-05-29,0,0,509,21,TZ
2020-05-30,0,0,509,21,TZ
2020-05-31,0,0,509,21,TZ
2020-06-01,0,0,509,21,TZ
2020-06-02,0,0,509,21,TZ
2020-06-03,0,0,509,21,TZ
2020-06-04,0,0,509,21,TZ
2020-06-05,0,0,509,21,TZ
2020-06-06,0,0,509,21,TZ
2020-06-07,0,0,509,21,TZ
2020-06-08,0,0,509,21,TZ
2020-06-09,0,0,509,21,TZ
2020-06-10,0,0,509,21,TZ
2020-06-11,0,0,509,21,TZ
2020-06-12,0,0,509,21,TZ
2020-06-13,0,0,509,21,TZ
2020-06-14,0,0,509,21,TZ
2020-06-15,0,0,509,21,TZ
2020-06-16,0,0,509,21,TZ
2020-06-17,0,0,509,21,TZ
2020-06-18,0,0,509,21,TZ
2020-06-19,0,0,509,21,TZ
2020-06-20,0,0,509,21,TZ
2020-06-21,0,0,509,21,TZ
2020-06-22,0,0,509,21,TZ
2020-06-23,0,0,509,21,TZ
2020-06-24,0,0,509,21,TZ
2020-06-25,0,0,509,21,TZ
2020-06-26,0,0,509,21,TZ
2020-03-03,1,0,1,0,UA
2020-03-12,2,0,3,0,UA
2020-03-15,0,0,3,0,UA
2020-03-16,2,0,5,0,UA
2020-03-17,9,0,14,0,UA
2020-03-18,5,2,19,2,UA
2020-03-19,7,0,26,2,UA
2020-03-20,0,1,26,3,UA
2020-03-21,15,0,41,3,UA
2020-03-22,6,0,47,3,UA
2020-03-23,26,0,73,3,UA
2020-03-24,11,0,84,3,UA
2020-03-25,29,1,113,4,UA
2020-03-26,43,1,156,5,UA
2020-03-27,62,0,218,5,UA
2020-03-28,93,3,311,8,UA
2020-03-29,107,1,418,9,UA
2020-03-30,62,2,480,11,UA
2020-03-31,69,2,549,13,UA
2020-04-01,245,7,794,20,UA
2020-04-02,10,0,804,20,UA
2020-04-03,183,3,987,23,UA
2020-04-04,109,5,1096,28,UA
2020-04-05,155,4,1251,32,UA
2020-04-06,68,6,1319,38,UA
2020-04-07,143,7,1462,45,UA
2020-04-08,206,7,1668,52,UA
2020-04-09,224,5,1892,57,UA
2020-04-10,311,12,2203,69,UA
2020-04-11,308,4,2511,73,UA
2020-04-12,266,10,2777,83,UA
2020-04-13,325,10,3102,93,UA
2020-04-14,270,5,3372,98,UA
2020-04-15,789,18,4161,116,UA
2020-04-16,301,9,4462,125,UA
2020-04-17,644,8,5106,133,UA
2020-04-18,343,8,5449,141,UA
2020-04-19,261,10,5710,151,UA
2020-04-20,415,10,6125,161,UA
2020-04-21,467,13,6592,174,UA
2020-04-22,578,13,7170,187,UA
2020-04-23,477,6,7647,193,UA
2020-04-24,478,8,8125,201,UA
2020-04-25,492,8,8617,209,UA
2020-04-26,392,11,9009,220,UA
2020-04-27,0,0,9009,220,UA
2020-04-28,401,19,9410,239,UA
2020-04-29,456,11,9866,250,UA
2020-04-30,540,0,10406,250,UA
2020-05-01,455,29,10861,279,UA
2020-05-02,550,0,11411,279,UA
2020-05-03,502,9,11913,288,UA
2020-05-04,418,15,12331,303,UA
2020-05-05,366,13,12697,316,UA
2020-05-06,487,11,13184,327,UA
2020-05-07,507,13,13691,340,UA
2020-05-08,504,21,14195,361,UA
2020-05-09,515,15,14710,376,UA
2020-05-10,522,15,15232,391,UA
2020-05-11,416,17,15648,408,UA
2020-05-12,375,17,16023,425,UA
2020-05-13,402,14,16425,439,UA
2020-05-14,422,17,16847,456,UA
2020-05-15,483,27,17330,483,UA
2020-05-16,528,14,17858,497,UA
2020-05-17,433,17,18291,514,UA
2020-05-18,325,21,18616,535,UA
2020-05-19,260,13,18876,548,UA
2020-05-20,354,16,19230,564,UA
2020-05-21,476,15,19706,579,UA
2020-05-22,442,9,20148,588,UA
2020-05-23,432,17,20580,605,UA
2020-05-24,406,12,20986,617,UA
2020-05-25,259,6,21245,623,UA
2020-05-26,339,21,21584,644,UA
2020-05-27,0,0,21584,644,UA
2020-05-28,798,25,22382,669,UA
2020-05-29,822,27,23204,696,UA
2020-05-30,0,0,23204,696,UA
2020-05-31,468,12,23672,708,UA
2020-06-01,668,19,24340,727,UA
2020-06-02,483,8,24823,735,UA
2020-06-03,588,12,25411,747,UA
2020-06-04,553,15,25964,762,UA
2020-06-05,550,15,26514,777,UA
2020-06-06,0,0,26514,777,UA
2020-06-07,485,11,26999,788,UA
2020-06-08,463,9,27462,797,UA
2020-06-09,394,13,27856,810,UA
2020-06-10,525,23,28381,833,UA
2020-06-11,689,21,29070,854,UA
2020-06-12,683,16,29753,870,UA
2020-06-13,753,10,30506,880,UA
2020-06-14,648,9,31154,889,UA
2020-06-15,656,12,31810,901,UA
2020-06-16,666,11,32476,912,UA
2020-06-17,758,31,33234,943,UA
2020-06-18,829,23,34063,966,UA
2020-06-19,921,19,34984,985,UA
2020-06-20,841,9,35825,994,UA
2020-06-21,735,8,36560,1002,UA
2020-06-22,681,10,37241,1012,UA
2020-06-23,1773,39,39014,1051,UA
2020-06-24,0,0,39014,1051,UA
2020-06-25,994,16,40008,1067,UA
2020-06-26,1109,19,41117,1086,UA
2020-03-21,1,0,1,0,UG
2020-03-22,0,0,1,0,UG
2020-03-23,8,0,9,0,UG
2020-03-24,0,0,9,0,UG
2020-03-25,5,0,14,0,UG
2020-03-26,0,0,14,0,UG
2020-03-27,0,0,14,0,UG
2020-03-28,16,0,30,0,UG
2020-03-29,3,0,33,0,UG
2020-03-30,0,0,33,0,UG
2020-03-31,11,0,44,0,UG
2020-04-01,0,0,44,0,UG
2020-04-02,1,0,45,0,UG
2020-04-03,3,0,48,0,UG
2020-04-04,0,0,48,0,UG
2020-04-05,4,0,52,0,UG
2020-04-06,0,0,52,0,UG
2020-04-07,0,0,52,0,UG
2020-04-08,1,0,53,0,UG
2020-04-09,0,0,53,0,UG
2020-04-10,0,0,53,0,UG
2020-04-11,0,0,53,0,UG
2020-04-12,1,0,54,0,UG
2020-04-13,0,0,54,0,UG
2020-04-14,1,0,55,0,UG
2020-04-15,0,0,55,0,UG
2020-04-16,0,0,55,0,UG
2020-04-17,0,0,55,0,UG
2020-04-18,0,0,55,0,UG
2020-04-19,0,0,55,0,UG
2020-04-20,1,0,56,0,UG
2020-04-21,2,0,58,0,UG
2020-04-22,3,0,61,0,UG
2020-04-23,13,0,74,0,UG
2020-04-24,1,0,75,0,UG
2020-04-25,0,0,75,0,UG
2020-04-26,4,0,79,0,UG
2020-04-27,0,0,79,0,UG
2020-04-28,0,0,79,0,UG
2020-04-29,2,0,81,0,UG
2020-04-30,2,0,83,0,UG
2020-05-01,2,0,85,0,UG
2020-05-02,3,0,88,0,UG
2020-05-03,1,0,89,0,UG
2020-05-04,8,0,97,0,UG
2020-05-05,1,0,98,0,UG
2020-05-06,0,0,98,0,UG
2020-05-07,3,0,101,0,UG
2020-05-08,0,0,101,0,UG
2020-05-09,15,0,116,0,UG
2020-05-10,5,0,121,0,UG
2020-05-11,1,0,122,0,UG
2020-05-12,4,0,126,0,UG
2020-05-13,13,0,139,0,UG
2020-05-14,21,0,160,0,UG
2020-05-15,43,0,203,0,UG
2020-05-16,24,0,227,0,UG
2020-05-17,0,0,227,0,UG
2020-05-18,33,0,260,0,UG
2020-05-19,0,0,260,0,UG
2020-05-20,-115,0,145,0,UG
2020-05-21,15,0,160,0,UG
2020-05-22,15,0,175,0,UG
2020-05-23,23,0,198,0,UG
2020-05-24,14,0,212,0,UG
2020-05-25,10,0,222,0,UG
2020-05-26,31,0,253,0,UG
2020-05-27,28,0,281,0,UG
2020-05-28,36,0,317,0,UG
2020-05-29,12,0,329,0,UG
2020-05-30,84,0,413,0,UG
2020-05-31,45,0,458,0,UG
2020-06-01,-1,0,457,0,UG
2020-06-02,32,0,489,0,UG
2020-06-03,18,0,507,0,UG
2020-06-04,15,0,522,0,UG
2020-06-05,35,0,557,0,UG
2020-06-06,36,0,593,0,UG
2020-06-07,23,0,616,0,UG
2020-06-08,30,0,646,0,UG
2020-06-09,11,0,657,0,UG
2020-06-10,8,0,665,0,UG
2020-06-11,14,0,679,0,UG
2020-06-12,6,0,685,0,UG
2020-06-13,0,0,685,0,UG
2020-06-14,11,0,696,0,UG
2020-06-15,9,0,705,0,UG
2020-06-16,19,0,724,0,UG
2020-06-17,8,0,732,0,UG
2020-06-18,9,0,741,0,UG
2020-06-19,14,0,755,0,UG
2020-06-20,0,0,755,0,UG
2020-06-21,15,0,770,0,UG
2020-06-22,4,0,774,0,UG
2020-06-23,23,0,797,0,UG
2020-06-24,8,0,805,0,UG
2020-06-25,16,0,821,0,UG
2020-06-26,12,0,833,0,UG
2019-12-30,0,0,0,0,US
2019-12-31,0,0,0,0,US
2020-01-01,0,0,0,0,US
2020-01-02,0,0,0,0,US
2020-01-03,0,0,0,0,US
2020-01-04,0,0,0,0,US
2020-01-05,0,0,0,0,US
2020-01-06,0,0,0,0,US
2020-01-07,0,0,0,0,US
2020-01-08,0,0,0,0,US
2020-01-09,0,0,0,0,US
2020-01-10,0,0,0,0,US
2020-01-11,0,0,0,0,US
2020-01-12,0,0,0,0,US
2020-01-13,0,0,0,0,US
2020-01-14,0,0,0,0,US
2020-01-15,0,0,0,0,US
2020-01-16,0,0,0,0,US
2020-01-17,0,0,0,0,US
2020-01-18,0,0,0,0,US
2020-01-19,0,0,0,0,US
2020-01-20,1,0,1,0,US
2020-01-21,0,0,1,0,US
2020-01-22,0,0,1,0,US
2020-01-23,0,0,1,0,US
2020-01-24,1,0,2,0,US
2020-01-25,0,0,2,0,US
2020-01-26,3,0,5,0,US
2020-01-27,0,0,5,0,US
2020-01-28,0,0,5,0,US
2020-01-29,0,0,5,0,US
2020-01-30,1,0,6,0,US
2020-01-31,1,0,7,0,US
2020-02-01,1,0,8,0,US
2020-02-02,3,0,11,0,US
2020-02-03,0,0,11,0,US
2020-02-04,0,0,11,0,US
2020-02-05,1,0,12,0,US
2020-02-06,0,0,12,0,US
2020-02-07,0,0,12,0,US
2020-02-08,0,0,12,0,US
2020-02-09,0,0,12,0,US
2020-02-10,1,0,13,0,US
2020-02-11,0,0,13,0,US
2020-02-12,1,0,14,0,US
2020-02-13,1,0,15,0,US
2020-02-14,0,0,15,0,US
2020-02-15,0,0,15,0,US
2020-02-16,0,0,15,0,US
2020-02-17,0,0,15,0,US
2020-02-18,0,0,15,0,US
2020-02-19,0,0,15,0,US
2020-02-20,1,0,16,0,US
2020-02-21,19,0,35,0,US
2020-02-22,0,0,35,0,US
2020-02-23,0,0,35,0,US
2020-02-24,18,0,53,0,US
2020-02-25,0,0,53,0,US
2020-02-26,6,0,59,0,US
2020-02-27,1,0,60,0,US
2020-02-28,6,0,66,0,US
2020-02-29,3,1,69,1,US
2020-03-01,20,1,89,2,US
2020-03-02,14,4,103,6,US
2020-03-03,22,3,125,9,US
2020-03-04,34,2,159,11,US
2020-03-05,74,1,233,12,US
2020-03-06,105,2,338,14,US
2020-03-07,95,3,433,17,US
2020-03-08,121,4,554,21,US
2020-03-09,200,5,754,26,US
2020-03-10,271,2,1025,28,US
2020-03-11,287,2,1312,30,US
2020-03-12,351,10,1663,40,US
2020-03-13,511,7,2174,47,US
2020-03-14,777,10,2951,57,US
2020-03-15,823,12,3774,69,US
2020-03-16,887,16,4661,85,US
2020-03-17,1766,23,6427,108,US
2020-03-18,2988,42,9415,150,US
2020-03-19,4835,0,14250,150,US
2020-03-20,5374,110,19624,260,US
2020-03-21,7123,80,26747,340,US
2020-03-22,8459,131,35206,471,US
2020-03-23,11236,119,46442,590,US
2020-03-24,8789,211,55231,801,US
2020-03-25,13963,249,69194,1050,US
2020-03-26,16797,246,85991,1296,US
2020-03-27,18695,411,104686,1707,US
2020-03-28,19979,484,124665,2191,US
2020-03-29,18360,318,143025,2509,US
2020-03-30,21595,661,164620,3170,US
2020-03-31,24998,909,189618,4079,US
2020-04-01,27103,1059,216721,5138,US
2020-04-02,28819,915,245540,6053,US
2020-04-03,32425,1104,277965,7157,US
2020-04-04,34272,1344,312237,8501,US
2020-04-05,25398,1146,337635,9647,US
2020-04-06,30561,1342,368196,10989,US
2020-04-07,30613,1906,398809,12895,US
2020-04-08,33323,1922,432132,14817,US
2020-04-09,33901,1873,466033,16690,US
2020-04-10,35527,2087,501560,18777,US
2020-04-11,28391,1831,529951,20608,US
2020-04-12,27620,1500,557571,22108,US
2020-04-13,25023,1541,582594,23649,US
2020-04-14,26922,2408,609516,26057,US
2020-04-15,30148,4928,639664,30985,US
2020-04-16,31667,2299,671331,33284,US
2020-04-17,30833,3770,702164,37054,US
2020-04-18,32922,1856,735086,38910,US
2020-04-19,24601,1772,759687,40682,US
2020-04-20,28065,1857,787752,42539,US
2020-04-21,37289,2524,825041,45063,US
2020-04-22,17588,1721,842629,46784,US
2020-04-23,26543,3179,869172,49963,US
2020-04-24,21352,1054,890524,51017,US
2020-04-25,48529,2172,939053,53189,US
2020-04-26,26857,1687,965910,54876,US
2020-04-27,22541,1369,988451,56245,US
2020-04-28,24132,2110,1012583,58355,US
2020-04-29,27326,2611,1039909,60966,US
2020-04-30,29917,2040,1069826,63006,US
2020-05-01,33955,2062,1103781,65068,US
2020-05-02,29288,1317,1133069,66385,US
2020-05-03,24972,1297,1158041,67682,US
2020-05-04,22593,1252,1180634,68934,US
2020-05-05,23841,2144,1204475,71078,US
2020-05-06,24128,2353,1228603,73431,US
2020-05-07,28369,2239,1256972,75670,US
2020-05-08,26957,1510,1283929,77180,US
2020-05-09,25612,1614,1309541,78794,US
2020-05-10,20258,734,1329799,79528,US
2020-05-11,18117,1156,1347916,80684,US
2020-05-12,22048,1703,1369964,82387,US
2020-05-13,20782,1746,1390746,84133,US
2020-05-14,27143,1773,1417889,85906,US
2020-05-15,25508,1662,1443397,87568,US
2020-05-16,24487,1186,1467884,88754,US
2020-05-17,18873,808,1486757,89562,US
2020-05-18,21841,791,1508598,90353,US
2020-05-19,19970,1568,1528568,91921,US
2020-05-20,23285,1518,1551853,93439,US
2020-05-21,25434,1263,1577287,94702,US
2020-05-22,24147,1305,1601434,96007,US
2020-05-23,21236,1080,1622670,97087,US
2020-05-24,20568,633,1643238,97720,US
2020-05-25,19064,500,1662302,98220,US
2020-05-26,18910,696,1681212,98916,US
2020-05-27,18721,1526,1699933,100442,US
2020-05-28,21817,1175,1721750,101617,US
2020-05-29,25337,1219,1747087,102836,US
2020-05-30,23297,945,1770384,103781,US
2020-05-31,19807,602,1790191,104383,US
2020-06-01,21086,764,1811277,105147,US
2020-06-02,20544,1034,1831821,106181,US
2020-06-03,19699,994,1851520,107175,US
2020-06-04,21140,1036,1872660,108211,US
2020-06-05,25178,932,1897838,109143,US
2020-06-06,22223,659,1920061,109802,US
2020-06-07,22302,712,1942363,110514,US
2020-06-08,18822,493,1961185,111007,US
2020-06-09,18665,999,1979850,112006,US
2020-06-10,20614,918,2000464,112924,US
2020-06-11,22883,896,2023347,113820,US
2020-06-12,25639,849,2048986,114669,US
2020-06-13,25540,767,2074526,115436,US
2020-06-14,19543,296,2094069,115732,US
2020-06-15,19957,395,2114026,116127,US
2020-06-16,23705,836,2137731,116963,US
2020-06-17,25559,754,2163290,117717,US
2020-06-18,27762,717,2191052,118434,US
2020-06-19,29909,678,2220961,119112,US
2020-06-20,34158,607,2255119,119719,US
2020-06-21,25793,256,2280912,119975,US
2020-06-22,31390,427,2312302,120402,US
2020-06-23,34720,826,2347022,121228,US
2020-06-24,34339,751,2381361,121979,US
2020-06-25,40949,2437,2422310,124416,US
2020-06-26,45527,623,2467837,125039,US
2020-03-14,6,0,6,0,UY
2020-03-15,2,0,8,0,UY
2020-03-16,21,0,29,0,UY
2020-03-17,21,0,50,0,UY
2020-03-18,29,0,79,0,UY
2020-03-19,15,0,94,0,UY
2020-03-20,16,0,110,0,UY
2020-03-21,25,0,135,0,UY
2020-03-22,23,0,158,0,UY
2020-03-23,4,0,162,0,UY
2020-03-24,27,0,189,0,UY
2020-03-25,28,0,217,0,UY
2020-03-26,21,0,238,0,UY
2020-03-27,0,0,238,0,UY
2020-03-28,21,0,259,0,UY
2020-03-29,36,1,295,1,UY
2020-03-30,29,0,324,1,UY
2020-03-31,6,0,330,1,UY
2020-04-01,11,1,341,2,UY
2020-04-02,18,2,359,4,UY
2020-04-03,12,0,371,4,UY
2020-04-04,19,1,390,5,UY
2020-04-05,17,1,407,6,UY
2020-04-06,4,0,411,6,UY
2020-04-07,6,1,417,7,UY
2020-04-08,9,0,426,7,UY
2020-04-09,7,0,433,7,UY
2020-04-10,13,0,446,7,UY
2020-04-11,7,0,453,7,UY
2020-04-12,12,1,465,8,UY
2020-04-13,7,0,472,8,UY
2020-04-14,11,0,483,8,UY
2020-04-15,10,1,493,9,UY
2020-04-16,9,0,502,9,UY
2020-04-17,6,0,508,9,UY
2020-04-18,9,0,517,9,UY
2020-04-19,11,1,528,10,UY
2020-04-20,7,0,535,10,UY
2020-04-21,8,2,543,12,UY
2020-04-22,6,0,549,12,UY
2020-04-23,8,0,557,12,UY
2020-04-24,6,0,563,12,UY
2020-04-25,33,2,596,14,UY
2020-04-26,10,1,606,15,UY
2020-04-27,14,0,620,15,UY
2020-04-28,5,0,625,15,UY
2020-04-29,5,0,630,15,UY
2020-04-30,13,2,643,17,UY
2020-05-01,5,0,648,17,UY
2020-05-02,4,0,652,17,UY
2020-05-03,3,0,655,17,UY
2020-05-04,2,0,657,17,UY
2020-05-05,13,0,670,17,UY
2020-05-06,3,0,673,17,UY
2020-05-07,11,0,684,17,UY
2020-05-08,10,1,694,18,UY
2020-05-09,8,0,702,18,UY
2020-05-10,5,1,707,19,UY
2020-05-11,4,0,711,19,UY
2020-05-12,6,0,717,19,UY
2020-05-13,2,0,719,19,UY
2020-05-14,5,0,724,19,UY
2020-05-15,8,0,732,19,UY
2020-05-16,1,0,733,19,UY
2020-05-17,1,1,734,20,UY
2020-05-18,3,0,737,20,UY
2020-05-19,1,0,738,20,UY
2020-05-20,8,0,746,20,UY
2020-05-21,3,0,749,20,UY
2020-05-22,4,0,753,20,UY
2020-05-23,11,2,764,22,UY
2020-05-24,5,0,769,22,UY
2020-05-25,18,0,787,22,UY
2020-05-26,2,0,789,22,UY
2020-05-27,14,0,803,22,UY
2020-05-28,8,0,811,22,UY
2020-05-29,5,0,816,22,UY
2020-05-30,5,0,821,22,UY
2020-05-31,2,0,823,22,UY
2020-06-01,2,1,825,23,UY
2020-06-02,1,0,826,23,UY
2020-06-03,2,0,828,23,UY
2020-06-04,4,0,832,23,UY
2020-06-05,2,0,834,23,UY
2020-06-06,11,0,845,23,UY
2020-06-07,0,0,845,23,UY
2020-06-08,0,0,845,23,UY
2020-06-09,1,0,846,23,UY
2020-06-10,1,0,847,23,UY
2020-06-11,0,0,847,23,UY
2020-06-12,0,0,847,23,UY
2020-06-13,0,0,847,23,UY
2020-06-14,1,0,848,23,UY
2020-06-15,0,0,848,23,UY
2020-06-16,1,1,849,24,UY
2020-06-17,0,0,849,24,UY
2020-06-18,1,0,850,24,UY
2020-06-19,3,0,853,24,UY
2020-06-20,6,1,859,25,UY
2020-06-21,17,0,876,25,UY
2020-06-22,6,0,882,25,UY
2020-06-23,3,0,885,25,UY
2020-06-24,17,1,902,26,UY
2020-06-25,5,0,907,26,UY
2020-06-26,12,0,919,26,UY
2020-03-15,6,0,6,0,UZ
2020-03-16,2,0,8,0,UZ
2020-03-17,8,0,16,0,UZ
2020-03-18,7,0,23,0,UZ
2020-03-19,0,0,23,0,UZ
2020-03-20,10,0,33,0,UZ
2020-03-21,0,0,33,0,UZ
2020-03-22,13,0,46,0,UZ
2020-03-23,3,0,49,0,UZ
2020-03-24,6,0,55,0,UZ
2020-03-25,10,0,65,0,UZ
2020-03-26,18,0,83,0,UZ
2020-03-27,21,0,104,0,UZ
2020-03-28,29,1,133,1,UZ
2020-03-29,12,0,145,1,UZ
2020-03-30,4,1,149,2,UZ
2020-03-31,24,0,173,2,UZ
2020-04-01,14,0,187,2,UZ
2020-04-02,3,0,190,2,UZ
2020-04-03,37,0,227,2,UZ
2020-04-04,39,0,266,2,UZ
2020-04-05,76,0,342,2,UZ
2020-04-06,55,0,397,2,UZ
2020-04-07,107,0,504,2,UZ
2020-04-08,51,1,555,3,UZ
2020-04-09,27,0,582,3,UZ
2020-04-10,42,0,624,3,UZ
2020-04-11,172,1,796,4,UZ
2020-04-12,69,0,865,4,UZ
2020-04-13,133,0,998,4,UZ
2020-04-14,167,0,1165,4,UZ
2020-04-15,137,0,1302,4,UZ
2020-04-16,78,0,1380,4,UZ
2020-04-17,70,0,1450,4,UZ
2020-04-18,45,1,1495,5,UZ
2020-04-19,70,0,1565,5,UZ
2020-04-20,92,0,1657,5,UZ
2020-04-21,35,1,1692,6,UZ
2020-04-22,24,1,1716,7,UZ
2020-04-23,62,0,1778,7,UZ
2020-04-24,58,1,1836,8,UZ
2020-04-25,29,0,1865,8,UZ
2020-04-26,22,0,1887,8,UZ
2020-04-27,17,0,1904,8,UZ
2020-04-28,35,0,1939,8,UZ
2020-04-29,63,1,2002,9,UZ
2020-04-30,44,0,2046,9,UZ
2020-05-01,48,0,2094,9,UZ
2020-05-02,33,0,2127,9,UZ
2020-05-03,22,1,2149,10,UZ
2020-05-04,40,0,2189,10,UZ
2020-05-05,18,0,2207,10,UZ
2020-05-06,26,0,2233,10,UZ
2020-05-07,65,0,2298,10,UZ
2020-05-08,38,0,2336,10,UZ
2020-05-09,51,0,2387,10,UZ
2020-05-10,31,0,2418,10,UZ
2020-05-11,91,0,2509,10,UZ
2020-05-12,38,0,2547,10,UZ
2020-05-13,65,1,2612,11,UZ
2020-05-14,33,0,2645,11,UZ
2020-05-15,46,0,2691,11,UZ
2020-05-16,50,0,2741,11,UZ
2020-05-17,12,1,2753,12,UZ
2020-05-18,49,1,2802,13,UZ
2020-05-19,78,0,2880,13,UZ
2020-05-20,70,0,2950,13,UZ
2020-05-21,56,0,3006,13,UZ
2020-05-22,72,0,3078,13,UZ
2020-05-23,54,0,3132,13,UZ
2020-05-24,32,0,3164,13,UZ
2020-05-25,97,0,3261,13,UZ
2020-05-26,72,1,3333,14,UZ
2020-05-27,0,0,3333,14,UZ
2020-05-28,111,0,3444,14,UZ
2020-05-29,69,0,3513,14,UZ
2020-05-30,41,0,3554,14,UZ
2020-05-31,108,1,3662,15,UZ
2020-06-01,56,0,3718,15,UZ
2020-06-02,51,0,3769,15,UZ
2020-06-03,105,1,3874,16,UZ
2020-06-04,91,0,3965,16,UZ
2020-06-05,57,0,4022,16,UZ
2020-06-06,159,1,4181,17,UZ
2020-06-07,171,0,4352,17,UZ
2020-06-08,96,1,4448,18,UZ
2020-06-09,99,0,4547,18,UZ
2020-06-10,148,1,4695,19,UZ
2020-06-11,124,0,4819,19,UZ
2020-06-12,82,0,4901,19,UZ
2020-06-13,93,0,4994,19,UZ
2020-06-14,109,0,5103,19,UZ
2020-06-15,190,0,5293,19,UZ
2020-06-16,268,0,5561,19,UZ
2020-06-17,136,0,5697,19,UZ
2020-06-18,158,0,5855,19,UZ
2020-06-19,170,0,6025,19,UZ
2020-06-20,191,0,6216,19,UZ
2020-06-21,142,0,6358,19,UZ
2020-06-22,142,0,6500,19,UZ
2020-06-23,255,0,6755,19,UZ
2020-06-24,235,0,6990,19,UZ
2020-06-25,238,1,7228,20,UZ
2020-06-26,262,0,7490,20,UZ
2020-03-06,1,0,1,0,VA
2020-03-15,0,0,1,0,VA
2020-03-16,0,0,1,0,VA
2020-03-17,0,0,1,0,VA
2020-03-18,0,0,1,0,VA
2020-03-19,0,0,1,0,VA
2020-03-20,0,0,1,0,VA
2020-03-21,0,0,1,0,VA
2020-03-22,0,0,1,0,VA
2020-03-23,0,0,1,0,VA
2020-03-24,0,0,1,0,VA
2020-03-25,0,0,1,0,VA
2020-03-26,4,0,5,0,VA
2020-03-27,0,0,5,0,VA
2020-03-28,1,0,6,0,VA
2020-03-29,0,0,6,0,VA
2020-03-30,0,0,6,0,VA
2020-03-31,0,0,6,0,VA
2020-04-01,0,0,6,0,VA
2020-04-02,0,0,6,0,VA
2020-04-03,1,0,7,0,VA
2020-04-04,0,0,7,0,VA
2020-04-05,0,0,7,0,VA
2020-04-06,0,0,7,0,VA
2020-04-07,0,0,7,0,VA
2020-04-08,1,0,8,0,VA
2020-04-09,0,0,8,0,VA
2020-04-10,0,0,8,0,VA
2020-04-11,0,0,8,0,VA
2020-04-12,0,0,8,0,VA
2020-04-13,0,0,8,0,VA
2020-04-14,0,0,8,0,VA
2020-04-15,0,0,8,0,VA
2020-04-16,0,0,8,0,VA
2020-04-17,0,0,8,0,VA
2020-04-18,0,0,8,0,VA
2020-04-19,0,0,8,0,VA
2020-04-20,1,0,9,0,VA
2020-04-21,0,0,9,0,VA
2020-04-22,0,0,9,0,VA
2020-04-23,0,0,9,0,VA
2020-04-24,0,0,9,0,VA
2020-04-25,0,0,9,0,VA
2020-04-26,0,0,9,0,VA
2020-04-27,0,0,9,0,VA
2020-04-28,0,0,9,0,VA
2020-04-29,1,0,10,0,VA
2020-04-30,1,0,11,0,VA
2020-05-01,0,0,11,0,VA
2020-05-02,0,0,11,0,VA
2020-05-03,0,0,11,0,VA
2020-05-04,0,0,11,0,VA
2020-05-05,0,0,11,0,VA
2020-05-06,1,0,12,0,VA
2020-05-07,0,0,12,0,VA
2020-05-08,0,0,12,0,VA
2020-05-09,0,0,12,0,VA
2020-05-10,0,0,12,0,VA
2020-05-11,0,0,12,0,VA
2020-05-12,0,0,12,0,VA
2020-05-13,0,0,12,0,VA
2020-05-14,0,0,12,0,VA
2020-05-15,0,0,12,0,VA
2020-05-16,0,0,12,0,VA
2020-05-17,0,0,12,0,VA
2020-05-18,0,0,12,0,VA
2020-05-19,0,0,12,0,VA
2020-05-20,0,0,12,0,VA
2020-05-21,0,0,12,0,VA
2020-05-22,0,0,12,0,VA
2020-05-23,0,0,12,0,VA
2020-05-24,0,0,12,0,VA
2020-05-25,0,0,12,0,VA
2020-05-26,0,0,12,0,VA
2020-05-27,0,0,12,0,VA
2020-05-28,0,0,12,0,VA
2020-05-29,0,0,12,0,VA
2020-05-30,0,0,12,0,VA
2020-05-31,0,0,12,0,VA
2020-06-01,0,0,12,0,VA
2020-06-02,0,0,12,0,VA
2020-06-03,0,0,12,0,VA
2020-06-04,0,0,12,0,VA
2020-06-05,0,0,12,0,VA
2020-06-06,0,0,12,0,VA
2020-06-07,0,0,12,0,VA
2020-06-08,0,0,12,0,VA
2020-06-09,0,0,12,0,VA
2020-06-10,0,0,12,0,VA
2020-06-11,0,0,12,0,VA
2020-06-12,0,0,12,0,VA
2020-06-13,0,0,12,0,VA
2020-06-14,0,0,12,0,VA
2020-06-15,0,0,12,0,VA
2020-06-16,0,0,12,0,VA
2020-06-17,0,0,12,0,VA
2020-06-18,0,0,12,0,VA
2020-06-19,0,0,12,0,VA
2020-06-20,0,0,12,0,VA
2020-06-21,0,0,12,0,VA
2020-06-22,0,0,12,0,VA
2020-06-23,0,0,12,0,VA
2020-06-24,0,0,12,0,VA
2020-06-25,0,0,12,0,VA
2020-06-26,0,0,12,0,VA
2020-03-12,1,0,1,0,VC
2020-03-24,0,0,1,0,VC
2020-03-25,0,0,1,0,VC
2020-03-26,0,0,1,0,VC
2020-03-27,0,0,1,0,VC
2020-03-28,0,0,1,0,VC
2020-03-29,0,0,1,0,VC
2020-03-30,0,0,1,0,VC
2020-03-31,0,0,1,0,VC
2020-04-01,1,0,2,0,VC
2020-04-02,0,0,2,0,VC
2020-04-03,5,0,7,0,VC
2020-04-04,0,0,7,0,VC
2020-04-05,0,0,7,0,VC
2020-04-06,0,0,7,0,VC
2020-04-07,1,0,8,0,VC
2020-04-08,0,0,8,0,VC
2020-04-09,4,0,12,0,VC
2020-04-10,0,0,12,0,VC
2020-04-11,0,0,12,0,VC
2020-04-12,0,0,12,0,VC
2020-04-13,0,0,12,0,VC
2020-04-14,0,0,12,0,VC
2020-04-15,0,0,12,0,VC
2020-04-16,0,0,12,0,VC
2020-04-17,0,0,12,0,VC
2020-04-18,0,0,12,0,VC
2020-04-19,0,0,12,0,VC
2020-04-20,0,0,12,0,VC
2020-04-21,0,0,12,0,VC
2020-04-22,1,0,13,0,VC
2020-04-23,0,0,13,0,VC
2020-04-24,1,0,14,0,VC
2020-04-25,0,0,14,0,VC
2020-04-26,0,0,14,0,VC
2020-04-27,1,0,15,0,VC
2020-04-28,1,0,16,0,VC
2020-04-29,0,0,16,0,VC
2020-04-30,0,0,16,0,VC
2020-05-01,0,0,16,0,VC
2020-05-02,0,0,16,0,VC
2020-05-03,1,0,17,0,VC
2020-05-04,0,0,17,0,VC
2020-05-05,0,0,17,0,VC
2020-05-06,0,0,17,0,VC
2020-05-07,0,0,17,0,VC
2020-05-08,0,0,17,0,VC
2020-05-09,0,0,17,0,VC
2020-05-10,0,0,17,0,VC
2020-05-11,0,0,17,0,VC
2020-05-12,0,0,17,0,VC
2020-05-13,0,0,17,0,VC
2020-05-14,0,0,17,0,VC
2020-05-15,0,0,17,0,VC
2020-05-16,0,0,17,0,VC
2020-05-17,0,0,17,0,VC
2020-05-18,0,0,17,0,VC
2020-05-19,0,0,17,0,VC
2020-05-20,1,0,18,0,VC
2020-05-21,0,0,18,0,VC
2020-05-22,0,0,18,0,VC
2020-05-23,0,0,18,0,VC
2020-05-24,0,0,18,0,VC
2020-05-25,0,0,18,0,VC
2020-05-26,0,0,18,0,VC
2020-05-27,0,0,18,0,VC
2020-05-28,7,0,25,0,VC
2020-05-29,1,0,26,0,VC
2020-05-30,0,0,26,0,VC
2020-05-31,0,0,26,0,VC
2020-06-01,0,0,26,0,VC
2020-06-02,0,0,26,0,VC
2020-06-03,0,0,26,0,VC
2020-06-04,0,0,26,0,VC
2020-06-05,0,0,26,0,VC
2020-06-06,0,0,26,0,VC
2020-06-07,0,0,26,0,VC
2020-06-08,1,0,27,0,VC
2020-06-09,0,0,27,0,VC
2020-06-10,0,0,27,0,VC
2020-06-11,0,0,27,0,VC
2020-06-12,0,0,27,0,VC
2020-06-13,0,0,27,0,VC
2020-06-14,0,0,27,0,VC
2020-06-15,0,0,27,0,VC
2020-06-16,2,0,29,0,VC
2020-06-17,0,0,29,0,VC
2020-06-18,0,0,29,0,VC
2020-06-19,0,0,29,0,VC
2020-06-20,0,0,29,0,VC
2020-06-21,0,0,29,0,VC
2020-06-22,0,0,29,0,VC
2020-06-23,0,0,29,0,VC
2020-06-24,0,0,29,0,VC
2020-06-25,0,0,29,0,VC
2020-06-26,0,0,29,0,VC
2020-03-14,10,0,10,0,VE
2020-03-15,5,0,15,0,VE
2020-03-16,18,0,33,0,VE
2020-03-17,0,0,33,0,VE
2020-03-18,0,0,33,0,VE
2020-03-19,0,0,33,0,VE
2020-03-20,3,0,36,0,VE
2020-03-21,0,0,36,0,VE
2020-03-22,0,0,36,0,VE
2020-03-23,48,0,84,0,VE
2020-03-24,7,0,91,0,VE
2020-03-25,15,0,106,0,VE
2020-03-26,1,1,107,1,VE
2020-03-27,12,0,119,1,VE
2020-03-28,0,0,119,1,VE
2020-03-29,0,0,119,1,VE
2020-03-30,16,2,135,3,VE
2020-03-31,0,0,135,3,VE
2020-04-01,8,0,143,3,VE
2020-04-02,1,0,144,3,VE
2020-04-03,0,0,144,3,VE
2020-04-04,0,2,144,5,VE
2020-04-05,4,0,148,5,VE
2020-04-06,11,0,159,5,VE
2020-04-07,7,2,166,7,VE
2020-04-08,1,1,167,8,VE
2020-04-09,4,1,171,9,VE
2020-04-10,4,0,175,9,VE
2020-04-11,0,0,175,9,VE
2020-04-12,6,0,181,9,VE
2020-04-13,8,0,189,9,VE
2020-04-14,4,0,193,9,VE
2020-04-15,4,0,197,9,VE
2020-04-16,7,0,204,9,VE
2020-04-17,23,0,227,9,VE
2020-04-18,0,0,227,9,VE
2020-04-19,29,0,256,9,VE
2020-04-20,0,0,256,9,VE
2020-04-21,29,1,285,10,VE
2020-04-22,3,0,288,10,VE
2020-04-23,10,0,298,10,VE
2020-04-24,20,0,318,10,VE
2020-04-25,5,0,323,10,VE
2020-04-26,2,0,325,10,VE
2020-04-27,4,0,329,10,VE
2020-04-28,0,0,329,10,VE
2020-04-29,2,0,331,10,VE
2020-04-30,2,0,333,10,VE
2020-05-01,2,0,335,10,VE
2020-05-02,10,0,345,10,VE
2020-05-03,12,0,357,10,VE
2020-05-04,4,0,361,10,VE
2020-05-05,6,0,367,10,VE
2020-05-06,12,0,379,10,VE
2020-05-07,2,0,381,10,VE
2020-05-08,7,0,388,10,VE
2020-05-09,14,0,402,10,VE
2020-05-10,12,0,414,10,VE
2020-05-11,8,0,422,10,VE
2020-05-12,1,0,423,10,VE
2020-05-13,17,0,440,10,VE
2020-05-14,15,0,455,10,VE
2020-05-15,4,0,459,10,VE
2020-05-16,45,0,504,10,VE
2020-05-17,37,0,541,10,VE
2020-05-18,77,0,618,10,VE
2020-05-19,131,0,749,10,VE
2020-05-20,75,0,824,10,VE
2020-05-21,58,0,882,10,VE
2020-05-22,62,0,944,10,VE
2020-05-23,0,0,944,10,VE
2020-05-24,177,0,1121,10,VE
2020-05-25,56,0,1177,10,VE
2020-05-26,34,1,1211,11,VE
2020-05-27,34,0,1245,11,VE
2020-05-28,82,0,1327,11,VE
2020-05-29,42,3,1369,14,VE
2020-05-30,90,0,1459,14,VE
2020-05-31,51,0,1510,14,VE
2020-06-01,152,3,1662,17,VE
2020-06-02,157,1,1819,18,VE
2020-06-03,133,2,1952,20,VE
2020-06-04,135,0,2087,20,VE
2020-06-05,58,0,2145,20,VE
2020-06-06,171,2,2316,22,VE
2020-06-07,61,0,2377,22,VE
2020-06-08,96,0,2473,22,VE
2020-06-09,159,1,2632,23,VE
2020-06-10,106,0,2738,23,VE
2020-06-11,76,0,2814,23,VE
2020-06-12,65,0,2879,23,VE
2020-06-13,25,1,2904,24,VE
2020-06-14,74,1,2978,25,VE
2020-06-15,84,1,3062,26,VE
2020-06-16,88,1,3150,27,VE
2020-06-18,334,1,3484,28,VE
2020-06-19,107,2,3591,30,VE
2020-06-20,199,3,3790,33,VE
2020-06-21,128,0,3918,33,VE
2020-06-22,130,2,4048,35,VE
2020-06-23,138,0,4186,35,VE
2020-06-24,179,3,4365,38,VE
2020-06-25,198,1,4563,39,VE
2020-06-26,216,2,4779,41,VE
2020-03-26,2,0,2,0,VG
2020-03-27,0,0,2,0,VG
2020-03-28,0,0,2,0,VG
2020-03-29,0,0,2,0,VG
2020-03-30,1,0,3,0,VG
2020-03-31,0,0,3,0,VG
2020-04-01,0,0,3,0,VG
2020-04-02,0,0,3,0,VG
2020-04-03,0,0,3,0,VG
2020-04-04,0,0,3,0,VG
2020-04-05,0,0,3,0,VG
2020-04-06,0,0,3,0,VG
2020-04-07,0,0,3,0,VG
2020-04-08,0,0,3,0,VG
2020-04-09,0,0,3,0,VG
2020-04-10,0,0,3,0,VG
2020-04-11,0,0,3,0,VG
2020-04-12,0,0,3,0,VG
2020-04-13,0,0,3,0,VG
2020-04-14,0,0,3,0,VG
2020-04-15,0,0,3,0,VG
2020-04-16,0,0,3,0,VG
2020-04-17,0,0,3,0,VG
2020-04-18,0,0,3,0,VG
2020-04-19,1,1,4,1,VG
2020-04-20,1,0,5,1,VG
2020-04-21,0,0,5,1,VG
2020-04-22,0,0,5,1,VG
2020-04-23,0,0,5,1,VG
2020-04-24,1,0,6,1,VG
2020-04-25,0,0,6,1,VG
2020-04-26,0,0,6,1,VG
2020-04-27,0,0,6,1,VG
2020-04-28,0,0,6,1,VG
2020-04-29,0,0,6,1,VG
2020-04-30,0,0,6,1,VG
2020-05-01,0,0,6,1,VG
2020-05-02,0,0,6,1,VG
2020-05-03,0,0,6,1,VG
2020-05-04,1,0,7,1,VG
2020-05-05,0,0,7,1,VG
2020-05-06,0,0,7,1,VG
2020-05-07,0,0,7,1,VG
2020-05-08,0,0,7,1,VG
2020-05-09,0,0,7,1,VG
2020-05-10,0,0,7,1,VG
2020-05-11,0,0,7,1,VG
2020-05-12,0,0,7,1,VG
2020-05-13,0,0,7,1,VG
2020-05-14,1,0,8,1,VG
2020-05-15,0,0,8,1,VG
2020-05-16,0,0,8,1,VG
2020-05-17,0,0,8,1,VG
2020-05-18,0,0,8,1,VG
2020-05-19,0,0,8,1,VG
2020-05-20,0,0,8,1,VG
2020-05-21,0,0,8,1,VG
2020-05-22,0,0,8,1,VG
2020-05-23,0,0,8,1,VG
2020-05-24,0,0,8,1,VG
2020-05-25,0,0,8,1,VG
2020-05-26,0,0,8,1,VG
2020-05-27,0,0,8,1,VG
2020-05-28,0,0,8,1,VG
2020-05-29,0,0,8,1,VG
2020-05-30,0,0,8,1,VG
2020-05-31,0,0,8,1,VG
2020-06-01,0,0,8,1,VG
2020-06-02,0,0,8,1,VG
2020-06-03,0,0,8,1,VG
2020-06-04,0,0,8,1,VG
2020-06-05,0,0,8,1,VG
2020-06-06,0,0,8,1,VG
2020-06-07,0,0,8,1,VG
2020-06-08,0,0,8,1,VG
2020-06-09,0,0,8,1,VG
2020-06-10,0,0,8,1,VG
2020-06-11,0,0,8,1,VG
2020-06-12,0,0,8,1,VG
2020-06-13,0,0,8,1,VG
2020-06-14,0,0,8,1,VG
2020-06-15,0,0,8,1,VG
2020-06-16,0,0,8,1,VG
2020-06-17,0,0,8,1,VG
2020-06-18,0,0,8,1,VG
2020-06-19,0,0,8,1,VG
2020-06-20,0,0,8,1,VG
2020-06-21,0,0,8,1,VG
2020-06-22,0,0,8,1,VG
2020-06-23,0,0,8,1,VG
2020-06-24,0,0,8,1,VG
2020-06-25,0,0,8,1,VG
2020-06-26,0,0,8,1,VG
2020-03-23,17,0,17,0,VI
2020-03-24,0,0,17,0,VI
2020-03-25,0,0,17,0,VI
2020-03-26,0,0,17,0,VI
2020-03-27,2,0,19,0,VI
2020-03-28,3,0,22,0,VI
2020-03-29,8,0,30,0,VI
2020-03-31,0,0,30,0,VI
2020-04-01,0,0,30,0,VI
2020-04-02,3,0,33,0,VI
2020-04-03,7,0,40,0,VI
2020-04-04,0,0,40,0,VI
2020-04-05,2,1,42,1,VI
2020-04-06,0,0,42,1,VI
2020-04-07,3,0,45,1,VI
2020-04-08,0,0,45,1,VI
2020-04-09,5,0,50,1,VI
2020-04-10,0,0,50,1,VI
2020-04-11,1,0,51,1,VI
2020-04-12,0,0,51,1,VI
2020-04-13,0,0,51,1,VI
2020-04-14,0,0,51,1,VI
2020-04-15,0,0,51,1,VI
2020-04-16,0,0,51,1,VI
2020-04-17,0,1,51,2,VI
2020-04-18,2,1,53,3,VI
2020-04-19,0,0,53,3,VI
2020-04-20,1,0,54,3,VI
2020-04-21,0,0,54,3,VI
2020-04-22,0,0,54,3,VI
2020-04-23,0,0,54,3,VI
2020-04-24,0,0,54,3,VI
2020-04-25,1,0,55,3,VI
2020-04-26,0,0,55,3,VI
2020-04-27,4,1,59,4,VI
2020-04-28,0,0,59,4,VI
2020-04-29,7,0,66,4,VI
2020-04-30,0,0,66,4,VI
2020-05-01,0,0,66,4,VI
2020-05-02,0,0,66,4,VI
2020-05-03,0,0,66,4,VI
2020-05-04,0,0,66,4,VI
2020-05-05,0,0,66,4,VI
2020-05-06,0,0,66,4,VI
2020-05-07,0,0,66,4,VI
2020-05-08,2,0,68,4,VI
2020-05-09,1,0,69,4,VI
2020-05-10,0,0,69,4,VI
2020-05-11,0,1,69,5,VI
2020-05-12,0,0,69,5,VI
2020-05-13,0,1,69,6,VI
2020-05-14,0,0,69,6,VI
2020-05-15,0,0,69,6,VI
2020-05-16,0,0,69,6,VI
2020-05-17,0,0,69,6,VI
2020-05-18,0,0,69,6,VI
2020-05-19,0,0,69,6,VI
2020-05-20,0,0,69,6,VI
2020-05-21,0,0,69,6,VI
2020-05-22,0,0,69,6,VI
2020-05-23,0,0,69,6,VI
2020-05-24,0,0,69,6,VI
2020-05-25,0,0,69,6,VI
2020-05-26,0,0,69,6,VI
2020-05-27,0,0,69,6,VI
2020-05-28,0,0,69,6,VI
2020-05-29,0,0,69,6,VI
2020-05-30,0,0,69,6,VI
2020-05-31,0,0,69,6,VI
2020-06-01,1,0,70,6,VI
2020-06-02,0,0,70,6,VI
2020-06-03,0,0,70,6,VI
2020-06-04,1,0,71,6,VI
2020-06-05,0,0,71,6,VI
2020-06-06,0,0,71,6,VI
2020-06-07,0,0,71,6,VI
2020-06-08,0,0,71,6,VI
2020-06-09,0,0,71,6,VI
2020-06-10,1,0,72,6,VI
2020-06-11,0,0,72,6,VI
2020-06-12,0,0,72,6,VI
2020-06-13,0,0,72,6,VI
2020-06-14,1,0,73,6,VI
2020-06-15,0,0,73,6,VI
2020-06-16,0,0,73,6,VI
2020-06-17,0,0,73,6,VI
2020-06-18,0,0,73,6,VI
2020-06-19,1,0,74,6,VI
2020-06-20,0,0,74,6,VI
2020-06-21,2,0,76,6,VI
2020-06-22,0,0,76,6,VI
2020-06-23,0,0,76,6,VI
2020-06-24,4,0,80,6,VI
2020-06-25,1,0,81,6,VI
2020-06-26,0,0,81,6,VI
2019-12-30,0,0,0,0,VN
2019-12-31,0,0,0,0,VN
2020-01-01,0,0,0,0,VN
2020-01-02,0,0,0,0,VN
2020-01-03,0,0,0,0,VN
2020-01-04,0,0,0,0,VN
2020-01-05,0,0,0,0,VN
2020-01-06,0,0,0,0,VN
2020-01-07,0,0,0,0,VN
2020-01-08,0,0,0,0,VN
2020-01-09,0,0,0,0,VN
2020-01-10,0,0,0,0,VN
2020-01-11,0,0,0,0,VN
2020-01-12,0,0,0,0,VN
2020-01-13,0,0,0,0,VN
2020-01-14,0,0,0,0,VN
2020-01-15,0,0,0,0,VN
2020-01-16,0,0,0,0,VN
2020-01-17,0,0,0,0,VN
2020-01-18,0,0,0,0,VN
2020-01-19,0,0,0,0,VN
2020-01-20,0,0,0,0,VN
2020-01-21,0,0,0,0,VN
2020-01-22,0,0,0,0,VN
2020-01-23,2,0,2,0,VN
2020-01-24,0,0,2,0,VN
2020-01-25,0,0,2,0,VN
2020-01-26,0,0,2,0,VN
2020-01-27,0,0,2,0,VN
2020-01-28,0,0,2,0,VN
2020-01-29,0,0,2,0,VN
2020-01-30,3,0,5,0,VN
2020-01-31,0,0,5,0,VN
2020-02-01,2,0,7,0,VN
2020-02-02,1,0,8,0,VN
2020-02-03,1,0,9,0,VN
2020-02-04,1,0,10,0,VN
2020-02-05,0,0,10,0,VN
2020-02-06,2,0,12,0,VN
2020-02-07,1,0,13,0,VN
2020-02-08,1,0,14,0,VN
2020-02-09,0,0,14,0,VN
2020-02-10,1,0,15,0,VN
2020-02-11,0,0,15,0,VN
2020-02-12,1,0,16,0,VN
2020-02-13,0,0,16,0,VN
2020-02-14,0,0,16,0,VN
2020-02-15,0,0,16,0,VN
2020-02-16,0,0,16,0,VN
2020-02-17,0,0,16,0,VN
2020-02-18,0,0,16,0,VN
2020-02-19,0,0,16,0,VN
2020-02-20,0,0,16,0,VN
2020-02-21,0,0,16,0,VN
2020-02-22,0,0,16,0,VN
2020-02-23,0,0,16,0,VN
2020-02-24,0,0,16,0,VN
2020-02-25,0,0,16,0,VN
2020-02-26,0,0,16,0,VN
2020-02-27,0,0,16,0,VN
2020-02-28,0,0,16,0,VN
2020-02-29,0,0,16,0,VN
2020-03-01,0,0,16,0,VN
2020-03-06,1,0,17,0,VN
2020-03-07,4,0,21,0,VN
2020-03-08,9,0,30,0,VN
2020-03-09,4,0,34,0,VN
2020-03-10,4,0,38,0,VN
2020-03-11,1,0,39,0,VN
2020-03-12,5,0,44,0,VN
2020-03-13,9,0,53,0,VN
2020-03-14,0,0,53,0,VN
2020-03-15,4,0,57,0,VN
2020-03-16,4,0,61,0,VN
2020-03-17,7,0,68,0,VN
2020-03-18,8,0,76,0,VN
2020-03-19,11,0,87,0,VN
2020-03-20,1,0,88,0,VN
2020-03-21,7,0,95,0,VN
2020-03-22,26,0,121,0,VN
2020-03-23,11,0,132,0,VN
2020-03-24,5,0,137,0,VN
2020-03-25,16,0,153,0,VN
2020-03-26,10,0,163,0,VN
2020-03-27,8,0,171,0,VN
2020-03-28,17,0,188,0,VN
2020-03-29,15,0,203,0,VN
2020-03-30,3,0,206,0,VN
2020-03-31,6,0,212,0,VN
2020-04-01,21,0,233,0,VN
2020-04-02,3,0,236,0,VN
2020-04-03,4,0,240,0,VN
2020-04-04,1,0,241,0,VN
2020-04-05,4,0,245,0,VN
2020-04-06,6,0,251,0,VN
2020-04-07,0,0,251,0,VN
2020-04-08,4,0,255,0,VN
2020-04-09,2,0,257,0,VN
2020-04-10,1,0,258,0,VN
2020-04-11,4,0,262,0,VN
2020-04-12,2,0,264,0,VN
2020-04-13,3,0,267,0,VN
2020-04-14,1,0,268,0,VN
2020-04-15,0,0,268,0,VN
2020-04-16,0,0,268,0,VN
2020-04-17,0,0,268,0,VN
2020-04-18,0,0,268,0,VN
2020-04-19,0,0,268,0,VN
2020-04-20,0,0,268,0,VN
2020-04-21,0,0,268,0,VN
2020-04-22,0,0,268,0,VN
2020-04-23,2,0,270,0,VN
2020-04-24,0,0,270,0,VN
2020-04-25,0,0,270,0,VN
2020-04-26,0,0,270,0,VN
2020-04-27,0,0,270,0,VN
2020-04-28,0,0,270,0,VN
2020-04-29,0,0,270,0,VN
2020-04-30,0,0,270,0,VN
2020-05-01,0,0,270,0,VN
2020-05-02,0,0,270,0,VN
2020-05-03,1,0,271,0,VN
2020-05-04,0,0,271,0,VN
2020-05-05,0,0,271,0,VN
2020-05-06,0,0,271,0,VN
2020-05-07,17,0,288,0,VN
2020-05-08,0,0,288,0,VN
2020-05-09,0,0,288,0,VN
2020-05-10,0,0,288,0,VN
2020-05-11,0,0,288,0,VN
2020-05-12,0,0,288,0,VN
2020-05-13,0,0,288,0,VN
2020-05-14,24,0,312,0,VN
2020-05-15,1,0,313,0,VN
2020-05-16,5,0,318,0,VN
2020-05-17,2,0,320,0,VN
2020-05-18,4,0,324,0,VN
2020-05-19,0,0,324,0,VN
2020-05-20,0,0,324,0,VN
2020-05-21,0,0,324,0,VN
2020-05-22,0,0,324,0,VN
2020-05-23,0,0,324,0,VN
2020-05-24,1,0,325,0,VN
2020-05-25,1,0,326,0,VN
2020-05-26,1,0,327,0,VN
2020-05-27,0,0,327,0,VN
2020-05-28,0,0,327,0,VN
2020-05-29,0,0,327,0,VN
2020-05-30,0,0,327,0,VN
2020-05-31,1,0,328,0,VN
2020-06-01,0,0,328,0,VN
2020-06-02,0,0,328,0,VN
2020-06-03,0,0,328,0,VN
2020-06-04,0,0,328,0,VN
2020-06-05,1,0,329,0,VN
2020-06-06,0,0,329,0,VN
2020-06-07,2,0,331,0,VN
2020-06-08,1,0,332,0,VN
2020-06-09,0,0,332,0,VN
2020-06-10,0,0,332,0,VN
2020-06-11,0,0,332,0,VN
2020-06-12,1,0,333,0,VN
2020-06-13,1,0,334,0,VN
2020-06-14,0,0,334,0,VN
2020-06-15,0,0,334,0,VN
2020-06-16,1,0,335,0,VN
2020-06-17,0,0,335,0,VN
2020-06-18,7,0,342,0,VN
2020-06-19,7,0,349,0,VN
2020-06-20,0,0,349,0,VN
2020-06-21,0,0,349,0,VN
2020-06-22,0,0,349,0,VN
2020-06-23,0,0,349,0,VN
2020-06-24,3,0,352,0,VN
2020-06-25,0,0,352,0,VN
2020-06-26,1,0,353,0,VN
2020-03-16,2,0,2,0,XK
2020-03-17,0,0,2,0,XK
2020-03-18,17,0,19,0,XK
2020-03-19,0,0,19,0,XK
2020-03-20,2,0,21,0,XK
2020-03-21,3,0,24,0,XK
2020-03-22,0,0,24,0,XK
2020-03-23,7,1,31,1,XK
2020-03-24,30,0,61,1,XK
2020-03-25,2,0,63,1,XK
2020-03-26,8,0,71,1,XK
2020-03-27,8,0,79,1,XK
2020-03-28,7,0,86,1,XK
2020-03-29,2,0,88,1,XK
2020-03-30,3,0,91,1,XK
2020-03-31,15,0,106,1,XK
2020-04-01,6,0,112,1,XK
2020-04-02,0,0,112,1,XK
2020-04-03,13,0,125,1,XK
2020-04-04,1,0,126,1,XK
2020-04-05,6,0,132,1,XK
2020-04-06,8,0,140,1,XK
2020-04-07,5,2,145,3,XK
2020-04-08,39,2,184,5,XK
2020-04-09,0,0,184,5,XK
2020-04-10,43,2,227,7,XK
2020-04-11,23,0,250,7,XK
2020-04-12,33,0,283,7,XK
2020-04-13,79,0,362,7,XK
2020-04-14,15,1,377,8,XK
2020-04-15,10,0,387,8,XK
2020-04-16,36,1,423,9,XK
2020-04-17,26,2,449,11,XK
2020-04-18,31,1,480,12,XK
2020-04-19,30,0,510,12,XK
2020-04-20,0,0,510,12,XK
2020-04-21,88,3,598,15,XK
2020-04-22,6,3,604,18,XK
2020-04-23,26,0,630,18,XK
2020-04-24,39,1,669,19,XK
2020-04-25,34,0,703,19,XK
2020-04-26,28,1,731,20,XK
2020-04-27,32,1,763,21,XK
2020-04-28,17,1,780,22,XK
2020-04-29,10,0,790,22,XK
2020-04-30,9,0,799,22,XK
2020-05-01,0,0,799,22,XK
2020-05-02,14,0,813,22,XK
2020-05-03,10,0,823,22,XK
2020-05-04,28,0,851,22,XK
2020-05-05,4,4,855,26,XK
2020-05-06,1,0,856,26,XK
2020-05-07,4,0,860,26,XK
2020-05-08,1,1,861,27,XK
2020-05-09,1,1,862,28,XK
2020-05-10,8,0,870,28,XK
2020-05-11,0,0,870,28,XK
2020-05-12,14,0,884,28,XK
2020-05-13,35,1,919,29,XK
2020-05-14,0,0,919,29,XK
2020-05-15,25,0,944,29,XK
2020-05-16,0,0,944,29,XK
2020-05-17,0,0,944,29,XK
2020-05-18,11,0,955,29,XK
2020-05-19,0,0,955,29,XK
2020-05-20,34,0,989,29,XK
2020-05-21,0,0,989,29,XK
2020-05-22,14,0,1003,29,XK
2020-05-23,1,0,1004,29,XK
2020-05-24,21,0,1025,29,XK
2020-05-25,7,0,1032,29,XK
2020-05-26,6,1,1038,30,XK
2020-05-27,0,0,1038,30,XK
2020-05-28,9,0,1047,30,XK
2020-05-29,1,0,1048,30,XK
2020-05-30,0,0,1048,30,XK
2020-05-31,16,0,1064,30,XK
2020-06-01,0,0,1064,30,XK
2020-06-02,0,0,1064,30,XK
2020-06-03,3,0,1067,30,XK
2020-06-04,75,0,1142,30,XK
2020-06-05,0,0,1142,30,XK
2020-06-06,0,0,1142,30,XK
2020-06-07,0,0,1142,30,XK
2020-06-08,0,0,1142,30,XK
2020-06-09,121,1,1263,31,XK
2020-06-10,0,0,1263,31,XK
2020-06-11,35,0,1298,31,XK
2020-06-12,28,0,1326,31,XK
2020-06-13,0,0,1326,31,XK
2020-06-14,111,1,1437,32,XK
2020-06-15,0,0,1437,32,XK
2020-06-16,49,1,1486,33,XK
2020-06-17,0,0,1486,33,XK
2020-06-18,0,0,1486,33,XK
2020-06-19,0,0,1486,33,XK
2020-06-20,0,0,1486,33,XK
2020-06-21,0,0,1486,33,XK
2020-06-22,0,0,1486,33,XK
2020-06-23,683,4,2169,37,XK
2020-06-24,0,0,2169,37,XK
2020-06-25,0,0,2169,37,XK
2020-06-26,0,0,2169,37,XK
2020-06-27,0,0,2169,37,XK
2020-04-09,1,0,1,0,YE
2020-04-10,0,0,1,0,YE
2020-04-11,0,0,1,0,YE
2020-04-12,0,0,1,0,YE
2020-04-13,0,0,1,0,YE
2020-04-14,0,0,1,0,YE
2020-04-15,0,0,1,0,YE
2020-04-16,0,0,1,0,YE
2020-04-17,0,0,1,0,YE
2020-04-18,0,0,1,0,YE
2020-04-19,0,0,1,0,YE
2020-04-20,0,0,1,0,YE
2020-04-21,0,0,1,0,YE
2020-04-22,0,0,1,0,YE
2020-04-23,0,0,1,0,YE
2020-04-24,0,0,1,0,YE
2020-04-25,0,0,1,0,YE
2020-04-26,0,0,1,0,YE
2020-04-27,0,0,1,0,YE
2020-04-28,0,0,1,0,YE
2020-04-29,5,0,6,0,YE
2020-04-30,0,2,6,2,YE
2020-05-01,1,0,7,2,YE
2020-05-02,3,0,10,2,YE
2020-05-03,0,0,10,2,YE
2020-05-04,2,0,12,2,YE
2020-05-05,9,1,21,3,YE
2020-05-06,4,2,25,5,YE
2020-05-07,1,1,26,6,YE
2020-05-08,8,1,34,7,YE
2020-05-09,0,0,34,7,YE
2020-05-10,17,1,51,8,YE
2020-05-11,5,1,56,9,YE
2020-05-12,11,2,67,11,YE
2020-05-13,3,1,70,12,YE
2020-05-14,17,1,87,13,YE
2020-05-15,19,2,106,15,YE
2020-05-16,18,4,124,19,YE
2020-05-17,4,1,128,20,YE
2020-05-18,2,0,130,20,YE
2020-05-19,37,8,167,28,YE
2020-05-20,13,1,180,29,YE
2020-05-21,13,4,193,33,YE
2020-05-22,12,0,205,33,YE
2020-05-23,7,6,212,39,YE
2020-05-24,10,3,222,42,YE
2020-05-25,15,3,237,45,YE
2020-05-26,12,4,249,49,YE
2020-05-27,6,4,255,53,YE
2020-05-28,23,4,278,57,YE
2020-05-29,9,9,287,66,YE
2020-05-30,23,11,310,77,YE
2020-05-31,13,3,323,80,YE
2020-06-01,31,4,354,84,YE
2020-06-02,45,3,399,87,YE
2020-06-03,4,1,403,88,YE
2020-06-04,50,15,453,103,YE
2020-06-05,16,8,469,111,YE
2020-06-06,4,1,473,112,YE
2020-06-07,13,0,486,112,YE
2020-06-08,10,0,496,112,YE
2020-06-09,28,15,524,127,YE
2020-06-10,36,2,560,129,YE
2020-06-11,31,7,591,136,YE
2020-06-12,41,3,632,139,YE
2020-06-13,73,21,705,160,YE
2020-06-14,23,4,728,164,YE
2020-06-15,116,44,844,208,YE
2020-06-16,45,7,889,215,YE
2020-06-17,13,29,902,244,YE
2020-06-18,4,4,906,248,YE
2020-06-19,13,3,919,251,YE
2020-06-20,4,3,923,254,YE
2020-06-21,18,2,941,256,YE
2020-06-22,26,1,967,257,YE
2020-06-23,25,4,992,261,YE
2020-06-24,23,13,1015,274,YE
2020-06-25,61,14,1076,288,YE
2020-06-26,13,5,1089,293,YE
2020-03-05,1,0,1,0,ZA
2020-03-07,1,0,2,0,ZA
2020-03-08,1,0,3,0,ZA
2020-03-09,4,0,7,0,ZA
2020-03-11,6,0,13,0,ZA
2020-03-12,4,0,17,0,ZA
2020-03-13,7,0,24,0,ZA
2020-03-14,0,0,24,0,ZA
2020-03-15,27,0,51,0,ZA
2020-03-16,11,0,62,0,ZA
2020-03-17,23,0,85,0,ZA
2020-03-18,31,0,116,0,ZA
2020-03-19,34,0,150,0,ZA
2020-03-20,55,0,205,0,ZA
2020-03-21,35,0,240,0,ZA
2020-03-22,34,0,274,0,ZA
2020-03-23,128,0,402,0,ZA
2020-03-24,155,0,557,0,ZA
2020-03-25,152,0,709,0,ZA
2020-03-26,218,2,927,2,ZA
2020-03-27,243,0,1170,2,ZA
2020-03-28,17,0,1187,2,ZA
2020-03-29,93,0,1280,2,ZA
2020-03-30,46,1,1326,3,ZA
2020-03-31,27,2,1353,5,ZA
2020-04-01,27,0,1380,5,ZA
2020-04-02,82,0,1462,5,ZA
2020-04-03,43,2,1505,7,ZA
2020-04-04,80,2,1585,9,ZA
2020-04-05,70,2,1655,11,ZA
2020-04-06,31,1,1686,12,ZA
2020-04-07,63,1,1749,13,ZA
2020-04-08,96,5,1845,18,ZA
2020-04-09,89,0,1934,18,ZA
2020-04-10,69,6,2003,24,ZA
2020-04-11,25,1,2028,25,ZA
2020-04-12,145,0,2173,25,ZA
2020-04-13,99,2,2272,27,ZA
2020-04-14,143,0,2415,27,ZA
2020-04-15,91,7,2506,34,ZA
2020-04-16,99,14,2605,48,ZA
2020-04-17,178,2,2783,50,ZA
2020-04-18,251,2,3034,52,ZA
2020-04-19,124,2,3158,54,ZA
2020-04-20,142,4,3300,58,ZA
2020-04-21,165,0,3465,58,ZA
2020-04-22,170,7,3635,65,ZA
2020-04-23,318,10,3953,75,ZA
2020-04-24,267,4,4220,79,ZA
2020-04-25,141,7,4361,86,ZA
2020-04-26,185,1,4546,87,ZA
2020-04-27,247,3,4793,90,ZA
2020-04-28,203,3,4996,93,ZA
2020-04-29,354,10,5350,103,ZA
2020-04-30,297,0,5647,103,ZA
2020-05-01,304,13,5951,116,ZA
2020-05-02,385,7,6336,123,ZA
2020-05-03,447,8,6783,131,ZA
2020-05-04,437,7,7220,138,ZA
2020-05-05,352,10,7572,148,ZA
2020-05-06,236,5,7808,153,ZA
2020-05-07,424,8,8232,161,ZA
2020-05-08,663,17,8895,178,ZA
2020-05-09,525,8,9420,186,ZA
2020-05-10,595,8,10015,194,ZA
2020-05-11,637,12,10652,206,ZA
2020-05-12,698,0,11350,206,ZA
2020-05-13,724,13,12074,219,ZA
2020-05-14,665,19,12739,238,ZA
2020-05-15,785,9,13524,247,ZA
2020-05-16,831,14,14355,261,ZA
2020-05-17,1160,3,15515,264,ZA
2020-05-18,918,22,16433,286,ZA
2020-05-19,767,26,17200,312,ZA
2020-05-20,803,27,18003,339,ZA
2020-05-21,1134,30,19137,369,ZA
2020-05-22,988,28,20125,397,ZA
2020-05-23,1218,10,21343,407,ZA
2020-05-24,1240,22,22583,429,ZA
2020-05-25,1032,52,23615,481,ZA
2020-05-26,649,43,24264,524,ZA
2020-05-27,1673,28,25937,552,ZA
2020-05-28,1466,25,27403,577,ZA
2020-05-29,1837,34,29240,611,ZA
2020-05-30,1727,32,30967,643,ZA
2020-05-31,1716,40,32683,683,ZA
2020-06-01,1674,22,34357,705,ZA
2020-06-02,1455,50,35812,755,ZA
2020-06-03,1713,37,37525,792,ZA
2020-06-04,3267,56,40792,848,ZA
2020-06-05,2642,60,43434,908,ZA
2020-06-06,2539,44,45973,952,ZA
2020-06-07,2312,46,48285,998,ZA
2020-06-08,2594,82,50879,1080,ZA
2020-06-09,2112,82,52991,1162,ZA
2020-06-10,2430,48,55421,1210,ZA
2020-06-11,3147,79,58568,1289,ZA
2020-06-12,3359,65,61927,1354,ZA
2020-06-13,3809,69,65736,1423,ZA
2020-06-14,4302,57,70038,1480,ZA
2020-06-15,3495,88,73533,1568,ZA
2020-06-16,2801,57,76334,1625,ZA
2020-06-17,4078,49,80412,1674,ZA
2020-06-18,3478,63,83890,1737,ZA
2020-06-19,3825,94,87715,1831,ZA
2020-06-20,4966,46,92681,1877,ZA
2020-06-21,4621,53,97302,1930,ZA
2020-06-22,4288,61,101590,1991,ZA
2020-06-23,4518,111,106108,2102,ZA
2020-06-24,5688,103,111796,2205,ZA
2020-06-25,6579,87,118375,2292,ZA
2020-06-26,6215,48,124590,2340,ZA
2020-03-18,2,0,2,0,ZM
2020-03-19,0,0,2,0,ZM
2020-03-20,0,0,2,0,ZM
2020-03-21,0,0,2,0,ZM
2020-03-22,1,0,3,0,ZM
2020-03-23,0,0,3,0,ZM
2020-03-24,0,0,3,0,ZM
2020-03-25,9,0,12,0,ZM
2020-03-26,2,0,14,0,ZM
2020-03-27,2,0,16,0,ZM
2020-03-28,12,0,28,0,ZM
2020-03-29,1,0,29,0,ZM
2020-03-30,6,0,35,0,ZM
2020-03-31,0,0,35,0,ZM
2020-04-01,1,0,36,0,ZM
2020-04-02,3,1,39,1,ZM
2020-04-03,0,0,39,1,ZM
2020-04-04,0,0,39,1,ZM
2020-04-05,0,0,39,1,ZM
2020-04-06,0,0,39,1,ZM
2020-04-07,0,0,39,1,ZM
2020-04-08,0,0,39,1,ZM
2020-04-09,0,0,39,1,ZM
2020-04-10,1,1,40,2,ZM
2020-04-11,0,0,40,2,ZM
2020-04-12,3,0,43,2,ZM
2020-04-13,2,0,45,2,ZM
2020-04-14,0,0,45,2,ZM
2020-04-15,3,0,48,2,ZM
2020-04-16,0,0,48,2,ZM
2020-04-17,4,0,52,2,ZM
2020-04-18,5,0,57,2,ZM
2020-04-19,4,1,61,3,ZM
2020-04-20,4,0,65,3,ZM
2020-04-21,0,0,65,3,ZM
2020-04-22,9,0,74,3,ZM
2020-04-23,2,0,76,3,ZM
2020-04-24,8,0,84,3,ZM
2020-04-25,0,0,84,3,ZM
2020-04-26,4,0,88,3,ZM
2020-04-27,1,0,89,3,ZM
2020-04-28,6,0,95,3,ZM
2020-04-29,2,0,97,3,ZM
2020-04-30,9,0,106,3,ZM
2020-05-01,3,0,109,3,ZM
2020-05-02,10,0,119,3,ZM
2020-05-03,5,0,124,3,ZM
2020-05-04,13,0,137,3,ZM
2020-05-05,2,1,139,4,ZM
2020-05-06,7,0,146,4,ZM
2020-05-07,7,0,153,4,ZM
2020-05-08,14,0,167,4,ZM
2020-05-09,85,3,252,7,ZM
2020-05-10,15,0,267,7,ZM
2020-05-11,0,0,267,7,ZM
2020-05-12,174,0,441,7,ZM
2020-05-13,5,0,446,7,ZM
2020-05-14,208,0,654,7,ZM
2020-05-15,14,0,668,7,ZM
2020-05-16,11,0,679,7,ZM
2020-05-17,74,0,753,7,ZM
2020-05-18,8,0,761,7,ZM
2020-05-19,11,0,772,7,ZM
2020-05-20,60,0,832,7,ZM
2020-05-21,34,0,866,7,ZM
2020-05-22,54,0,920,7,ZM
2020-05-23,0,0,920,7,ZM
2020-05-24,0,0,920,7,ZM
2020-05-25,0,0,920,7,ZM
2020-05-26,0,0,920,7,ZM
2020-05-27,137,0,1057,7,ZM
2020-05-28,0,0,1057,7,ZM
2020-05-29,0,0,1057,7,ZM
2020-05-30,0,0,1057,7,ZM
2020-05-31,0,0,1057,7,ZM
2020-06-01,32,0,1089,7,ZM
2020-06-02,0,0,1089,7,ZM
2020-06-03,0,0,1089,7,ZM
2020-06-04,22,0,1111,7,ZM
2020-06-05,0,0,1111,7,ZM
2020-06-06,43,0,1154,7,ZM
2020-06-07,0,0,1154,7,ZM
2020-06-08,46,3,1200,10,ZM
2020-06-09,0,0,1200,10,ZM
2020-06-10,52,0,1252,10,ZM
2020-06-11,0,0,1252,10,ZM
2020-06-12,69,0,1321,10,ZM
2020-06-13,36,0,1357,10,ZM
2020-06-14,1,1,1358,11,ZM
2020-06-15,24,0,1382,11,ZM
2020-06-16,23,0,1405,11,ZM
2020-06-17,7,0,1412,11,ZM
2020-06-18,4,0,1416,11,ZM
2020-06-19,14,0,1430,11,ZM
2020-06-20,0,0,1430,11,ZM
2020-06-21,0,0,1430,11,ZM
2020-06-22,0,0,1430,11,ZM
2020-06-23,47,7,1477,18,ZM
2020-06-24,12,0,1489,18,ZM
2020-06-25,8,0,1497,18,ZM
2020-06-26,34,3,1531,21,ZM
2020-03-20,1,0,1,0,ZW
2020-03-21,1,0,2,0,ZW
2020-03-22,0,0,2,0,ZW
2020-03-23,0,1,2,1,ZW
2020-03-24,0,0,2,1,ZW
2020-03-25,1,0,3,1,ZW
2020-03-26,0,0,3,1,ZW
2020-03-27,2,0,5,1,ZW
2020-03-28,2,0,7,1,ZW
2020-03-29,0,0,7,1,ZW
2020-03-30,0,0,7,1,ZW
2020-03-31,1,0,8,1,ZW
2020-04-01,0,0,8,1,ZW
2020-04-02,0,0,8,1,ZW
2020-04-03,1,0,9,1,ZW
2020-04-04,0,0,9,1,ZW
2020-04-05,0,0,9,1,ZW
2020-04-06,0,0,9,1,ZW
2020-04-07,1,0,10,1,ZW
2020-04-08,1,1,11,2,ZW
2020-04-09,0,1,11,3,ZW
2020-04-10,0,0,11,3,ZW
2020-04-11,3,0,14,3,ZW
2020-04-12,0,0,14,3,ZW
2020-04-13,3,0,17,3,ZW
2020-04-14,0,0,17,3,ZW
2020-04-15,6,0,23,3,ZW
2020-04-16,1,0,24,3,ZW
2020-04-17,0,0,24,3,ZW
2020-04-18,1,0,25,3,ZW
2020-04-19,0,0,25,3,ZW
2020-04-20,0,0,25,3,ZW
2020-04-21,3,0,28,3,ZW
2020-04-22,0,0,28,3,ZW
2020-04-23,1,0,29,3,ZW
2020-04-24,0,1,29,4,ZW
2020-04-25,2,0,31,4,ZW
2020-04-26,0,0,31,4,ZW
2020-04-27,1,0,32,4,ZW
2020-04-28,0,0,32,4,ZW
2020-04-29,2,0,34,4,ZW
2020-04-30,0,0,34,4,ZW
2020-05-01,0,0,34,4,ZW
2020-05-02,0,0,34,4,ZW
2020-05-03,0,0,34,4,ZW
2020-05-04,0,0,34,4,ZW
2020-05-05,0,0,34,4,ZW
2020-05-06,0,0,34,4,ZW
2020-05-07,0,0,34,4,ZW
2020-05-08,1,0,35,4,ZW
2020-05-09,1,0,36,4,ZW
2020-05-10,0,0,36,4,ZW
2020-05-11,1,0,37,4,ZW
2020-05-12,0,0,37,4,ZW
2020-05-13,0,0,37,4,ZW
2020-05-14,0,0,37,4,ZW
2020-05-15,5,0,42,4,ZW
2020-05-16,2,0,44,4,ZW
2020-05-17,2,0,46,4,ZW
2020-05-18,0,0,46,4,ZW
2020-05-19,0,0,46,4,ZW
2020-05-20,2,0,48,4,ZW
2020-05-21,3,0,51,4,ZW
2020-05-22,5,0,56,4,ZW
2020-05-23,0,0,56,4,ZW
2020-05-24,0,0,56,4,ZW
2020-05-25,0,0,56,4,ZW
2020-05-26,0,0,56,4,ZW
2020-05-27,76,0,132,4,ZW
2020-05-28,17,0,149,4,ZW
2020-05-29,11,0,160,4,ZW
2020-05-30,14,0,174,4,ZW
2020-05-31,4,0,178,4,ZW
2020-06-01,25,0,203,4,ZW
2020-06-02,3,0,206,4,ZW
2020-06-03,16,0,222,4,ZW
2020-06-04,15,0,237,4,ZW
2020-06-05,28,0,265,4,ZW
2020-06-06,14,0,279,4,ZW
2020-06-07,3,0,282,4,ZW
2020-06-08,5,0,287,4,ZW
2020-06-09,27,0,314,4,ZW
2020-06-10,6,0,320,4,ZW
2020-06-11,12,0,332,4,ZW
2020-06-12,11,0,343,4,ZW
2020-06-13,13,0,356,4,ZW
2020-06-14,27,0,383,4,ZW
2020-06-15,4,0,387,4,ZW
2020-06-16,7,0,394,4,ZW
2020-06-17,7,0,401,4,ZW
2020-06-18,62,0,463,4,ZW
2020-06-19,16,0,479,4,ZW
2020-06-20,7,2,486,6,ZW
2020-06-21,3,0,489,6,ZW
2020-06-22,23,0,512,6,ZW
2020-06-23,13,0,525,6,ZW
2020-06-24,5,0,530,6,ZW
2020-06-25,21,0,551,6,ZW
2020-06-26,10,0,561,6,ZW
