date,new_hospitalized,incid_rea,new_deceased,new_recovered,key,total_hospitalized,total_deceased,total_recovered
2020-03-19,2229,438,155,519,FR,2229,155,519
2020-03-20,1256,242,83,317,FR,3485,238,836
2020-03-21,1540,298,115,368,FR,5025,353,1204
2020-03-22,1534,309,124,315,FR,6559,477,1519
2020-03-23,2053,448,189,377,FR,8612,666,1896
2020-03-24,2618,571,244,743,FR,11230,910,2639
2020-03-25,3166,607,293,834,FR,14396,1203,3473
2020-03-26,3097,612,318,888,FR,17493,1521,4361
2020-03-27,3059,608,307,814,FR,20552,1828,5175
2020-03-28,3353,695,326,969,FR,23905,2154,6144
2020-03-29,2685,543,295,543,FR,26590,2449,6687
2020-03-30,3108,694,423,861,FR,29698,2872,7548
2020-03-31,4146,767,526,1589,FR,33844,3398,9137
2020-04-01,4281,771,516,1647,FR,38125,3914,10784
2020-04-02,3845,728,524,1577,FR,41970,4438,12361
2020-04-03,3627,640,606,1655,FR,45597,5044,14016
2020-04-04,2822,502,448,1495,FR,48419,5492,15511
2020-04-05,1931,390,361,773,FR,50350,5853,16284
2020-04-06,2754,478,613,1133,FR,53104,6466,17417
2020-04-07,3277,518,607,2161,FR,56381,7073,19578
2020-04-08,3139,482,562,2022,FR,59520,7635,21600
2020-04-09,2990,369,424,2032,FR,62510,8059,23632
2020-04-10,3161,431,578,1967,FR,65671,8637,25599
2020-04-11,2044,255,353,1527,FR,67715,8990,27126
2020-04-12,1688,220,315,825,FR,69403,9305,27951
2020-04-13,1257,227,343,551,FR,70660,9648,28502
2020-04-14,1965,275,559,1125,FR,72625,10207,29627
2020-04-15,2415,284,524,2224,FR,75040,10731,31851
2020-04-16,2084,270,435,1925,FR,77124,11166,33776
2020-04-17,2166,242,428,1720,FR,79290,11594,35496
2020-04-18,1565,206,368,1605,FR,80855,11962,37101
2020-04-19,890,137,231,622,FR,81745,12193,37723
2020-04-20,1464,208,450,933,FR,83209,12643,38656
2020-04-21,1885,190,404,1875,FR,85094,13047,40531
2020-04-22,1619,183,349,1587,FR,86713,13396,42118
2020-04-23,1410,178,320,1531,FR,88123,13716,43649
2020-04-24,1346,155,312,1464,FR,89469,14028,45113
2020-04-25,999,124,207,1166,FR,90468,14235,46279
2020-04-26,481,79,152,318,FR,90949,14387,46597
2020-04-27,964,125,300,736,FR,91913,14687,47333
2020-04-28,1321,153,328,1491,FR,93234,15015,48824
2020-04-29,1070,110,251,1430,FR,94304,15266,50254
2020-04-30,1048,121,207,1327,FR,95352,15473,51581
2020-05-01,668,73,138,862,FR,96020,15611,52443
2020-05-02,453,64,120,381,FR,96473,15731,52824
2020-05-03,345,80,101,245,FR,96818,15832,53069
2020-05-04,689,84,245,619,FR,97507,16077,53688
2020-05-05,987,111,244,1435,FR,98494,16321,55123
2020-05-06,833,69,181,1298,FR,99327,16502,56421
2020-05-07,728,99,159,1291,FR,100055,16661,57712
2020-05-08,510,89,118,817,FR,100565,16779,58529
2020-05-09,265,38,77,274,FR,100830,16856,58803
2020-05-10,253,38,70,212,FR,101083,16926,59015
2020-05-11,523,82,184,560,FR,101606,17110,59575
2020-05-12,670,92,194,1118,FR,102276,17304,60693
2020-05-13,543,69,105,943,FR,102819,17409,61636
2020-05-14,542,52,126,970,FR,103361,17535,62606
2020-05-15,438,64,120,892,FR,103799,17655,63498
2020-05-16,350,46,78,652,FR,104149,17733,64150
2020-05-17,152,24,54,159,FR,104301,17787,64309
2020-05-18,375,38,123,548,FR,104676,17910,64857
2020-05-19,506,69,140,882,FR,105182,18050,65739
2020-05-20,432,43,102,823,FR,105614,18152,66562
2020-05-21,271,28,58,530,FR,105885,18210,67092
2020-05-22,263,36,75,373,FR,106148,18285,67465
2020-05-23,233,30,47,361,FR,106381,18332,67826
2020-05-24,121,24,36,80,FR,106502,18368,67906
2020-05-25,342,45,93,609,FR,106844,18461,68515
2020-05-26,318,37,92,718,FR,107162,18553,69233
2020-05-27,271,32,67,736,FR,107433,18620,69969
2020-05-28,253,36,69,621,FR,107686,18689,70590
2020-05-29,255,29,63,656,FR,107941,18752,71246
2020-05-30,227,29,57,486,FR,108168,18809,71732
2020-05-31,72,18,35,93,FR,108240,18844,71825
2020-06-01,89,9,31,95,FR,108329,18875,71920
2020-06-02,229,33,85,402,FR,108558,18960,72322
2020-06-03,250,26,85,668,FR,108808,19045,72990
2020-06-04,195,23,46,544,FR,109003,19091,73534
2020-06-05,213,19,47,548,FR,109216,19138,74082
2020-06-06,143,15,35,309,FR,109359,19173,74391
2020-06-07,37,4,13,39,FR,109396,19186,74430
2020-06-08,145,23,55,245,FR,109541,19241,74675
2020-06-09,169,15,53,463,FR,109710,19294,75138
2020-06-10,130,23,34,337,FR,109840,19328,75475
2020-06-11,143,26,28,322,FR,109983,19356,75797
2020-06-12,136,18,33,440,FR,110119,19389,76237
2020-06-13,68,14,24,247,FR,110187,19413,76484
2020-06-14,33,6,9,51,FR,110220,19422,76535
2020-06-15,114,12,30,198,FR,110334,19452,76733
2020-06-16,143,14,42,317,FR,110477,19494,77050
2020-06-17,116,14,30,345,FR,110593,19524,77395
2020-06-18,136,15,29,236,FR,110729,19553,77631
2020-06-19,116,10,14,246,FR,110845,19567,77877
2020-06-20,90,7,19,206,FR,110935,19586,78083
2020-06-21,48,5,7,60,FR,110983,19593,78143
2020-06-22,142,16,23,242,FR,111125,19616,78385
2020-06-23,117,15,26,286,FR,111242,19642,78671
2020-06-24,97,8,13,272,FR,111339,19655,78943
2020-03-19,337,44,21,76,FR_ARA,337,21,76
2020-03-20,98,16,5,34,FR_ARA,435,26,110
2020-03-21,152,15,7,24,FR_ARA,587,33,134
2020-03-22,133,25,12,20,FR_ARA,720,45,154
2020-03-23,230,45,18,34,FR_ARA,950,63,188
2020-03-24,228,47,16,63,FR_ARA,1178,79,251
2020-03-25,373,85,20,93,FR_ARA,1551,99,344
2020-03-26,338,64,28,93,FR_ARA,1889,127,437
2020-03-27,372,77,32,114,FR_ARA,2261,159,551
2020-03-28,407,108,31,95,FR_ARA,2668,190,646
2020-03-29,326,89,33,58,FR_ARA,2994,223,704
2020-03-30,364,116,37,90,FR_ARA,3358,260,794
2020-03-31,343,64,32,146,FR_ARA,3701,292,940
2020-04-01,437,82,54,213,FR_ARA,4138,346,1153
2020-04-02,330,64,56,186,FR_ARA,4468,402,1339
2020-04-03,356,55,44,169,FR_ARA,4824,446,1508
2020-04-04,229,57,30,158,FR_ARA,5053,476,1666
2020-04-05,225,68,33,70,FR_ARA,5278,509,1736
2020-04-06,240,43,48,119,FR_ARA,5518,557,1855
2020-04-07,272,45,46,265,FR_ARA,5790,603,2120
2020-04-08,243,39,54,214,FR_ARA,6033,657,2334
2020-04-09,286,34,32,192,FR_ARA,6319,689,2526
2020-04-10,224,30,37,187,FR_ARA,6543,726,2713
2020-04-11,257,29,34,168,FR_ARA,6800,760,2881
2020-04-12,144,18,19,83,FR_ARA,6944,779,2964
2020-04-13,97,17,21,35,FR_ARA,7041,800,2999
2020-04-14,156,23,43,116,FR_ARA,7197,843,3115
2020-04-15,271,33,49,243,FR_ARA,7468,892,3358
2020-04-16,175,27,42,151,FR_ARA,7643,934,3509
2020-04-17,220,16,28,190,FR_ARA,7863,962,3699
2020-04-18,198,20,38,162,FR_ARA,8061,1000,3861
2020-04-19,112,13,19,39,FR_ARA,8173,1019,3900
2020-04-20,88,21,52,72,FR_ARA,8261,1071,3972
2020-04-21,181,29,42,189,FR_ARA,8442,1113,4161
2020-04-22,137,12,30,171,FR_ARA,8579,1143,4332
2020-04-23,139,9,35,145,FR_ARA,8718,1178,4477
2020-04-24,136,14,25,140,FR_ARA,8854,1203,4617
2020-04-25,127,11,20,121,FR_ARA,8981,1223,4738
2020-04-26,55,2,14,28,FR_ARA,9036,1237,4766
2020-04-27,82,8,29,66,FR_ARA,9118,1266,4832
2020-04-28,154,8,32,172,FR_ARA,9272,1298,5004
2020-04-29,80,9,24,126,FR_ARA,9352,1322,5130
2020-04-30,120,12,26,139,FR_ARA,9472,1348,5269
2020-05-01,92,12,17,95,FR_ARA,9564,1365,5364
2020-05-02,43,9,9,28,FR_ARA,9607,1374,5392
2020-05-03,31,4,11,12,FR_ARA,9638,1385,5404
2020-05-04,50,6,22,56,FR_ARA,9688,1407,5460
2020-05-05,120,9,34,122,FR_ARA,9808,1441,5582
2020-05-06,69,9,18,140,FR_ARA,9877,1459,5722
2020-05-07,77,8,26,142,FR_ARA,9954,1485,5864
2020-05-08,46,6,7,99,FR_ARA,10000,1492,5963
2020-05-09,20,2,4,20,FR_ARA,10020,1496,5983
2020-05-10,20,3,10,15,FR_ARA,10040,1506,5998
2020-05-11,52,7,16,55,FR_ARA,10092,1522,6053
2020-05-12,61,8,18,111,FR_ARA,10153,1540,6164
2020-05-13,46,4,10,141,FR_ARA,10199,1550,6305
2020-05-14,69,5,11,95,FR_ARA,10268,1561,6400
2020-05-15,23,7,11,63,FR_ARA,10291,1572,6463
2020-05-16,53,3,14,91,FR_ARA,10344,1586,6554
2020-05-17,21,3,2,5,FR_ARA,10365,1588,6559
2020-05-18,20,2,7,51,FR_ARA,10385,1595,6610
2020-05-19,51,4,20,101,FR_ARA,10436,1615,6711
2020-05-20,42,2,12,112,FR_ARA,10478,1627,6823
2020-05-21,45,3,5,77,FR_ARA,10523,1632,6900
2020-05-22,19,2,7,23,FR_ARA,10542,1639,6923
2020-05-23,21,2,9,28,FR_ARA,10563,1648,6951
2020-05-24,13,2,0,3,FR_ARA,10576,1648,6954
2020-05-25,41,5,10,84,FR_ARA,10617,1658,7038
2020-05-26,29,1,13,69,FR_ARA,10646,1671,7107
2020-05-27,28,7,7,76,FR_ARA,10674,1678,7183
2020-05-28,14,1,9,95,FR_ARA,10688,1687,7278
2020-05-29,13,1,8,84,FR_ARA,10701,1695,7362
2020-05-30,26,10,1,31,FR_ARA,10727,1696,7393
2020-05-31,24,9,3,16,FR_ARA,10751,1699,7409
2020-06-01,5,0,2,2,FR_ARA,10756,1701,7411
2020-06-02,18,3,10,43,FR_ARA,10774,1711,7454
2020-06-03,24,2,8,60,FR_ARA,10798,1719,7514
2020-06-04,14,3,4,82,FR_ARA,10812,1723,7596
2020-06-05,13,1,0,63,FR_ARA,10825,1723,7659
2020-06-06,4,0,2,22,FR_ARA,10829,1725,7681
2020-06-07,1,0,1,2,FR_ARA,10830,1726,7683
2020-06-08,18,3,7,27,FR_ARA,10848,1733,7710
2020-06-09,9,0,3,35,FR_ARA,10857,1736,7745
2020-06-10,15,2,5,39,FR_ARA,10872,1741,7784
2020-06-11,12,0,4,31,FR_ARA,10884,1745,7815
2020-06-12,9,0,2,49,FR_ARA,10893,1747,7864
2020-06-13,5,1,1,13,FR_ARA,10898,1748,7877
2020-06-14,0,0,0,2,FR_ARA,10898,1748,7879
2020-06-15,3,0,2,35,FR_ARA,10901,1750,7914
2020-06-16,20,1,4,24,FR_ARA,10921,1754,7938
2020-06-17,19,4,2,55,FR_ARA,10940,1756,7993
2020-06-18,9,1,2,21,FR_ARA,10949,1758,8014
2020-06-19,12,1,0,15,FR_ARA,10961,1758,8029
2020-06-20,9,0,1,29,FR_ARA,10970,1759,8058
2020-06-21,1,0,0,15,FR_ARA,10971,1759,8073
2020-06-22,7,0,3,11,FR_ARA,10978,1762,8084
2020-06-23,11,0,1,23,FR_ARA,10989,1763,8107
2020-06-24,6,1,1,15,FR_ARA,10995,1764,8122
2020-03-19,96,33,13,35,FR_BFC,96,13,35
2020-03-20,77,9,3,15,FR_BFC,173,16,50
2020-03-21,67,11,14,37,FR_BFC,240,30,87
2020-03-22,130,14,13,77,FR_BFC,370,43,164
2020-03-23,87,12,14,19,FR_BFC,457,57,183
2020-03-24,185,19,23,88,FR_BFC,642,80,271
2020-03-25,204,30,17,67,FR_BFC,846,97,338
2020-03-26,165,19,21,54,FR_BFC,1011,118,392
2020-03-27,109,24,16,33,FR_BFC,1120,134,425
2020-03-28,127,21,9,63,FR_BFC,1247,143,488
2020-03-29,158,33,16,57,FR_BFC,1405,159,545
2020-03-30,105,20,23,58,FR_BFC,1510,182,603
2020-03-31,203,30,28,76,FR_BFC,1713,210,679
2020-04-01,168,33,18,70,FR_BFC,1881,228,749
2020-04-02,214,33,41,109,FR_BFC,2095,269,858
2020-04-03,134,28,33,91,FR_BFC,2229,302,949
2020-04-04,147,22,21,77,FR_BFC,2376,323,1026
2020-04-05,96,12,18,32,FR_BFC,2472,341,1058
2020-04-06,127,24,26,45,FR_BFC,2599,367,1103
2020-04-07,163,29,29,102,FR_BFC,2762,396,1205
2020-04-08,117,14,16,88,FR_BFC,2879,412,1293
2020-04-09,86,10,15,80,FR_BFC,2965,427,1373
2020-04-10,177,20,32,76,FR_BFC,3142,459,1449
2020-04-11,82,3,19,104,FR_BFC,3224,478,1553
2020-04-12,112,9,22,33,FR_BFC,3336,500,1586
2020-04-13,51,13,12,22,FR_BFC,3387,512,1608
2020-04-14,118,5,39,25,FR_BFC,3505,551,1633
2020-04-15,120,10,31,116,FR_BFC,3625,582,1749
2020-04-16,123,16,27,67,FR_BFC,3748,609,1816
2020-04-17,108,5,16,71,FR_BFC,3856,625,1887
2020-04-18,51,12,21,61,FR_BFC,3907,646,1948
2020-04-19,40,12,13,53,FR_BFC,3947,659,2001
2020-04-20,52,6,20,26,FR_BFC,3999,679,2027
2020-04-21,86,13,28,81,FR_BFC,4085,707,2108
2020-04-22,111,17,16,83,FR_BFC,4196,723,2191
2020-04-23,51,6,32,74,FR_BFC,4247,755,2265
2020-04-24,70,4,18,91,FR_BFC,4317,773,2356
2020-04-25,50,7,16,55,FR_BFC,4367,789,2411
2020-04-26,24,4,11,10,FR_BFC,4391,800,2421
2020-04-27,42,6,17,32,FR_BFC,4433,817,2453
2020-04-28,56,10,7,52,FR_BFC,4489,824,2505
2020-04-29,71,7,13,71,FR_BFC,4560,837,2576
2020-04-30,71,9,6,63,FR_BFC,4631,843,2639
2020-05-01,24,1,5,56,FR_BFC,4655,848,2695
2020-05-02,17,4,7,9,FR_BFC,4672,855,2704
2020-05-03,13,3,6,4,FR_BFC,4685,861,2708
2020-05-04,31,2,13,22,FR_BFC,4716,874,2730
2020-05-05,69,8,15,72,FR_BFC,4785,889,2802
2020-05-06,55,2,12,37,FR_BFC,4840,901,2839
2020-05-07,31,3,10,85,FR_BFC,4871,911,2924
2020-05-08,35,7,8,66,FR_BFC,4906,919,2990
2020-05-09,17,2,7,19,FR_BFC,4923,926,3009
2020-05-10,12,0,5,4,FR_BFC,4935,931,3013
2020-05-11,31,6,13,19,FR_BFC,4966,944,3032
2020-05-12,21,7,10,44,FR_BFC,4987,954,3076
2020-05-13,32,2,6,43,FR_BFC,5019,960,3119
2020-05-14,15,1,3,29,FR_BFC,5034,963,3148
2020-05-15,12,4,2,41,FR_BFC,5046,965,3189
2020-05-16,12,2,2,28,FR_BFC,5058,967,3217
2020-05-17,1,0,0,2,FR_BFC,5059,967,3219
2020-05-18,18,0,10,23,FR_BFC,5077,977,3242
2020-05-19,16,2,9,43,FR_BFC,5093,986,3285
2020-05-20,24,3,2,49,FR_BFC,5117,988,3334
2020-05-21,13,0,3,56,FR_BFC,5130,991,3390
2020-05-22,9,2,5,23,FR_BFC,5139,996,3413
2020-05-23,10,2,0,12,FR_BFC,5149,996,3425
2020-05-24,4,1,2,4,FR_BFC,5153,998,3429
2020-05-25,21,2,4,46,FR_BFC,5174,1002,3475
2020-05-26,17,2,3,119,FR_BFC,5191,1005,3594
2020-05-27,20,1,4,59,FR_BFC,5211,1009,3653
2020-05-28,9,1,3,24,FR_BFC,5220,1012,3677
2020-05-29,29,0,4,50,FR_BFC,5249,1016,3727
2020-05-30,8,0,1,12,FR_BFC,5257,1017,3739
2020-05-31,2,0,1,7,FR_BFC,5259,1018,3746
2020-06-01,3,0,1,3,FR_BFC,5262,1019,3749
2020-06-02,9,1,2,28,FR_BFC,5271,1021,3777
2020-06-03,6,1,4,42,FR_BFC,5277,1025,3819
2020-06-04,15,0,5,23,FR_BFC,5292,1030,3842
2020-06-05,3,1,0,12,FR_BFC,5295,1030,3854
2020-06-06,3,0,1,7,FR_BFC,5298,1031,3861
2020-06-07,0,0,0,1,FR_BFC,5298,1031,3862
2020-06-08,10,1,1,10,FR_BFC,5308,1032,3872
2020-06-09,10,1,4,34,FR_BFC,5318,1036,3906
2020-06-10,3,0,4,26,FR_BFC,5321,1040,3932
2020-06-11,5,2,0,8,FR_BFC,5326,1040,3940
2020-06-12,21,0,0,55,FR_BFC,5347,1040,3995
2020-06-13,1,0,2,6,FR_BFC,5348,1042,4001
2020-06-14,0,0,0,5,FR_BFC,5348,1042,4006
2020-06-15,4,0,0,2,FR_BFC,5352,1042,4008
2020-06-16,2,0,0,14,FR_BFC,5354,1042,4022
2020-06-17,0,0,1,13,FR_BFC,5354,1043,4035
2020-06-18,1,1,1,5,FR_BFC,5355,1044,4040
2020-06-19,6,0,0,25,FR_BFC,5361,1044,4065
2020-06-20,0,0,0,1,FR_BFC,5361,1044,4066
2020-06-21,0,0,0,0,FR_BFC,5361,1044,4066
2020-06-22,6,1,1,7,FR_BFC,5367,1045,4073
2020-06-23,4,1,0,8,FR_BFC,5371,1045,4081
2020-06-24,2,0,1,6,FR_BFC,5373,1046,4087
2020-03-19,52,8,4,21,FR_BRE,52,4,21
2020-03-20,16,2,2,3,FR_BRE,68,6,24
2020-03-21,34,9,3,2,FR_BRE,102,9,26
2020-03-22,21,8,2,7,FR_BRE,123,11,33
2020-03-23,25,6,6,6,FR_BRE,148,17,39
2020-03-24,31,8,2,19,FR_BRE,179,19,58
2020-03-25,41,5,3,16,FR_BRE,220,22,74
2020-03-26,59,10,1,13,FR_BRE,279,23,87
2020-03-27,38,9,5,18,FR_BRE,317,28,105
2020-03-28,50,19,3,15,FR_BRE,367,31,120
2020-03-29,55,4,4,21,FR_BRE,422,35,141
2020-03-30,42,10,4,7,FR_BRE,464,39,148
2020-03-31,41,12,5,21,FR_BRE,505,44,169
2020-04-01,68,19,5,15,FR_BRE,573,49,184
2020-04-02,60,18,8,27,FR_BRE,633,57,211
2020-04-03,45,9,6,20,FR_BRE,678,63,231
2020-04-04,32,7,6,30,FR_BRE,710,69,261
2020-04-05,28,6,6,9,FR_BRE,738,75,270
2020-04-06,39,4,7,16,FR_BRE,777,82,286
2020-04-07,40,5,9,43,FR_BRE,817,91,329
2020-04-08,72,7,10,40,FR_BRE,889,101,369
2020-04-09,34,4,2,24,FR_BRE,923,103,393
2020-04-10,43,5,13,35,FR_BRE,966,116,428
2020-04-11,44,7,8,39,FR_BRE,1010,124,467
2020-04-12,39,3,3,13,FR_BRE,1049,127,480
2020-04-13,13,4,4,10,FR_BRE,1062,131,490
2020-04-14,39,4,13,21,FR_BRE,1101,144,511
2020-04-15,32,1,10,30,FR_BRE,1133,154,541
2020-04-16,26,2,8,36,FR_BRE,1159,162,577
2020-04-17,25,3,5,20,FR_BRE,1184,167,597
2020-04-18,26,5,10,32,FR_BRE,1210,177,629
2020-04-19,11,1,5,13,FR_BRE,1221,182,642
2020-04-20,11,1,4,11,FR_BRE,1232,186,653
2020-04-21,24,3,4,31,FR_BRE,1256,190,684
2020-04-22,22,3,0,25,FR_BRE,1278,190,709
2020-04-23,28,0,6,22,FR_BRE,1306,196,731
2020-04-24,23,1,0,21,FR_BRE,1329,196,752
2020-04-25,12,1,3,26,FR_BRE,1341,199,778
2020-04-26,3,1,1,6,FR_BRE,1344,200,784
2020-04-27,4,1,1,2,FR_BRE,1348,201,786
2020-04-28,21,1,5,23,FR_BRE,1369,206,809
2020-04-29,9,2,2,14,FR_BRE,1378,208,823
2020-04-30,14,0,2,15,FR_BRE,1392,210,838
2020-05-01,6,0,0,23,FR_BRE,1398,210,861
2020-05-02,15,2,4,10,FR_BRE,1413,214,871
2020-05-03,6,0,3,7,FR_BRE,1419,217,878
2020-05-04,9,2,3,9,FR_BRE,1428,220,887
2020-05-05,7,1,0,12,FR_BRE,1435,220,899
2020-05-06,10,1,1,14,FR_BRE,1445,221,913
2020-05-07,5,3,1,17,FR_BRE,1450,222,930
2020-05-08,10,2,1,17,FR_BRE,1460,223,947
2020-05-09,5,2,1,7,FR_BRE,1465,224,954
2020-05-10,3,1,1,3,FR_BRE,1468,225,957
2020-05-11,6,2,3,5,FR_BRE,1474,228,962
2020-05-12,9,0,1,19,FR_BRE,1483,229,981
2020-05-13,3,1,1,29,FR_BRE,1486,230,1010
2020-05-14,5,1,1,8,FR_BRE,1491,231,1018
2020-05-15,7,0,1,23,FR_BRE,1498,232,1041
2020-05-16,14,3,2,14,FR_BRE,1512,234,1055
2020-05-17,4,0,1,5,FR_BRE,1516,235,1060
2020-05-18,4,2,3,11,FR_BRE,1520,238,1071
2020-05-19,6,0,1,15,FR_BRE,1526,239,1086
2020-05-20,11,1,0,11,FR_BRE,1537,239,1097
2020-05-21,5,0,1,7,FR_BRE,1542,240,1104
2020-05-22,8,0,1,3,FR_BRE,1550,241,1107
2020-05-23,4,1,0,7,FR_BRE,1554,241,1114
2020-05-24,1,1,0,0,FR_BRE,1555,241,1114
2020-05-25,5,1,2,7,FR_BRE,1560,243,1121
2020-05-26,3,1,2,13,FR_BRE,1563,245,1134
2020-05-27,5,0,2,6,FR_BRE,1568,247,1140
2020-05-28,2,1,1,7,FR_BRE,1570,248,1147
2020-05-29,6,1,0,5,FR_BRE,1576,248,1152
2020-05-30,5,0,0,13,FR_BRE,1581,248,1165
2020-05-31,1,0,0,0,FR_BRE,1582,248,1165
2020-06-01,2,0,2,2,FR_BRE,1584,250,1167
2020-06-02,1,1,1,7,FR_BRE,1585,251,1174
2020-06-03,7,0,1,17,FR_BRE,1592,252,1191
2020-06-04,3,0,1,4,FR_BRE,1595,253,1195
2020-06-05,5,0,1,10,FR_BRE,1600,254,1205
2020-06-06,1,0,0,2,FR_BRE,1601,254,1207
2020-06-07,2,0,0,1,FR_BRE,1603,254,1208
2020-06-08,2,1,0,5,FR_BRE,1605,254,1213
2020-06-09,0,0,0,3,FR_BRE,1605,254,1216
2020-06-10,3,0,0,1,FR_BRE,1608,254,1217
2020-06-11,3,1,0,10,FR_BRE,1611,254,1227
2020-06-12,1,0,1,5,FR_BRE,1612,255,1232
2020-06-13,1,1,0,11,FR_BRE,1613,255,1243
2020-06-14,0,0,1,1,FR_BRE,1613,256,1244
2020-06-15,3,0,0,1,FR_BRE,1616,256,1245
2020-06-16,2,0,0,2,FR_BRE,1618,256,1247
2020-06-17,0,0,0,1,FR_BRE,1618,256,1248
2020-06-18,0,0,0,4,FR_BRE,1618,256,1252
2020-06-19,4,0,0,9,FR_BRE,1622,256,1261
2020-06-20,0,0,0,5,FR_BRE,1622,256,1266
2020-06-21,0,0,0,0,FR_BRE,1622,256,1266
2020-06-22,1,0,0,2,FR_BRE,1623,256,1268
2020-06-23,1,0,1,4,FR_BRE,1624,257,1272
2020-06-24,0,0,1,2,FR_BRE,1624,258,1274
2020-03-19,59,10,1,10,FR_COR,59,1,10
2020-03-20,36,0,2,23,FR_COR,95,3,33
2020-03-21,4,0,1,3,FR_COR,99,4,36
2020-03-22,7,2,2,1,FR_COR,106,6,37
2020-03-23,16,2,1,9,FR_COR,122,7,46
2020-03-24,12,0,0,7,FR_COR,134,7,53
2020-03-25,22,0,8,3,FR_COR,156,15,56
2020-03-26,27,4,4,10,FR_COR,183,19,66
2020-03-27,15,1,0,7,FR_COR,198,19,73
2020-03-28,10,6,0,2,FR_COR,208,19,75
2020-03-29,16,4,0,8,FR_COR,224,19,83
2020-03-30,14,1,0,12,FR_COR,238,19,95
2020-03-31,13,2,1,12,FR_COR,251,20,107
2020-04-01,3,3,1,3,FR_COR,254,21,110
2020-04-02,20,3,2,8,FR_COR,274,23,118
2020-04-03,9,1,3,7,FR_COR,283,26,125
2020-04-04,27,2,0,2,FR_COR,310,26,127
2020-04-05,0,0,0,2,FR_COR,310,26,129
2020-04-06,1,1,4,0,FR_COR,311,30,129
2020-04-07,5,3,2,1,FR_COR,316,32,130
2020-04-08,6,3,0,3,FR_COR,322,32,133
2020-04-09,2,1,2,2,FR_COR,324,34,135
2020-04-10,0,0,1,8,FR_COR,324,35,143
2020-04-11,1,0,1,2,FR_COR,325,36,145
2020-04-12,3,1,0,4,FR_COR,328,36,149
2020-04-13,3,1,2,0,FR_COR,331,38,149
2020-04-14,2,1,0,3,FR_COR,333,38,152
2020-04-15,14,1,3,2,FR_COR,347,41,154
2020-04-16,3,1,0,3,FR_COR,350,41,157
2020-04-17,2,1,1,1,FR_COR,352,42,158
2020-04-18,4,0,0,11,FR_COR,356,42,169
2020-04-19,4,0,2,4,FR_COR,360,44,173
2020-04-20,0,2,3,2,FR_COR,360,47,175
2020-04-21,2,0,1,5,FR_COR,362,48,180
2020-04-22,8,1,1,5,FR_COR,370,49,185
2020-04-23,1,0,0,4,FR_COR,371,49,189
2020-04-24,6,0,0,2,FR_COR,377,49,191
2020-04-25,0,0,1,5,FR_COR,377,50,196
2020-04-26,0,0,0,0,FR_COR,377,50,196
2020-04-27,0,0,0,0,FR_COR,377,50,196
2020-04-28,5,1,0,7,FR_COR,382,50,203
2020-04-29,2,0,0,7,FR_COR,384,50,210
2020-04-30,3,0,0,3,FR_COR,387,50,213
2020-05-01,3,0,0,1,FR_COR,390,50,214
2020-05-02,0,0,0,2,FR_COR,390,50,216
2020-05-03,0,0,1,0,FR_COR,390,51,216
2020-05-04,1,0,0,2,FR_COR,391,51,218
2020-05-05,1,0,0,2,FR_COR,392,51,220
2020-05-06,0,0,1,2,FR_COR,392,52,222
2020-05-07,0,0,0,2,FR_COR,392,52,224
2020-05-08,0,0,0,2,FR_COR,392,52,226
2020-05-09,1,0,0,0,FR_COR,393,52,226
2020-05-10,0,0,0,0,FR_COR,393,52,226
2020-05-11,1,0,0,0,FR_COR,394,52,226
2020-05-12,5,3,1,5,FR_COR,399,53,231
2020-05-13,1,0,1,2,FR_COR,400,54,233
2020-05-14,0,1,0,1,FR_COR,400,54,234
2020-05-15,0,0,2,4,FR_COR,400,56,238
2020-05-16,0,0,0,0,FR_COR,400,56,238
2020-05-17,0,0,0,0,FR_COR,400,56,238
2020-05-18,2,0,1,2,FR_COR,402,57,240
2020-05-19,1,0,0,2,FR_COR,403,57,242
2020-05-20,0,0,0,3,FR_COR,403,57,245
2020-05-21,0,0,0,0,FR_COR,403,57,245
2020-05-22,0,0,0,1,FR_COR,403,57,246
2020-05-23,0,0,0,0,FR_COR,403,57,246
2020-05-24,0,0,1,0,FR_COR,403,58,246
2020-05-25,0,0,0,0,FR_COR,403,58,246
2020-05-26,1,1,0,0,FR_COR,404,58,246
2020-05-27,1,0,0,6,FR_COR,405,58,252
2020-05-28,0,0,0,1,FR_COR,405,58,253
2020-05-29,1,0,0,3,FR_COR,406,58,256
2020-05-30,0,0,0,0,FR_COR,406,58,256
2020-05-31,0,0,0,0,FR_COR,406,58,256
2020-06-01,0,0,0,0,FR_COR,406,58,256
2020-06-02,0,0,0,0,FR_COR,406,58,256
2020-06-03,0,0,0,1,FR_COR,406,58,257
2020-06-04,0,0,0,3,FR_COR,406,58,260
2020-06-05,0,0,0,0,FR_COR,406,58,260
2020-06-06,1,0,0,0,FR_COR,407,58,260
2020-06-07,0,0,0,0,FR_COR,407,58,260
2020-06-08,2,0,0,1,FR_COR,409,58,261
2020-06-09,0,0,0,0,FR_COR,409,58,261
2020-06-10,0,0,0,1,FR_COR,409,58,262
2020-06-11,0,0,0,0,FR_COR,409,58,262
2020-06-12,0,0,1,2,FR_COR,409,59,264
2020-06-13,0,0,0,4,FR_COR,409,59,268
2020-06-14,0,0,0,0,FR_COR,409,59,268
2020-06-15,0,0,0,2,FR_COR,409,59,270
2020-06-16,0,0,0,0,FR_COR,409,59,270
2020-06-17,0,0,0,0,FR_COR,409,59,270
2020-06-18,0,0,0,0,FR_COR,409,59,270
2020-06-19,0,0,0,0,FR_COR,409,59,270
2020-06-20,0,0,0,0,FR_COR,409,59,270
2020-06-21,0,0,0,0,FR_COR,409,59,270
2020-06-22,0,0,0,0,FR_COR,409,59,270
2020-06-23,0,0,0,2,FR_COR,409,59,272
2020-06-24,0,0,0,0,FR_COR,409,59,272
2020-03-19,26,6,0,3,FR_CVL,26,0,3
2020-03-20,22,4,1,0,FR_CVL,48,1,3
2020-03-21,12,3,1,4,FR_CVL,60,2,7
2020-03-22,14,7,0,4,FR_CVL,74,2,11
2020-03-23,53,17,5,5,FR_CVL,127,7,16
2020-03-24,31,7,1,10,FR_CVL,158,8,26
2020-03-25,58,19,5,14,FR_CVL,216,13,40
2020-03-26,57,15,7,16,FR_CVL,273,20,56
2020-03-27,72,20,6,14,FR_CVL,345,26,70
2020-03-28,69,13,9,13,FR_CVL,414,35,83
2020-03-29,73,17,4,6,FR_CVL,487,39,89
2020-03-30,130,13,14,19,FR_CVL,617,53,108
2020-03-31,66,19,7,14,FR_CVL,683,60,122
2020-04-01,100,24,17,28,FR_CVL,783,77,150
2020-04-02,126,22,8,42,FR_CVL,909,85,192
2020-04-03,99,24,15,46,FR_CVL,1008,100,238
2020-04-04,108,16,8,47,FR_CVL,1116,108,285
2020-04-05,59,6,9,27,FR_CVL,1175,117,312
2020-04-06,93,19,17,34,FR_CVL,1268,134,346
2020-04-07,78,8,10,54,FR_CVL,1346,144,400
2020-04-08,105,19,14,55,FR_CVL,1451,158,455
2020-04-09,94,13,10,39,FR_CVL,1545,168,494
2020-04-10,103,12,15,56,FR_CVL,1648,183,550
2020-04-11,82,9,14,41,FR_CVL,1730,197,591
2020-04-12,48,1,8,14,FR_CVL,1778,205,605
2020-04-13,70,8,13,15,FR_CVL,1848,218,620
2020-04-14,64,8,13,34,FR_CVL,1912,231,654
2020-04-15,80,8,18,58,FR_CVL,1992,249,712
2020-04-16,74,2,7,85,FR_CVL,2066,256,797
2020-04-17,81,15,12,51,FR_CVL,2147,268,848
2020-04-18,38,5,12,32,FR_CVL,2185,280,880
2020-04-19,31,5,8,14,FR_CVL,2216,288,894
2020-04-20,36,5,14,29,FR_CVL,2252,302,923
2020-04-21,71,3,11,47,FR_CVL,2323,313,970
2020-04-22,58,5,20,37,FR_CVL,2381,333,1007
2020-04-23,46,5,6,47,FR_CVL,2427,339,1054
2020-04-24,33,7,9,16,FR_CVL,2460,348,1070
2020-04-25,30,9,5,21,FR_CVL,2490,353,1091
2020-04-26,21,1,7,13,FR_CVL,2511,360,1104
2020-04-27,39,5,12,18,FR_CVL,2550,372,1122
2020-04-28,37,6,9,54,FR_CVL,2587,381,1176
2020-04-29,50,3,8,37,FR_CVL,2637,389,1213
2020-04-30,60,6,5,39,FR_CVL,2697,394,1252
2020-05-01,34,6,7,15,FR_CVL,2731,401,1267
2020-05-02,18,1,2,9,FR_CVL,2749,403,1276
2020-05-03,15,3,4,3,FR_CVL,2764,407,1279
2020-05-04,17,2,10,18,FR_CVL,2781,417,1297
2020-05-05,59,6,10,57,FR_CVL,2840,427,1354
2020-05-06,16,0,8,60,FR_CVL,2856,435,1414
2020-05-07,26,2,5,31,FR_CVL,2882,440,1445
2020-05-08,14,0,5,36,FR_CVL,2896,445,1481
2020-05-09,9,0,2,6,FR_CVL,2905,447,1487
2020-05-10,7,0,3,2,FR_CVL,2912,450,1489
2020-05-11,15,2,5,23,FR_CVL,2927,455,1512
2020-05-12,14,3,6,37,FR_CVL,2941,461,1549
2020-05-13,11,2,2,27,FR_CVL,2952,463,1576
2020-05-14,14,4,5,31,FR_CVL,2966,468,1607
2020-05-15,22,3,7,32,FR_CVL,2988,475,1639
2020-05-16,2,0,4,15,FR_CVL,2990,479,1654
2020-05-17,2,0,2,4,FR_CVL,2992,481,1658
2020-05-18,10,1,4,20,FR_CVL,3002,485,1678
2020-05-19,9,1,6,15,FR_CVL,3011,491,1693
2020-05-20,16,1,7,22,FR_CVL,3027,498,1715
2020-05-21,1,0,2,13,FR_CVL,3028,500,1728
2020-05-22,13,0,1,11,FR_CVL,3041,501,1739
2020-05-23,3,1,2,9,FR_CVL,3044,503,1748
2020-05-24,2,0,1,1,FR_CVL,3046,504,1749
2020-05-25,8,0,3,4,FR_CVL,3054,507,1753
2020-05-26,1,1,2,21,FR_CVL,3055,509,1774
2020-05-27,3,0,1,12,FR_CVL,3058,510,1786
2020-05-28,3,0,0,23,FR_CVL,3061,510,1809
2020-05-29,2,0,5,27,FR_CVL,3063,515,1836
2020-05-30,5,1,0,3,FR_CVL,3068,515,1839
2020-05-31,1,0,1,1,FR_CVL,3069,516,1840
2020-06-01,0,0,1,1,FR_CVL,3069,517,1841
2020-06-02,4,0,1,6,FR_CVL,3073,518,1847
2020-06-03,3,2,5,11,FR_CVL,3076,523,1858
2020-06-04,3,0,3,8,FR_CVL,3079,526,1866
2020-06-05,2,0,0,18,FR_CVL,3081,526,1884
2020-06-06,2,0,0,4,FR_CVL,3083,526,1888
2020-06-07,1,0,1,3,FR_CVL,3084,527,1891
2020-06-08,2,0,3,3,FR_CVL,3086,530,1894
2020-06-09,0,0,1,11,FR_CVL,3086,531,1905
2020-06-10,1,1,1,23,FR_CVL,3087,532,1928
2020-06-11,3,1,1,6,FR_CVL,3090,533,1934
2020-06-12,0,0,2,5,FR_CVL,3090,535,1939
2020-06-13,2,0,1,3,FR_CVL,3092,536,1942
2020-06-14,0,0,0,1,FR_CVL,3092,536,1943
2020-06-15,3,0,0,1,FR_CVL,3095,536,1944
2020-06-16,3,1,0,9,FR_CVL,3098,536,1953
2020-06-17,9,0,6,38,FR_CVL,3107,542,1991
2020-06-18,7,0,7,3,FR_CVL,3114,549,1994
2020-06-19,1,0,2,4,FR_CVL,3115,551,1998
2020-06-20,1,0,0,1,FR_CVL,3116,551,1999
2020-06-21,0,0,0,0,FR_CVL,3116,551,1999
2020-06-22,0,3,0,14,FR_CVL,3116,551,2013
2020-06-23,2,0,0,7,FR_CVL,3118,551,2020
2020-06-24,1,0,0,5,FR_CVL,3119,551,2025
2020-03-19,438,70,38,75,FR_GES,438,38,75
2020-03-20,263,45,27,63,FR_GES,701,65,138
2020-03-21,313,65,44,73,FR_GES,1014,109,211
2020-03-22,291,63,47,43,FR_GES,1305,156,254
2020-03-23,416,81,63,73,FR_GES,1721,219,327
2020-03-24,646,104,83,154,FR_GES,2367,302,481
2020-03-25,593,99,101,155,FR_GES,2960,403,636
2020-03-26,553,95,84,192,FR_GES,3513,487,828
2020-03-27,538,102,76,130,FR_GES,4051,563,958
2020-03-28,582,114,98,195,FR_GES,4633,661,1153
2020-03-29,386,71,63,90,FR_GES,5019,724,1243
2020-03-30,554,113,108,147,FR_GES,5573,832,1390
2020-03-31,697,122,103,234,FR_GES,6270,935,1624
2020-04-01,666,107,114,286,FR_GES,6936,1049,1910
2020-04-02,605,109,97,279,FR_GES,7541,1146,2189
2020-04-03,586,104,141,326,FR_GES,8127,1287,2515
2020-04-04,403,72,93,261,FR_GES,8530,1380,2776
2020-04-05,284,44,70,154,FR_GES,8814,1450,2930
2020-04-06,375,70,107,176,FR_GES,9189,1557,3106
2020-04-07,498,61,101,353,FR_GES,9687,1658,3459
2020-04-08,401,60,116,357,FR_GES,10088,1774,3816
2020-04-09,548,42,82,390,FR_GES,10636,1856,4206
2020-04-10,566,31,110,329,FR_GES,11202,1966,4535
2020-04-11,149,28,57,144,FR_GES,11351,2023,4679
2020-04-12,253,24,57,146,FR_GES,11604,2080,4825
2020-04-13,147,24,41,65,FR_GES,11751,2121,4890
2020-04-14,302,36,74,145,FR_GES,12053,2195,5035
2020-04-15,394,27,83,410,FR_GES,12447,2278,5445
2020-04-16,259,31,64,305,FR_GES,12706,2342,5750
2020-04-17,263,35,55,244,FR_GES,12969,2397,5994
2020-04-18,219,29,66,236,FR_GES,13188,2463,6230
2020-04-19,104,13,41,86,FR_GES,13292,2504,6316
2020-04-20,175,22,52,139,FR_GES,13467,2556,6455
2020-04-21,281,21,53,272,FR_GES,13748,2609,6727
2020-04-22,232,29,57,239,FR_GES,13980,2666,6966
2020-04-23,201,27,35,232,FR_GES,14181,2701,7198
2020-04-24,180,16,35,181,FR_GES,14361,2736,7379
2020-04-25,147,16,35,188,FR_GES,14508,2771,7567
2020-04-26,60,13,23,46,FR_GES,14568,2794,7613
2020-04-27,144,17,42,105,FR_GES,14712,2836,7718
2020-04-28,190,24,43,213,FR_GES,14902,2879,7931
2020-04-29,171,13,46,283,FR_GES,15073,2925,8214
2020-04-30,158,16,29,215,FR_GES,15231,2954,8429
2020-05-01,121,15,38,157,FR_GES,15352,2992,8586
2020-05-02,92,14,22,82,FR_GES,15444,3014,8668
2020-05-03,64,17,17,63,FR_GES,15508,3031,8731
2020-05-04,114,13,30,74,FR_GES,15622,3061,8805
2020-05-05,115,22,32,181,FR_GES,15737,3093,8986
2020-05-06,136,6,26,191,FR_GES,15873,3119,9177
2020-05-07,160,14,27,185,FR_GES,16033,3146,9362
2020-05-08,96,10,35,116,FR_GES,16129,3181,9478
2020-05-09,38,6,15,59,FR_GES,16167,3196,9537
2020-05-10,40,2,8,36,FR_GES,16207,3204,9573
2020-05-11,73,8,26,63,FR_GES,16280,3230,9636
2020-05-12,119,11,35,146,FR_GES,16399,3265,9782
2020-05-13,99,8,23,152,FR_GES,16498,3288,9934
2020-05-14,111,2,33,195,FR_GES,16609,3321,10129
2020-05-15,97,6,28,158,FR_GES,16706,3349,10287
2020-05-16,38,9,13,118,FR_GES,16744,3362,10405
2020-05-17,27,8,16,43,FR_GES,16771,3378,10448
2020-05-18,76,8,19,59,FR_GES,16847,3397,10507
2020-05-19,103,12,24,134,FR_GES,16950,3421,10641
2020-05-20,48,8,20,124,FR_GES,16998,3441,10765
2020-05-21,27,8,4,60,FR_GES,17025,3445,10825
2020-05-22,53,5,15,86,FR_GES,17078,3460,10911
2020-05-23,65,10,8,56,FR_GES,17143,3468,10967
2020-05-24,16,4,11,31,FR_GES,17159,3479,10998
2020-05-25,61,5,7,95,FR_GES,17220,3486,11093
2020-05-26,35,4,13,93,FR_GES,17255,3499,11186
2020-05-27,57,6,11,143,FR_GES,17312,3510,11329
2020-05-28,55,11,9,105,FR_GES,17367,3519,11434
2020-05-29,46,8,11,124,FR_GES,17413,3530,11558
2020-05-30,42,6,9,120,FR_GES,17455,3539,11678
2020-05-31,9,3,3,11,FR_GES,17464,3542,11689
2020-06-01,12,4,4,19,FR_GES,17476,3546,11708
2020-06-02,39,4,19,70,FR_GES,17515,3565,11778
2020-06-03,59,6,12,98,FR_GES,17574,3577,11876
2020-06-04,36,3,8,77,FR_GES,17610,3585,11953
2020-06-05,49,4,16,140,FR_GES,17659,3601,12093
2020-06-06,31,3,4,44,FR_GES,17690,3605,12137
2020-06-07,7,0,2,5,FR_GES,17697,3607,12142
2020-06-08,22,4,13,47,FR_GES,17719,3620,12189
2020-06-09,19,2,5,72,FR_GES,17738,3625,12261
2020-06-10,22,2,8,69,FR_GES,17760,3633,12330
2020-06-11,26,6,3,60,FR_GES,17786,3636,12390
2020-06-12,20,3,4,96,FR_GES,17806,3640,12486
2020-06-13,10,5,3,34,FR_GES,17816,3643,12520
2020-06-14,4,3,2,2,FR_GES,17820,3645,12522
2020-06-15,23,3,7,28,FR_GES,17843,3652,12550
2020-06-16,20,4,5,51,FR_GES,17863,3657,12601
2020-06-17,22,2,2,42,FR_GES,17885,3659,12643
2020-06-18,25,2,8,34,FR_GES,17910,3667,12677
2020-06-19,21,2,4,46,FR_GES,17931,3671,12723
2020-06-20,9,1,3,10,FR_GES,17940,3674,12733
2020-06-21,2,0,1,1,FR_GES,17942,3675,12734
2020-06-22,17,1,5,42,FR_GES,17959,3680,12776
2020-06-23,13,1,5,43,FR_GES,17972,3685,12819
2020-06-24,13,0,1,31,FR_GES,17985,3686,12850
2020-03-19,0,0,0,0,FR_GF,0,0,0
2020-03-20,0,0,0,0,FR_GF,0,0,0
2020-03-21,0,0,0,0,FR_GF,0,0,0
2020-03-22,0,0,0,0,FR_GF,0,0,0
2020-03-23,0,0,0,0,FR_GF,0,0,0
2020-03-24,0,0,0,0,FR_GF,0,0,0
2020-03-25,0,0,0,0,FR_GF,0,0,0
2020-03-26,0,0,0,0,FR_GF,0,0,0
2020-03-27,0,0,0,0,FR_GF,0,0,0
2020-03-28,0,0,0,0,FR_GF,0,0,0
2020-03-29,0,0,0,0,FR_GF,0,0,0
2020-03-30,0,0,0,0,FR_GF,0,0,0
2020-03-31,0,0,0,0,FR_GF,0,0,0
2020-04-01,10,0,0,5,FR_GF,10,0,5
2020-04-02,3,0,0,3,FR_GF,23,0,13
2020-04-03,2,1,0,0,FR_GF,28,0,16
2020-04-04,0,0,0,0,FR_GF,30,0,16
2020-04-05,0,0,0,0,FR_GF,30,0,16
2020-04-06,0,0,0,0,FR_GF,30,0,16
2020-04-07,2,0,0,2,FR_GF,32,0,18
2020-04-08,2,0,0,0,FR_GF,36,0,20
2020-04-09,4,0,0,4,FR_GF,42,0,24
2020-04-10,1,0,0,1,FR_GF,47,0,29
2020-04-11,0,0,0,0,FR_GF,48,0,30
2020-04-12,6,0,0,0,FR_GF,54,0,30
2020-04-13,0,0,0,0,FR_GF,60,0,30
2020-04-14,3,0,0,0,FR_GF,63,0,30
2020-04-15,3,0,0,1,FR_GF,69,0,31
2020-04-16,0,1,0,10,FR_GF,72,0,42
2020-04-17,1,1,0,1,FR_GF,73,0,53
2020-04-18,0,0,0,0,FR_GF,74,0,54
2020-04-19,0,0,0,3,FR_GF,74,0,57
2020-04-20,0,0,0,1,FR_GF,74,0,61
2020-04-21,2,0,1,2,FR_GF,76,1,64
2020-04-22,0,0,0,1,FR_GF,78,2,67
2020-04-23,3,0,0,2,FR_GF,81,2,70
2020-04-24,0,0,0,0,FR_GF,84,2,72
2020-04-25,0,0,0,1,FR_GF,84,2,73
2020-04-26,0,0,0,0,FR_GF,84,2,74
2020-04-27,0,0,0,0,FR_GF,84,2,74
2020-04-28,0,0,0,0,FR_GF,84,2,74
2020-04-29,0,0,0,0,FR_GF,84,2,74
2020-04-30,0,0,0,1,FR_GF,84,2,75
2020-05-01,2,0,0,0,FR_GF,86,2,76
2020-05-02,0,0,0,0,FR_GF,88,2,76
2020-05-03,0,0,0,0,FR_GF,88,2,76
2020-05-04,3,0,0,0,FR_GF,91,2,76
2020-05-05,0,0,0,0,FR_GF,94,2,76
2020-05-06,0,0,0,0,FR_GF,94,2,76
2020-05-07,3,0,0,0,FR_GF,97,2,76
2020-05-08,0,0,0,2,FR_GF,100,2,78
2020-05-09,0,0,0,0,FR_GF,100,2,80
2020-05-10,0,0,0,0,FR_GF,100,2,80
2020-05-11,2,0,0,0,FR_GF,102,2,80
2020-05-12,3,0,0,0,FR_GF,107,2,80
2020-05-13,0,0,0,1,FR_GF,110,2,81
2020-05-14,0,0,0,3,FR_GF,110,2,85
2020-05-15,2,0,0,0,FR_GF,112,2,88
2020-05-16,0,0,0,1,FR_GF,114,2,89
2020-05-17,1,0,0,0,FR_GF,115,2,90
2020-05-18,7,0,0,2,FR_GF,123,2,92
2020-05-19,4,0,0,5,FR_GF,134,2,99
2020-05-20,0,0,0,1,FR_GF,138,2,105
2020-05-21,0,0,0,0,FR_GF,138,2,106
2020-05-22,0,0,0,0,FR_GF,138,2,106
2020-05-23,10,0,0,6,FR_GF,148,2,112
2020-05-24,0,0,0,0,FR_GF,158,2,118
2020-05-25,1,0,0,0,FR_GF,159,2,118
2020-05-26,8,2,0,8,FR_GF,168,2,126
2020-05-27,3,0,0,2,FR_GF,179,2,136
2020-05-28,5,0,0,4,FR_GF,187,2,142
2020-05-29,2,0,0,1,FR_GF,194,2,147
2020-05-30,2,0,0,1,FR_GF,198,2,149
2020-05-31,0,0,0,0,FR_GF,200,2,150
2020-06-01,9,0,0,1,FR_GF,209,2,151
2020-06-02,7,1,0,9,FR_GF,225,2,161
2020-06-03,8,0,0,7,FR_GF,240,2,177
2020-06-04,3,0,0,3,FR_GF,251,2,187
2020-06-05,16,0,0,8,FR_GF,270,2,198
2020-06-06,11,0,0,9,FR_GF,297,2,215
2020-06-07,3,0,0,3,FR_GF,311,2,227
2020-06-08,4,0,0,1,FR_GF,318,2,231
2020-06-09,10,1,1,19,FR_GF,332,3,251
2020-06-10,10,1,0,3,FR_GF,352,4,273
2020-06-11,9,1,0,6,FR_GF,371,4,282
2020-06-12,13,0,0,5,FR_GF,393,4,293
2020-06-13,13,2,0,10,FR_GF,419,4,308
2020-06-14,15,1,1,9,FR_GF,447,5,327
2020-06-15,16,2,0,2,FR_GF,478,6,338
2020-06-16,15,1,1,0,FR_GF,509,7,340
2020-06-17,21,0,1,21,FR_GF,545,9,361
2020-06-18,22,2,0,17,FR_GF,588,10,399
2020-06-19,22,1,0,4,FR_GF,632,10,420
2020-06-20,23,2,0,16,FR_GF,677,10,440
2020-06-21,17,3,1,16,FR_GF,717,11,472
2020-06-22,21,1,1,12,FR_GF,755,13,500
2020-06-23,20,3,1,15,FR_GF,796,15,527
2020-06-24,26,2,1,24,FR_GF,842,17,566
2020-03-19,0,0,0,0,FR_GF,0,0,0
2020-03-20,0,0,0,0,FR_GF,0,0,0
2020-03-21,0,0,0,0,FR_GF,0,0,0
2020-03-22,0,0,0,0,FR_GF,0,0,0
2020-03-23,0,0,0,0,FR_GF,0,0,0
2020-03-24,0,0,0,0,FR_GF,0,0,0
2020-03-25,0,0,0,0,FR_GF,0,0,0
2020-03-26,0,0,0,0,FR_GF,0,0,0
2020-03-27,0,0,0,0,FR_GF,0,0,0
2020-03-28,0,0,0,0,FR_GF,0,0,0
2020-03-29,0,0,0,0,FR_GF,0,0,0
2020-03-30,0,0,0,0,FR_GF,0,0,0
2020-03-31,0,0,0,0,FR_GF,0,0,0
2020-04-01,10,0,0,5,FR_GF,20,0,10
2020-04-02,3,0,0,3,FR_GF,26,0,16
2020-04-03,2,1,0,0,FR_GF,30,0,16
2020-04-04,0,0,0,0,FR_GF,30,0,16
2020-04-05,0,0,0,0,FR_GF,30,0,16
2020-04-06,0,0,0,0,FR_GF,30,0,16
2020-04-07,2,0,0,2,FR_GF,34,0,20
2020-04-08,2,0,0,0,FR_GF,38,0,20
2020-04-09,4,0,0,4,FR_GF,46,0,28
2020-04-10,1,0,0,1,FR_GF,48,0,30
2020-04-11,0,0,0,0,FR_GF,48,0,30
2020-04-12,6,0,0,0,FR_GF,60,0,30
2020-04-13,0,0,0,0,FR_GF,60,0,30
2020-04-14,3,0,0,0,FR_GF,66,0,30
2020-04-15,3,0,0,1,FR_GF,72,0,32
2020-04-16,0,1,0,10,FR_GF,72,0,52
2020-04-17,1,1,0,1,FR_GF,74,0,54
2020-04-18,0,0,0,0,FR_GF,74,0,54
2020-04-19,0,0,0,3,FR_GF,74,0,60
2020-04-20,0,0,0,1,FR_GF,74,0,62
2020-04-21,2,0,1,2,FR_GF,78,2,66
2020-04-22,0,0,0,1,FR_GF,78,2,68
2020-04-23,3,0,0,2,FR_GF,84,2,72
2020-04-24,0,0,0,0,FR_GF,84,2,72
2020-04-25,0,0,0,1,FR_GF,84,2,74
2020-04-26,0,0,0,0,FR_GF,84,2,74
2020-04-27,0,0,0,0,FR_GF,84,2,74
2020-04-28,0,0,0,0,FR_GF,84,2,74
2020-04-29,0,0,0,0,FR_GF,84,2,74
2020-04-30,0,0,0,1,FR_GF,84,2,76
2020-05-01,2,0,0,0,FR_GF,88,2,76
2020-05-02,0,0,0,0,FR_GF,88,2,76
2020-05-03,0,0,0,0,FR_GF,88,2,76
2020-05-04,3,0,0,0,FR_GF,94,2,76
2020-05-05,0,0,0,0,FR_GF,94,2,76
2020-05-06,0,0,0,0,FR_GF,94,2,76
2020-05-07,3,0,0,0,FR_GF,100,2,76
2020-05-08,0,0,0,2,FR_GF,100,2,80
2020-05-09,0,0,0,0,FR_GF,100,2,80
2020-05-10,0,0,0,0,FR_GF,100,2,80
2020-05-11,2,0,0,0,FR_GF,104,2,80
2020-05-12,3,0,0,0,FR_GF,110,2,80
2020-05-13,0,0,0,1,FR_GF,110,2,82
2020-05-14,0,0,0,3,FR_GF,110,2,88
2020-05-15,2,0,0,0,FR_GF,114,2,88
2020-05-16,0,0,0,1,FR_GF,114,2,90
2020-05-17,1,0,0,0,FR_GF,116,2,90
2020-05-18,7,0,0,2,FR_GF,130,2,94
2020-05-19,4,0,0,5,FR_GF,138,2,104
2020-05-20,0,0,0,1,FR_GF,138,2,106
2020-05-21,0,0,0,0,FR_GF,138,2,106
2020-05-22,0,0,0,0,FR_GF,138,2,106
2020-05-23,10,0,0,6,FR_GF,158,2,118
2020-05-24,0,0,0,0,FR_GF,158,2,118
2020-05-25,1,0,0,0,FR_GF,160,2,118
2020-05-26,8,2,0,8,FR_GF,176,2,134
2020-05-27,3,0,0,2,FR_GF,182,2,138
2020-05-28,5,0,0,4,FR_GF,192,2,146
2020-05-29,2,0,0,1,FR_GF,196,2,148
2020-05-30,2,0,0,1,FR_GF,200,2,150
2020-05-31,0,0,0,0,FR_GF,200,2,150
2020-06-01,9,0,0,1,FR_GF,218,2,152
2020-06-02,7,1,0,9,FR_GF,232,2,170
2020-06-03,8,0,0,7,FR_GF,248,2,184
2020-06-04,3,0,0,3,FR_GF,254,2,190
2020-06-05,16,0,0,8,FR_GF,286,2,206
2020-06-06,11,0,0,9,FR_GF,308,2,224
2020-06-07,3,0,0,3,FR_GF,314,2,230
2020-06-08,4,0,0,1,FR_GF,322,2,232
2020-06-09,10,1,1,19,FR_GF,342,4,270
2020-06-10,10,1,0,3,FR_GF,362,4,276
2020-06-11,9,1,0,6,FR_GF,380,4,288
2020-06-12,13,0,0,5,FR_GF,406,4,298
2020-06-13,13,2,0,10,FR_GF,432,4,318
2020-06-14,15,1,1,9,FR_GF,462,6,336
2020-06-15,16,2,0,2,FR_GF,494,6,340
2020-06-16,15,1,1,0,FR_GF,524,8,340
2020-06-17,21,0,1,21,FR_GF,566,10,382
2020-06-18,22,2,0,17,FR_GF,610,10,416
2020-06-19,22,1,0,4,FR_GF,654,10,424
2020-06-20,23,2,0,16,FR_GF,700,10,456
2020-06-21,17,3,1,16,FR_GF,734,12,488
2020-06-22,21,1,1,12,FR_GF,776,14,512
2020-06-23,20,3,1,15,FR_GF,816,16,542
2020-06-24,26,2,1,24,FR_GF,868,18,590
2020-03-19,0,0,0,0,FR_GUA,0,0,0
2020-03-20,0,0,0,0,FR_GUA,0,0,0
2020-03-21,0,0,0,0,FR_GUA,0,0,0
2020-03-22,6,5,0,0,FR_GUA,6,0,0
2020-03-23,0,0,0,0,FR_GUA,12,0,0
2020-03-24,0,0,0,0,FR_GUA,12,0,0
2020-03-25,0,0,0,0,FR_GUA,12,0,0
2020-03-26,19,3,0,4,FR_GUA,31,0,4
2020-03-27,11,7,1,2,FR_GUA,61,1,10
2020-03-28,18,0,0,3,FR_GUA,90,2,15
2020-03-29,1,0,1,0,FR_GUA,109,3,18
2020-03-30,3,4,2,9,FR_GUA,113,6,27
2020-03-31,4,2,1,1,FR_GUA,120,9,37
2020-04-01,6,2,2,6,FR_GUA,130,12,44
2020-04-02,9,4,0,3,FR_GUA,145,14,53
2020-04-03,6,1,1,6,FR_GUA,160,15,62
2020-04-04,3,2,0,1,FR_GUA,169,16,69
2020-04-05,2,2,0,1,FR_GUA,174,16,71
2020-04-06,5,0,0,1,FR_GUA,181,16,73
2020-04-07,1,0,0,6,FR_GUA,187,16,80
2020-04-08,5,1,2,4,FR_GUA,193,18,90
2020-04-09,3,2,0,3,FR_GUA,201,20,97
2020-04-10,2,3,0,2,FR_GUA,206,20,102
2020-04-11,3,0,0,0,FR_GUA,211,20,104
2020-04-12,2,0,0,1,FR_GUA,216,20,105
2020-04-13,3,0,0,0,FR_GUA,221,20,106
2020-04-14,0,0,0,0,FR_GUA,224,20,106
2020-04-15,0,1,0,7,FR_GUA,224,20,113
2020-04-16,1,0,0,3,FR_GUA,225,20,123
2020-04-17,2,2,0,0,FR_GUA,228,20,126
2020-04-18,0,0,1,3,FR_GUA,230,21,129
2020-04-19,1,0,0,0,FR_GUA,231,22,132
2020-04-20,0,0,1,1,FR_GUA,232,23,133
2020-04-21,0,1,0,7,FR_GUA,232,24,141
2020-04-22,4,0,1,1,FR_GUA,236,25,149
2020-04-23,0,1,0,1,FR_GUA,240,26,151
2020-04-24,0,0,1,0,FR_GUA,240,27,152
2020-04-25,0,0,0,0,FR_GUA,240,28,152
2020-04-26,1,1,0,0,FR_GUA,241,28,152
2020-04-27,1,0,1,0,FR_GUA,243,29,152
2020-04-28,0,0,0,0,FR_GUA,244,30,152
2020-04-29,1,1,0,2,FR_GUA,245,30,154
2020-04-30,0,0,2,0,FR_GUA,246,32,156
2020-05-01,0,0,1,0,FR_GUA,246,35,156
2020-05-02,0,0,0,0,FR_GUA,246,36,156
2020-05-03,0,0,0,0,FR_GUA,246,36,156
2020-05-04,0,0,0,0,FR_GUA,246,36,156
2020-05-05,0,0,1,0,FR_GUA,246,37,156
2020-05-06,0,0,0,0,FR_GUA,246,38,156
2020-05-07,0,0,0,1,FR_GUA,246,38,157
2020-05-08,0,0,1,0,FR_GUA,246,39,158
2020-05-09,0,0,0,0,FR_GUA,246,40,158
2020-05-10,0,0,0,0,FR_GUA,246,40,158
2020-05-11,0,0,0,0,FR_GUA,246,40,158
2020-05-12,0,0,0,0,FR_GUA,246,40,158
2020-05-13,0,0,0,0,FR_GUA,246,40,158
2020-05-14,0,0,0,0,FR_GUA,246,40,158
2020-05-15,0,0,0,0,FR_GUA,246,40,158
2020-05-16,0,0,0,0,FR_GUA,246,40,158
2020-05-17,0,0,0,0,FR_GUA,246,40,158
2020-05-18,0,0,0,0,FR_GUA,246,40,158
2020-05-19,0,0,0,0,FR_GUA,246,40,158
2020-05-20,0,0,0,1,FR_GUA,246,40,159
2020-05-21,0,0,0,0,FR_GUA,246,40,160
2020-05-22,0,0,0,0,FR_GUA,246,40,160
2020-05-23,0,0,0,0,FR_GUA,246,40,160
2020-05-24,0,0,0,0,FR_GUA,246,40,160
2020-05-25,0,1,1,0,FR_GUA,246,41,160
2020-05-26,0,0,0,0,FR_GUA,246,42,160
2020-05-27,0,0,0,0,FR_GUA,246,42,160
2020-05-28,0,0,0,0,FR_GUA,246,42,160
2020-05-29,0,0,0,0,FR_GUA,246,42,160
2020-05-30,0,0,0,0,FR_GUA,246,42,160
2020-05-31,0,0,0,0,FR_GUA,246,42,160
2020-06-01,0,0,0,0,FR_GUA,246,42,160
2020-06-02,0,0,0,0,FR_GUA,246,42,160
2020-06-03,0,0,0,0,FR_GUA,246,42,160
2020-06-04,0,0,0,1,FR_GUA,246,42,161
2020-06-05,0,0,0,0,FR_GUA,246,42,162
2020-06-06,0,0,0,0,FR_GUA,246,42,162
2020-06-07,0,0,0,0,FR_GUA,246,42,162
2020-06-08,0,0,0,0,FR_GUA,246,42,162
2020-06-09,0,0,0,0,FR_GUA,246,42,162
2020-06-10,0,0,0,0,FR_GUA,246,42,162
2020-06-11,0,0,0,0,FR_GUA,246,42,162
2020-06-12,0,0,0,0,FR_GUA,246,42,162
2020-06-13,0,0,0,0,FR_GUA,246,42,162
2020-06-14,0,0,0,0,FR_GUA,246,42,162
2020-06-15,0,0,0,3,FR_GUA,246,42,165
2020-06-16,0,0,0,1,FR_GUA,246,42,169
2020-06-17,0,0,0,2,FR_GUA,246,42,172
2020-06-18,0,0,0,0,FR_GUA,246,42,174
2020-06-19,0,0,0,0,FR_GUA,246,42,174
2020-06-20,0,0,0,0,FR_GUA,246,42,174
2020-06-21,0,0,0,0,FR_GUA,246,42,174
2020-06-22,0,0,0,0,FR_GUA,246,42,174
2020-06-23,0,0,0,0,FR_GUA,246,42,174
2020-06-24,0,0,0,0,FR_GUA,246,42,174
2020-03-19,0,0,0,0,FR_GUA,0,0,0
2020-03-20,0,0,0,0,FR_GUA,0,0,0
2020-03-21,0,0,0,0,FR_GUA,0,0,0
2020-03-22,6,5,0,0,FR_GUA,12,0,0
2020-03-23,0,0,0,0,FR_GUA,12,0,0
2020-03-24,0,0,0,0,FR_GUA,12,0,0
2020-03-25,0,0,0,0,FR_GUA,12,0,0
2020-03-26,19,3,0,4,FR_GUA,50,0,8
2020-03-27,11,7,1,2,FR_GUA,72,2,12
2020-03-28,18,0,0,3,FR_GUA,108,2,18
2020-03-29,1,0,1,0,FR_GUA,110,4,18
2020-03-30,3,4,2,9,FR_GUA,116,8,36
2020-03-31,4,2,1,1,FR_GUA,124,10,38
2020-04-01,6,2,2,6,FR_GUA,136,14,50
2020-04-02,9,4,0,3,FR_GUA,154,14,56
2020-04-03,6,1,1,6,FR_GUA,166,16,68
2020-04-04,3,2,0,1,FR_GUA,172,16,70
2020-04-05,2,2,0,1,FR_GUA,176,16,72
2020-04-06,5,0,0,1,FR_GUA,186,16,74
2020-04-07,1,0,0,6,FR_GUA,188,16,86
2020-04-08,5,1,2,4,FR_GUA,198,20,94
2020-04-09,3,2,0,3,FR_GUA,204,20,100
2020-04-10,2,3,0,2,FR_GUA,208,20,104
2020-04-11,3,0,0,0,FR_GUA,214,20,104
2020-04-12,2,0,0,1,FR_GUA,218,20,106
2020-04-13,3,0,0,0,FR_GUA,224,20,106
2020-04-14,0,0,0,0,FR_GUA,224,20,106
2020-04-15,0,1,0,7,FR_GUA,224,20,120
2020-04-16,1,0,0,3,FR_GUA,226,20,126
2020-04-17,2,2,0,0,FR_GUA,230,20,126
2020-04-18,0,0,1,3,FR_GUA,230,22,132
2020-04-19,1,0,0,0,FR_GUA,232,22,132
2020-04-20,0,0,1,1,FR_GUA,232,24,134
2020-04-21,0,1,0,7,FR_GUA,232,24,148
2020-04-22,4,0,1,1,FR_GUA,240,26,150
2020-04-23,0,1,0,1,FR_GUA,240,26,152
2020-04-24,0,0,1,0,FR_GUA,240,28,152
2020-04-25,0,0,0,0,FR_GUA,240,28,152
2020-04-26,1,1,0,0,FR_GUA,242,28,152
2020-04-27,1,0,1,0,FR_GUA,244,30,152
2020-04-28,0,0,0,0,FR_GUA,244,30,152
2020-04-29,1,1,0,2,FR_GUA,246,30,156
2020-04-30,0,0,2,0,FR_GUA,246,34,156
2020-05-01,0,0,1,0,FR_GUA,246,36,156
2020-05-02,0,0,0,0,FR_GUA,246,36,156
2020-05-03,0,0,0,0,FR_GUA,246,36,156
2020-05-04,0,0,0,0,FR_GUA,246,36,156
2020-05-05,0,0,1,0,FR_GUA,246,38,156
2020-05-06,0,0,0,0,FR_GUA,246,38,156
2020-05-07,0,0,0,1,FR_GUA,246,38,158
2020-05-08,0,0,1,0,FR_GUA,246,40,158
2020-05-09,0,0,0,0,FR_GUA,246,40,158
2020-05-10,0,0,0,0,FR_GUA,246,40,158
2020-05-11,0,0,0,0,FR_GUA,246,40,158
2020-05-12,0,0,0,0,FR_GUA,246,40,158
2020-05-13,0,0,0,0,FR_GUA,246,40,158
2020-05-14,0,0,0,0,FR_GUA,246,40,158
2020-05-15,0,0,0,0,FR_GUA,246,40,158
2020-05-16,0,0,0,0,FR_GUA,246,40,158
2020-05-17,0,0,0,0,FR_GUA,246,40,158
2020-05-18,0,0,0,0,FR_GUA,246,40,158
2020-05-19,0,0,0,0,FR_GUA,246,40,158
2020-05-20,0,0,0,1,FR_GUA,246,40,160
2020-05-21,0,0,0,0,FR_GUA,246,40,160
2020-05-22,0,0,0,0,FR_GUA,246,40,160
2020-05-23,0,0,0,0,FR_GUA,246,40,160
2020-05-24,0,0,0,0,FR_GUA,246,40,160
2020-05-25,0,1,1,0,FR_GUA,246,42,160
2020-05-26,0,0,0,0,FR_GUA,246,42,160
2020-05-27,0,0,0,0,FR_GUA,246,42,160
2020-05-28,0,0,0,0,FR_GUA,246,42,160
2020-05-29,0,0,0,0,FR_GUA,246,42,160
2020-05-30,0,0,0,0,FR_GUA,246,42,160
2020-05-31,0,0,0,0,FR_GUA,246,42,160
2020-06-01,0,0,0,0,FR_GUA,246,42,160
2020-06-02,0,0,0,0,FR_GUA,246,42,160
2020-06-03,0,0,0,0,FR_GUA,246,42,160
2020-06-04,0,0,0,1,FR_GUA,246,42,162
2020-06-05,0,0,0,0,FR_GUA,246,42,162
2020-06-06,0,0,0,0,FR_GUA,246,42,162
2020-06-07,0,0,0,0,FR_GUA,246,42,162
2020-06-08,0,0,0,0,FR_GUA,246,42,162
2020-06-09,0,0,0,0,FR_GUA,246,42,162
2020-06-10,0,0,0,0,FR_GUA,246,42,162
2020-06-11,0,0,0,0,FR_GUA,246,42,162
2020-06-12,0,0,0,0,FR_GUA,246,42,162
2020-06-13,0,0,0,0,FR_GUA,246,42,162
2020-06-14,0,0,0,0,FR_GUA,246,42,162
2020-06-15,0,0,0,3,FR_GUA,246,42,168
2020-06-16,0,0,0,1,FR_GUA,246,42,170
2020-06-17,0,0,0,2,FR_GUA,246,42,174
2020-06-18,0,0,0,0,FR_GUA,246,42,174
2020-06-19,0,0,0,0,FR_GUA,246,42,174
2020-06-20,0,0,0,0,FR_GUA,246,42,174
2020-06-21,0,0,0,0,FR_GUA,246,42,174
2020-06-22,0,0,0,0,FR_GUA,246,42,174
2020-06-23,0,0,0,0,FR_GUA,246,42,174
2020-06-24,0,0,0,0,FR_GUA,246,42,174
2020-03-19,212,37,25,63,FR_HDF,212,25,63
2020-03-20,92,35,7,27,FR_HDF,304,32,90
2020-03-21,131,28,7,41,FR_HDF,435,39,131
2020-03-22,83,15,11,18,FR_HDF,518,50,149
2020-03-23,166,42,17,24,FR_HDF,684,67,173
2020-03-24,193,36,23,49,FR_HDF,877,90,222
2020-03-25,174,47,13,40,FR_HDF,1051,103,262
2020-03-26,197,38,28,73,FR_HDF,1248,131,335
2020-03-27,163,51,20,59,FR_HDF,1411,151,394
2020-03-28,237,38,27,60,FR_HDF,1648,178,454
2020-03-29,171,37,15,37,FR_HDF,1819,193,491
2020-03-30,218,63,31,56,FR_HDF,2037,224,547
2020-03-31,310,67,44,132,FR_HDF,2347,268,679
2020-04-01,307,48,50,95,FR_HDF,2654,318,774
2020-04-02,394,65,41,135,FR_HDF,3048,359,909
2020-04-03,352,54,68,134,FR_HDF,3400,427,1043
2020-04-04,267,44,53,143,FR_HDF,3667,480,1186
2020-04-05,148,31,32,33,FR_HDF,3815,512,1219
2020-04-06,245,29,57,71,FR_HDF,4060,569,1290
2020-04-07,343,47,58,178,FR_HDF,4403,627,1468
2020-04-08,267,30,46,187,FR_HDF,4670,673,1655
2020-04-09,233,35,37,131,FR_HDF,4903,710,1786
2020-04-10,255,36,50,174,FR_HDF,5158,760,1960
2020-04-11,204,20,45,165,FR_HDF,5362,805,2125
2020-04-12,143,9,34,61,FR_HDF,5505,839,2186
2020-04-13,106,14,33,29,FR_HDF,5611,872,2215
2020-04-14,161,20,47,91,FR_HDF,5772,919,2306
2020-04-15,235,30,56,196,FR_HDF,6007,975,2502
2020-04-16,208,19,39,151,FR_HDF,6215,1014,2653
2020-04-17,190,22,49,159,FR_HDF,6405,1063,2812
2020-04-18,122,12,23,88,FR_HDF,6527,1086,2900
2020-04-19,100,16,17,48,FR_HDF,6627,1103,2948
2020-04-20,202,17,33,124,FR_HDF,6829,1136,3072
2020-04-21,284,17,41,299,FR_HDF,7113,1177,3371
2020-04-22,147,16,35,151,FR_HDF,7260,1212,3522
2020-04-23,158,19,37,142,FR_HDF,7418,1249,3664
2020-04-24,117,12,24,128,FR_HDF,7535,1273,3792
2020-04-25,99,4,29,77,FR_HDF,7634,1302,3869
2020-04-26,38,8,10,14,FR_HDF,7672,1312,3883
2020-04-27,84,10,25,73,FR_HDF,7756,1337,3956
2020-04-28,130,12,24,137,FR_HDF,7886,1361,4093
2020-04-29,63,7,18,108,FR_HDF,7949,1379,4201
2020-04-30,104,17,19,126,FR_HDF,8053,1398,4327
2020-05-01,61,4,16,70,FR_HDF,8114,1414,4397
2020-05-02,44,2,6,17,FR_HDF,8158,1420,4414
2020-05-03,26,5,14,21,FR_HDF,8184,1434,4435
2020-05-04,78,7,18,47,FR_HDF,8262,1452,4482
2020-05-05,82,10,35,133,FR_HDF,8344,1487,4615
2020-05-06,91,12,21,120,FR_HDF,8435,1508,4735
2020-05-07,65,11,17,114,FR_HDF,8500,1525,4849
2020-05-08,64,7,12,76,FR_HDF,8564,1537,4925
2020-05-09,14,3,4,19,FR_HDF,8578,1541,4944
2020-05-10,16,3,10,17,FR_HDF,8594,1551,4961
2020-05-11,69,10,26,42,FR_HDF,8663,1577,5003
2020-05-12,78,10,25,107,FR_HDF,8741,1602,5110
2020-05-13,49,7,8,84,FR_HDF,8790,1610,5194
2020-05-14,60,9,10,106,FR_HDF,8850,1620,5300
2020-05-15,61,3,17,93,FR_HDF,8911,1637,5393
2020-05-16,56,4,12,45,FR_HDF,8967,1649,5438
2020-05-17,15,2,9,8,FR_HDF,8982,1658,5446
2020-05-18,48,3,15,49,FR_HDF,9030,1673,5495
2020-05-19,51,7,9,101,FR_HDF,9081,1682,5596
2020-05-20,50,8,12,45,FR_HDF,9131,1694,5641
2020-05-21,22,1,7,45,FR_HDF,9153,1701,5686
2020-05-22,23,4,4,31,FR_HDF,9176,1705,5717
2020-05-23,15,0,9,32,FR_HDF,9191,1714,5749
2020-05-24,16,1,4,7,FR_HDF,9207,1718,5756
2020-05-25,29,3,13,56,FR_HDF,9236,1731,5812
2020-05-26,45,5,6,62,FR_HDF,9281,1737,5874
2020-05-27,32,0,7,48,FR_HDF,9313,1744,5922
2020-05-28,31,4,12,40,FR_HDF,9344,1756,5962
2020-05-29,30,2,6,68,FR_HDF,9374,1762,6030
2020-05-30,25,3,8,36,FR_HDF,9399,1770,6066
2020-05-31,4,1,3,7,FR_HDF,9403,1773,6073
2020-06-01,15,1,5,5,FR_HDF,9418,1778,6078
2020-06-02,22,2,7,27,FR_HDF,9440,1785,6105
2020-06-03,22,2,9,40,FR_HDF,9462,1794,6145
2020-06-04,18,7,10,50,FR_HDF,9480,1804,6195
2020-06-05,23,1,8,53,FR_HDF,9503,1812,6248
2020-06-06,9,3,2,9,FR_HDF,9512,1814,6257
2020-06-07,5,0,1,2,FR_HDF,9517,1815,6259
2020-06-08,19,3,8,18,FR_HDF,9536,1823,6277
2020-06-09,23,2,2,55,FR_HDF,9559,1825,6332
2020-06-10,13,3,4,30,FR_HDF,9572,1829,6362
2020-06-11,3,1,1,20,FR_HDF,9575,1830,6382
2020-06-12,13,3,2,27,FR_HDF,9588,1832,6409
2020-06-13,4,0,1,18,FR_HDF,9592,1833,6427
2020-06-14,2,0,1,2,FR_HDF,9594,1834,6429
2020-06-15,9,1,3,16,FR_HDF,9603,1837,6445
2020-06-16,17,0,7,20,FR_HDF,9620,1844,6465
2020-06-17,3,1,5,13,FR_HDF,9623,1849,6478
2020-06-18,14,0,2,22,FR_HDF,9637,1851,6500
2020-06-19,3,1,2,14,FR_HDF,9640,1853,6514
2020-06-20,6,0,2,11,FR_HDF,9646,1855,6525
2020-06-21,6,0,1,0,FR_HDF,9652,1856,6525
2020-06-22,4,0,2,13,FR_HDF,9656,1858,6538
2020-06-23,11,1,0,20,FR_HDF,9667,1858,6558
2020-06-24,8,0,2,31,FR_HDF,9675,1860,6589
2020-03-19,706,150,37,126,FR_IDF,706,37,126
2020-03-20,457,89,26,106,FR_IDF,1163,63,232
2020-03-21,549,104,28,110,FR_IDF,1712,91,342
2020-03-22,589,125,24,92,FR_IDF,2301,115,434
2020-03-23,688,155,46,127,FR_IDF,2989,161,561
2020-03-24,859,236,69,199,FR_IDF,3848,230,760
2020-03-25,1073,219,97,240,FR_IDF,4921,327,1000
2020-03-26,1093,222,106,234,FR_IDF,6014,433,1234
2020-03-27,1122,193,120,293,FR_IDF,7136,553,1527
2020-03-28,1216,242,112,345,FR_IDF,8352,665,1872
2020-03-29,887,158,120,177,FR_IDF,9239,785,2049
2020-03-30,1061,189,147,291,FR_IDF,10300,932,2340
2020-03-31,1731,288,225,530,FR_IDF,12031,1157,2870
2020-04-01,1798,304,194,534,FR_IDF,13829,1351,3404
2020-04-02,1412,260,207,485,FR_IDF,15241,1558,3889
2020-04-03,1449,258,226,555,FR_IDF,16690,1784,4444
2020-04-04,1147,192,177,482,FR_IDF,17837,1961,4926
2020-04-05,714,153,140,295,FR_IDF,18551,2101,5221
2020-04-06,1117,196,251,452,FR_IDF,19668,2352,5673
2020-04-07,1363,238,276,653,FR_IDF,21031,2628,6326
2020-04-08,1370,208,227,666,FR_IDF,22401,2855,6992
2020-04-09,1226,169,191,784,FR_IDF,23627,3046,7776
2020-04-10,1241,197,262,726,FR_IDF,24868,3308,8502
2020-04-11,893,117,121,504,FR_IDF,25761,3429,9006
2020-04-12,626,125,134,329,FR_IDF,26387,3563,9335
2020-04-13,514,102,164,276,FR_IDF,26901,3727,9611
2020-04-14,697,135,236,416,FR_IDF,27598,3963,10027
2020-04-15,889,125,209,770,FR_IDF,28487,4172,10797
2020-04-16,862,126,184,766,FR_IDF,29349,4356,11563
2020-04-17,868,95,195,673,FR_IDF,30217,4551,12236
2020-04-18,592,94,155,644,FR_IDF,30809,4706,12880
2020-04-19,309,43,93,217,FR_IDF,31118,4799,13097
2020-04-20,578,73,188,351,FR_IDF,31696,4987,13448
2020-04-21,627,83,157,640,FR_IDF,32323,5144,14088
2020-04-22,605,68,130,594,FR_IDF,32928,5274,14682
2020-04-23,525,70,116,572,FR_IDF,33453,5390,15254
2020-04-24,525,62,126,575,FR_IDF,33978,5516,15829
2020-04-25,379,64,68,440,FR_IDF,34357,5584,16269
2020-04-26,175,28,62,148,FR_IDF,34532,5646,16417
2020-04-27,329,50,115,279,FR_IDF,34861,5761,16696
2020-04-28,504,57,158,537,FR_IDF,35365,5919,17233
2020-04-29,416,44,101,494,FR_IDF,35781,6020,17727
2020-04-30,339,45,72,447,FR_IDF,36120,6092,18174
2020-05-01,203,25,41,261,FR_IDF,36323,6133,18435
2020-05-02,138,25,40,159,FR_IDF,36461,6173,18594
2020-05-03,102,33,32,94,FR_IDF,36563,6205,18688
2020-05-04,222,37,93,239,FR_IDF,36785,6298,18927
2020-05-05,349,30,79,608,FR_IDF,37134,6377,19535
2020-05-06,333,31,64,536,FR_IDF,37467,6441,20071
2020-05-07,238,42,46,547,FR_IDF,37705,6487,20618
2020-05-08,154,39,32,234,FR_IDF,37859,6519,20852
2020-05-09,106,16,30,98,FR_IDF,37965,6549,20950
2020-05-10,95,15,24,95,FR_IDF,38060,6573,21045
2020-05-11,168,29,57,247,FR_IDF,38228,6630,21292
2020-05-12,252,35,71,466,FR_IDF,38480,6701,21758
2020-05-13,183,26,36,315,FR_IDF,38663,6737,22073
2020-05-14,171,19,36,339,FR_IDF,38834,6773,22412
2020-05-15,127,27,31,313,FR_IDF,38961,6804,22725
2020-05-16,112,17,16,241,FR_IDF,39073,6820,22966
2020-05-17,42,8,17,67,FR_IDF,39115,6837,23033
2020-05-18,120,12,39,248,FR_IDF,39235,6876,23281
2020-05-19,180,29,54,346,FR_IDF,39415,6930,23627
2020-05-20,174,16,29,299,FR_IDF,39589,6959,23926
2020-05-21,107,16,23,181,FR_IDF,39696,6982,24107
2020-05-22,85,11,31,135,FR_IDF,39781,7013,24242
2020-05-23,62,10,10,154,FR_IDF,39843,7023,24396
2020-05-24,25,10,12,24,FR_IDF,39868,7035,24420
2020-05-25,108,16,33,218,FR_IDF,39976,7068,24638
2020-05-26,111,10,38,213,FR_IDF,40087,7106,24851
2020-05-27,69,11,27,272,FR_IDF,40156,7133,25123
2020-05-28,91,9,25,207,FR_IDF,40247,7158,25330
2020-05-29,77,12,17,192,FR_IDF,40324,7175,25522
2020-05-30,77,8,38,200,FR_IDF,40401,7213,25722
2020-05-31,7,3,18,29,FR_IDF,40408,7231,25751
2020-06-01,32,3,13,50,FR_IDF,40440,7244,25801
2020-06-02,79,12,29,99,FR_IDF,40519,7273,25900
2020-06-03,75,12,36,270,FR_IDF,40594,7309,26170
2020-06-04,68,6,12,167,FR_IDF,40662,7321,26337
2020-06-05,45,5,12,161,FR_IDF,40707,7333,26498
2020-06-06,51,7,22,156,FR_IDF,40758,7355,26654
2020-06-07,11,3,5,12,FR_IDF,40769,7360,26666
2020-06-08,37,6,14,83,FR_IDF,40806,7374,26749
2020-06-09,63,7,30,162,FR_IDF,40869,7404,26911
2020-06-10,36,10,9,75,FR_IDF,40905,7413,26986
2020-06-11,47,11,12,118,FR_IDF,40952,7425,27104
2020-06-12,33,5,15,126,FR_IDF,40985,7440,27230
2020-06-13,11,2,15,124,FR_IDF,40996,7455,27354
2020-06-14,4,2,3,16,FR_IDF,41000,7458,27370
2020-06-15,31,4,11,80,FR_IDF,41031,7469,27450
2020-06-16,36,6,19,125,FR_IDF,41067,7488,27575
2020-06-17,17,2,11,88,FR_IDF,41084,7499,27663
2020-06-18,41,6,4,81,FR_IDF,41125,7503,27744
2020-06-19,31,4,2,88,FR_IDF,41156,7505,27832
2020-06-20,23,2,11,78,FR_IDF,41179,7516,27910
2020-06-21,11,0,2,18,FR_IDF,41190,7518,27928
2020-06-22,59,5,8,100,FR_IDF,41249,7526,28028
2020-06-23,41,6,14,123,FR_IDF,41290,7540,28151
2020-06-24,28,3,0,84,FR_IDF,41318,7540,28235
2020-03-19,0,0,0,0,FR_LRE,0,0,0
2020-03-20,0,0,0,0,FR_LRE,0,0,0
2020-03-21,0,0,0,0,FR_LRE,0,0,0
2020-03-22,0,0,0,0,FR_LRE,0,0,0
2020-03-23,0,0,0,0,FR_LRE,0,0,0
2020-03-24,1,1,0,0,FR_LRE,1,0,0
2020-03-25,0,0,0,0,FR_LRE,2,0,0
2020-03-26,0,0,0,0,FR_LRE,2,0,0
2020-03-27,0,0,0,0,FR_LRE,2,0,0
2020-03-28,12,1,0,0,FR_LRE,14,0,0
2020-03-29,42,0,0,5,FR_LRE,68,0,5
2020-03-30,4,1,0,1,FR_LRE,114,0,11
2020-03-31,6,2,0,4,FR_LRE,124,0,16
2020-04-01,7,0,0,10,FR_LRE,137,0,30
2020-04-02,6,1,0,4,FR_LRE,150,0,44
2020-04-03,4,0,0,5,FR_LRE,160,0,53
2020-04-04,3,2,0,10,FR_LRE,167,0,68
2020-04-05,0,0,0,2,FR_LRE,170,0,80
2020-04-06,3,0,0,2,FR_LRE,173,0,84
2020-04-07,1,0,0,9,FR_LRE,177,0,95
2020-04-08,5,0,0,3,FR_LRE,183,0,107
2020-04-09,0,1,0,3,FR_LRE,188,0,113
2020-04-10,6,0,0,0,FR_LRE,194,0,116
2020-04-11,0,0,0,12,FR_LRE,200,0,128
2020-04-12,0,0,0,2,FR_LRE,200,0,142
2020-04-13,0,0,0,0,FR_LRE,200,0,144
2020-04-14,0,0,0,1,FR_LRE,200,0,145
2020-04-15,0,0,0,4,FR_LRE,200,0,150
2020-04-16,2,1,0,7,FR_LRE,202,0,161
2020-04-17,1,0,0,3,FR_LRE,205,0,171
2020-04-18,0,0,0,3,FR_LRE,206,0,177
2020-04-19,4,0,0,1,FR_LRE,210,0,181
2020-04-20,1,0,0,3,FR_LRE,215,0,185
2020-04-21,0,0,0,1,FR_LRE,216,0,189
2020-04-22,0,0,0,2,FR_LRE,216,0,192
2020-04-23,0,0,0,2,FR_LRE,216,0,196
2020-04-24,0,0,0,2,FR_LRE,216,0,200
2020-04-25,1,0,0,2,FR_LRE,217,0,204
2020-04-26,0,0,0,1,FR_LRE,218,0,207
2020-04-27,0,0,0,0,FR_LRE,218,0,208
2020-04-28,1,0,0,1,FR_LRE,219,0,209
2020-04-29,3,0,0,5,FR_LRE,223,0,215
2020-04-30,0,0,0,0,FR_LRE,226,0,220
2020-05-01,0,0,0,0,FR_LRE,226,0,220
2020-05-02,2,1,0,1,FR_LRE,228,0,221
2020-05-03,0,0,0,1,FR_LRE,230,0,223
2020-05-04,1,0,0,0,FR_LRE,231,0,224
2020-05-05,3,0,0,1,FR_LRE,235,0,225
2020-05-06,1,0,0,0,FR_LRE,239,0,226
2020-05-07,3,2,0,0,FR_LRE,243,0,226
2020-05-08,3,1,0,0,FR_LRE,249,0,226
2020-05-09,2,1,0,1,FR_LRE,254,0,227
2020-05-10,0,2,0,1,FR_LRE,256,0,229
2020-05-11,0,0,0,0,FR_LRE,256,0,230
2020-05-12,0,0,0,0,FR_LRE,256,0,230
2020-05-13,1,0,0,0,FR_LRE,257,0,230
2020-05-14,1,1,0,2,FR_LRE,259,0,232
2020-05-15,0,0,0,0,FR_LRE,260,0,234
2020-05-16,3,1,0,1,FR_LRE,263,0,235
2020-05-17,0,0,0,0,FR_LRE,266,0,236
2020-05-18,1,0,0,0,FR_LRE,267,0,236
2020-05-19,0,0,0,0,FR_LRE,268,0,236
2020-05-20,0,0,1,1,FR_LRE,268,1,237
2020-05-21,1,0,0,0,FR_LRE,269,2,238
2020-05-22,0,0,0,0,FR_LRE,270,2,238
2020-05-23,0,0,0,0,FR_LRE,270,2,238
2020-05-24,2,1,0,0,FR_LRE,272,2,238
2020-05-25,2,0,0,0,FR_LRE,276,2,238
2020-05-26,1,0,0,0,FR_LRE,279,2,238
2020-05-27,2,0,0,0,FR_LRE,282,2,238
2020-05-28,0,0,0,0,FR_LRE,284,2,238
2020-05-29,2,1,0,3,FR_LRE,286,2,241
2020-05-30,2,1,0,0,FR_LRE,290,2,244
2020-05-31,0,0,0,0,FR_LRE,292,2,244
2020-06-01,0,0,0,0,FR_LRE,292,2,244
2020-06-02,0,0,0,1,FR_LRE,292,2,245
2020-06-03,0,0,0,2,FR_LRE,292,2,248
2020-06-04,0,0,0,0,FR_LRE,292,2,250
2020-06-05,0,0,0,1,FR_LRE,292,2,251
2020-06-06,0,0,0,0,FR_LRE,292,2,252
2020-06-07,0,0,0,0,FR_LRE,292,2,252
2020-06-08,0,0,0,0,FR_LRE,292,2,252
2020-06-09,1,0,0,1,FR_LRE,293,2,253
2020-06-10,0,0,0,0,FR_LRE,294,2,254
2020-06-11,0,0,0,1,FR_LRE,294,2,255
2020-06-12,5,3,0,1,FR_LRE,299,2,257
2020-06-13,1,0,0,0,FR_LRE,305,2,258
2020-06-14,0,0,0,0,FR_LRE,306,2,258
2020-06-15,2,0,0,0,FR_LRE,308,2,258
2020-06-16,1,0,0,4,FR_LRE,311,2,262
2020-06-17,5,1,0,3,FR_LRE,317,2,269
2020-06-18,0,0,0,0,FR_LRE,322,2,272
2020-06-19,0,0,0,0,FR_LRE,322,2,272
2020-06-20,0,0,0,0,FR_LRE,322,2,272
2020-06-21,0,0,0,0,FR_LRE,322,2,272
2020-06-22,0,0,0,0,FR_LRE,322,2,272
2020-06-23,0,0,0,2,FR_LRE,322,2,274
2020-06-24,0,1,0,0,FR_LRE,322,2,276
2020-03-19,0,0,0,0,FR_LRE,0,0,0
2020-03-20,0,0,0,0,FR_LRE,0,0,0
2020-03-21,0,0,0,0,FR_LRE,0,0,0
2020-03-22,0,0,0,0,FR_LRE,0,0,0
2020-03-23,0,0,0,0,FR_LRE,0,0,0
2020-03-24,1,1,0,0,FR_LRE,2,0,0
2020-03-25,0,0,0,0,FR_LRE,2,0,0
2020-03-26,0,0,0,0,FR_LRE,2,0,0
2020-03-27,0,0,0,0,FR_LRE,2,0,0
2020-03-28,12,1,0,0,FR_LRE,26,0,0
2020-03-29,42,0,0,5,FR_LRE,110,0,10
2020-03-30,4,1,0,1,FR_LRE,118,0,12
2020-03-31,6,2,0,4,FR_LRE,130,0,20
2020-04-01,7,0,0,10,FR_LRE,144,0,40
2020-04-02,6,1,0,4,FR_LRE,156,0,48
2020-04-03,4,0,0,5,FR_LRE,164,0,58
2020-04-04,3,2,0,10,FR_LRE,170,0,78
2020-04-05,0,0,0,2,FR_LRE,170,0,82
2020-04-06,3,0,0,2,FR_LRE,176,0,86
2020-04-07,1,0,0,9,FR_LRE,178,0,104
2020-04-08,5,0,0,3,FR_LRE,188,0,110
2020-04-09,0,1,0,3,FR_LRE,188,0,116
2020-04-10,6,0,0,0,FR_LRE,200,0,116
2020-04-11,0,0,0,12,FR_LRE,200,0,140
2020-04-12,0,0,0,2,FR_LRE,200,0,144
2020-04-13,0,0,0,0,FR_LRE,200,0,144
2020-04-14,0,0,0,1,FR_LRE,200,0,146
2020-04-15,0,0,0,4,FR_LRE,200,0,154
2020-04-16,2,1,0,7,FR_LRE,204,0,168
2020-04-17,1,0,0,3,FR_LRE,206,0,174
2020-04-18,0,0,0,3,FR_LRE,206,0,180
2020-04-19,4,0,0,1,FR_LRE,214,0,182
2020-04-20,1,0,0,3,FR_LRE,216,0,188
2020-04-21,0,0,0,1,FR_LRE,216,0,190
2020-04-22,0,0,0,2,FR_LRE,216,0,194
2020-04-23,0,0,0,2,FR_LRE,216,0,198
2020-04-24,0,0,0,2,FR_LRE,216,0,202
2020-04-25,1,0,0,2,FR_LRE,218,0,206
2020-04-26,0,0,0,1,FR_LRE,218,0,208
2020-04-27,0,0,0,0,FR_LRE,218,0,208
2020-04-28,1,0,0,1,FR_LRE,220,0,210
2020-04-29,3,0,0,5,FR_LRE,226,0,220
2020-04-30,0,0,0,0,FR_LRE,226,0,220
2020-05-01,0,0,0,0,FR_LRE,226,0,220
2020-05-02,2,1,0,1,FR_LRE,230,0,222
2020-05-03,0,0,0,1,FR_LRE,230,0,224
2020-05-04,1,0,0,0,FR_LRE,232,0,224
2020-05-05,3,0,0,1,FR_LRE,238,0,226
2020-05-06,1,0,0,0,FR_LRE,240,0,226
2020-05-07,3,2,0,0,FR_LRE,246,0,226
2020-05-08,3,1,0,0,FR_LRE,252,0,226
2020-05-09,2,1,0,1,FR_LRE,256,0,228
2020-05-10,0,2,0,1,FR_LRE,256,0,230
2020-05-11,0,0,0,0,FR_LRE,256,0,230
2020-05-12,0,0,0,0,FR_LRE,256,0,230
2020-05-13,1,0,0,0,FR_LRE,258,0,230
2020-05-14,1,1,0,2,FR_LRE,260,0,234
2020-05-15,0,0,0,0,FR_LRE,260,0,234
2020-05-16,3,1,0,1,FR_LRE,266,0,236
2020-05-17,0,0,0,0,FR_LRE,266,0,236
2020-05-18,1,0,0,0,FR_LRE,268,0,236
2020-05-19,0,0,0,0,FR_LRE,268,0,236
2020-05-20,0,0,1,1,FR_LRE,268,2,238
2020-05-21,1,0,0,0,FR_LRE,270,2,238
2020-05-22,0,0,0,0,FR_LRE,270,2,238
2020-05-23,0,0,0,0,FR_LRE,270,2,238
2020-05-24,2,1,0,0,FR_LRE,274,2,238
2020-05-25,2,0,0,0,FR_LRE,278,2,238
2020-05-26,1,0,0,0,FR_LRE,280,2,238
2020-05-27,2,0,0,0,FR_LRE,284,2,238
2020-05-28,0,0,0,0,FR_LRE,284,2,238
2020-05-29,2,1,0,3,FR_LRE,288,2,244
2020-05-30,2,1,0,0,FR_LRE,292,2,244
2020-05-31,0,0,0,0,FR_LRE,292,2,244
2020-06-01,0,0,0,0,FR_LRE,292,2,244
2020-06-02,0,0,0,1,FR_LRE,292,2,246
2020-06-03,0,0,0,2,FR_LRE,292,2,250
2020-06-04,0,0,0,0,FR_LRE,292,2,250
2020-06-05,0,0,0,1,FR_LRE,292,2,252
2020-06-06,0,0,0,0,FR_LRE,292,2,252
2020-06-07,0,0,0,0,FR_LRE,292,2,252
2020-06-08,0,0,0,0,FR_LRE,292,2,252
2020-06-09,1,0,0,1,FR_LRE,294,2,254
2020-06-10,0,0,0,0,FR_LRE,294,2,254
2020-06-11,0,0,0,1,FR_LRE,294,2,256
2020-06-12,5,3,0,1,FR_LRE,304,2,258
2020-06-13,1,0,0,0,FR_LRE,306,2,258
2020-06-14,0,0,0,0,FR_LRE,306,2,258
2020-06-15,2,0,0,0,FR_LRE,310,2,258
2020-06-16,1,0,0,4,FR_LRE,312,2,266
2020-06-17,5,1,0,3,FR_LRE,322,2,272
2020-06-18,0,0,0,0,FR_LRE,322,2,272
2020-06-19,0,0,0,0,FR_LRE,322,2,272
2020-06-20,0,0,0,0,FR_LRE,322,2,272
2020-06-21,0,0,0,0,FR_LRE,322,2,272
2020-06-22,0,0,0,0,FR_LRE,322,2,272
2020-06-23,0,0,0,2,FR_LRE,322,2,276
2020-06-24,0,1,0,0,FR_LRE,322,2,276
2020-03-19,0,0,0,0,FR_MAY,0,0,0
2020-03-20,0,0,0,0,FR_MAY,0,0,0
2020-03-21,0,0,0,0,FR_MAY,0,0,0
2020-03-22,0,0,0,0,FR_MAY,0,0,0
2020-03-23,0,0,0,0,FR_MAY,0,0,0
2020-03-24,0,0,0,0,FR_MAY,0,0,0
2020-03-25,0,0,0,0,FR_MAY,0,0,0
2020-03-26,0,0,0,0,FR_MAY,0,0,0
2020-03-27,0,0,0,0,FR_MAY,0,0,0
2020-03-28,0,0,0,0,FR_MAY,0,0,0
2020-03-29,0,0,0,0,FR_MAY,0,0,0
2020-03-30,0,0,0,0,FR_MAY,0,0,0
2020-03-31,0,0,0,0,FR_MAY,0,0,0
2020-04-01,1,0,0,1,FR_MAY,1,0,1
2020-04-02,11,2,2,1,FR_MAY,13,2,3
2020-04-03,9,0,0,0,FR_MAY,33,4,4
2020-04-04,2,0,0,5,FR_MAY,44,4,9
2020-04-05,3,0,0,1,FR_MAY,49,4,15
2020-04-06,4,0,0,5,FR_MAY,56,4,21
2020-04-07,4,0,0,4,FR_MAY,64,4,30
2020-04-08,7,1,0,8,FR_MAY,75,4,42
2020-04-09,2,0,0,1,FR_MAY,84,4,51
2020-04-10,2,0,0,0,FR_MAY,88,4,52
2020-04-11,2,0,1,1,FR_MAY,92,5,53
2020-04-12,2,0,0,0,FR_MAY,96,6,54
2020-04-13,0,0,0,0,FR_MAY,98,6,54
2020-04-14,4,0,0,10,FR_MAY,102,6,64
2020-04-15,5,1,0,3,FR_MAY,111,6,77
2020-04-16,7,2,1,2,FR_MAY,123,7,82
2020-04-17,2,0,0,2,FR_MAY,132,8,86
2020-04-18,2,0,0,0,FR_MAY,136,8,88
2020-04-19,5,0,1,3,FR_MAY,143,9,91
2020-04-20,1,0,1,3,FR_MAY,149,11,97
2020-04-21,4,0,0,5,FR_MAY,154,12,105
2020-04-22,4,0,0,2,FR_MAY,162,12,112
2020-04-23,2,0,0,4,FR_MAY,168,12,118
2020-04-24,9,0,0,2,FR_MAY,179,12,124
2020-04-25,0,0,0,0,FR_MAY,188,12,126
2020-04-26,12,2,0,6,FR_MAY,200,12,132
2020-04-27,6,0,0,4,FR_MAY,218,12,142
2020-04-28,8,0,0,10,FR_MAY,232,12,156
2020-04-29,0,0,0,0,FR_MAY,240,12,166
2020-04-30,7,0,0,9,FR_MAY,247,12,175
2020-05-01,6,2,2,8,FR_MAY,260,14,192
2020-05-02,2,1,0,1,FR_MAY,268,16,201
2020-05-03,8,1,0,1,FR_MAY,278,16,203
2020-05-04,10,1,1,5,FR_MAY,296,17,209
2020-05-05,6,2,2,3,FR_MAY,312,20,217
2020-05-06,7,1,1,6,FR_MAY,325,23,226
2020-05-07,10,0,0,4,FR_MAY,342,24,236
2020-05-08,4,2,0,3,FR_MAY,356,24,243
2020-05-09,5,0,0,4,FR_MAY,365,24,250
2020-05-10,9,2,0,1,FR_MAY,379,24,255
2020-05-11,9,1,1,19,FR_MAY,397,25,275
2020-05-12,10,1,3,8,FR_MAY,416,29,302
2020-05-13,9,2,0,9,FR_MAY,435,32,319
2020-05-14,12,0,0,6,FR_MAY,456,32,334
2020-05-15,7,1,1,6,FR_MAY,475,33,346
2020-05-16,2,0,0,7,FR_MAY,484,34,359
2020-05-17,6,1,0,2,FR_MAY,492,34,368
2020-05-18,1,0,1,0,FR_MAY,499,35,370
2020-05-19,4,2,0,6,FR_MAY,504,36,376
2020-05-20,3,2,0,2,FR_MAY,511,36,384
2020-05-21,6,0,0,12,FR_MAY,520,36,398
2020-05-22,6,1,0,4,FR_MAY,532,36,414
2020-05-23,3,1,1,9,FR_MAY,541,37,427
2020-05-24,5,0,0,1,FR_MAY,549,38,437
2020-05-25,3,1,0,0,FR_MAY,557,38,438
2020-05-26,5,2,0,8,FR_MAY,565,38,446
2020-05-27,7,0,0,5,FR_MAY,577,38,459
2020-05-28,3,0,0,4,FR_MAY,587,38,468
2020-05-29,10,2,0,2,FR_MAY,600,38,474
2020-05-30,4,0,0,12,FR_MAY,614,38,488
2020-05-31,2,0,0,2,FR_MAY,620,38,502
2020-06-01,2,0,2,1,FR_MAY,624,40,505
2020-06-02,4,1,0,14,FR_MAY,630,42,520
2020-06-03,8,0,0,3,FR_MAY,642,42,537
2020-06-04,6,0,0,4,FR_MAY,656,42,544
2020-06-05,5,2,0,6,FR_MAY,667,42,554
2020-06-06,7,1,0,3,FR_MAY,679,42,563
2020-06-07,0,0,0,0,FR_MAY,686,42,566
2020-06-08,7,1,1,6,FR_MAY,693,43,572
2020-06-09,0,0,1,3,FR_MAY,700,45,581
2020-06-10,5,0,0,6,FR_MAY,705,46,590
2020-06-11,6,1,0,3,FR_MAY,716,46,599
2020-06-12,5,2,0,6,FR_MAY,727,46,608
2020-06-13,3,1,1,0,FR_MAY,735,47,614
2020-06-14,1,0,0,2,FR_MAY,739,48,616
2020-06-15,4,0,1,7,FR_MAY,744,49,625
2020-06-16,5,0,1,7,FR_MAY,753,51,639
2020-06-17,2,0,0,3,FR_MAY,760,52,649
2020-06-18,3,1,0,3,FR_MAY,765,52,655
2020-06-19,2,0,0,5,FR_MAY,770,52,663
2020-06-20,6,0,0,7,FR_MAY,778,52,675
2020-06-21,3,2,1,1,FR_MAY,787,53,683
2020-06-22,10,2,0,7,FR_MAY,800,54,691
2020-06-23,4,1,0,10,FR_MAY,814,54,708
2020-06-24,3,0,1,1,FR_MAY,821,55,719
2020-03-19,0,0,0,0,FR_MAY,0,0,0
2020-03-20,0,0,0,0,FR_MAY,0,0,0
2020-03-21,0,0,0,0,FR_MAY,0,0,0
2020-03-22,0,0,0,0,FR_MAY,0,0,0
2020-03-23,0,0,0,0,FR_MAY,0,0,0
2020-03-24,0,0,0,0,FR_MAY,0,0,0
2020-03-25,0,0,0,0,FR_MAY,0,0,0
2020-03-26,0,0,0,0,FR_MAY,0,0,0
2020-03-27,0,0,0,0,FR_MAY,0,0,0
2020-03-28,0,0,0,0,FR_MAY,0,0,0
2020-03-29,0,0,0,0,FR_MAY,0,0,0
2020-03-30,0,0,0,0,FR_MAY,0,0,0
2020-03-31,0,0,0,0,FR_MAY,0,0,0
2020-04-01,1,0,0,1,FR_MAY,2,0,2
2020-04-02,11,2,2,1,FR_MAY,24,4,4
2020-04-03,9,0,0,0,FR_MAY,42,4,4
2020-04-04,2,0,0,5,FR_MAY,46,4,14
2020-04-05,3,0,0,1,FR_MAY,52,4,16
2020-04-06,4,0,0,5,FR_MAY,60,4,26
2020-04-07,4,0,0,4,FR_MAY,68,4,34
2020-04-08,7,1,0,8,FR_MAY,82,4,50
2020-04-09,2,0,0,1,FR_MAY,86,4,52
2020-04-10,2,0,0,0,FR_MAY,90,4,52
2020-04-11,2,0,1,1,FR_MAY,94,6,54
2020-04-12,2,0,0,0,FR_MAY,98,6,54
2020-04-13,0,0,0,0,FR_MAY,98,6,54
2020-04-14,4,0,0,10,FR_MAY,106,6,74
2020-04-15,5,1,0,3,FR_MAY,116,6,80
2020-04-16,7,2,1,2,FR_MAY,130,8,84
2020-04-17,2,0,0,2,FR_MAY,134,8,88
2020-04-18,2,0,0,0,FR_MAY,138,8,88
2020-04-19,5,0,1,3,FR_MAY,148,10,94
2020-04-20,1,0,1,3,FR_MAY,150,12,100
2020-04-21,4,0,0,5,FR_MAY,158,12,110
2020-04-22,4,0,0,2,FR_MAY,166,12,114
2020-04-23,2,0,0,4,FR_MAY,170,12,122
2020-04-24,9,0,0,2,FR_MAY,188,12,126
2020-04-25,0,0,0,0,FR_MAY,188,12,126
2020-04-26,12,2,0,6,FR_MAY,212,12,138
2020-04-27,6,0,0,4,FR_MAY,224,12,146
2020-04-28,8,0,0,10,FR_MAY,240,12,166
2020-04-29,0,0,0,0,FR_MAY,240,12,166
2020-04-30,7,0,0,9,FR_MAY,254,12,184
2020-05-01,6,2,2,8,FR_MAY,266,16,200
2020-05-02,2,1,0,1,FR_MAY,270,16,202
2020-05-03,8,1,0,1,FR_MAY,286,16,204
2020-05-04,10,1,1,5,FR_MAY,306,18,214
2020-05-05,6,2,2,3,FR_MAY,318,22,220
2020-05-06,7,1,1,6,FR_MAY,332,24,232
2020-05-07,10,0,0,4,FR_MAY,352,24,240
2020-05-08,4,2,0,3,FR_MAY,360,24,246
2020-05-09,5,0,0,4,FR_MAY,370,24,254
2020-05-10,9,2,0,1,FR_MAY,388,24,256
2020-05-11,9,1,1,19,FR_MAY,406,26,294
2020-05-12,10,1,3,8,FR_MAY,426,32,310
2020-05-13,9,2,0,9,FR_MAY,444,32,328
2020-05-14,12,0,0,6,FR_MAY,468,32,340
2020-05-15,7,1,1,6,FR_MAY,482,34,352
2020-05-16,2,0,0,7,FR_MAY,486,34,366
2020-05-17,6,1,0,2,FR_MAY,498,34,370
2020-05-18,1,0,1,0,FR_MAY,500,36,370
2020-05-19,4,2,0,6,FR_MAY,508,36,382
2020-05-20,3,2,0,2,FR_MAY,514,36,386
2020-05-21,6,0,0,12,FR_MAY,526,36,410
2020-05-22,6,1,0,4,FR_MAY,538,36,418
2020-05-23,3,1,1,9,FR_MAY,544,38,436
2020-05-24,5,0,0,1,FR_MAY,554,38,438
2020-05-25,3,1,0,0,FR_MAY,560,38,438
2020-05-26,5,2,0,8,FR_MAY,570,38,454
2020-05-27,7,0,0,5,FR_MAY,584,38,464
2020-05-28,3,0,0,4,FR_MAY,590,38,472
2020-05-29,10,2,0,2,FR_MAY,610,38,476
2020-05-30,4,0,0,12,FR_MAY,618,38,500
2020-05-31,2,0,0,2,FR_MAY,622,38,504
2020-06-01,2,0,2,1,FR_MAY,626,42,506
2020-06-02,4,1,0,14,FR_MAY,634,42,534
2020-06-03,8,0,0,3,FR_MAY,650,42,540
2020-06-04,6,0,0,4,FR_MAY,662,42,548
2020-06-05,5,2,0,6,FR_MAY,672,42,560
2020-06-06,7,1,0,3,FR_MAY,686,42,566
2020-06-07,0,0,0,0,FR_MAY,686,42,566
2020-06-08,7,1,1,6,FR_MAY,700,44,578
2020-06-09,0,0,1,3,FR_MAY,700,46,584
2020-06-10,5,0,0,6,FR_MAY,710,46,596
2020-06-11,6,1,0,3,FR_MAY,722,46,602
2020-06-12,5,2,0,6,FR_MAY,732,46,614
2020-06-13,3,1,1,0,FR_MAY,738,48,614
2020-06-14,1,0,0,2,FR_MAY,740,48,618
2020-06-15,4,0,1,7,FR_MAY,748,50,632
2020-06-16,5,0,1,7,FR_MAY,758,52,646
2020-06-17,2,0,0,3,FR_MAY,762,52,652
2020-06-18,3,1,0,3,FR_MAY,768,52,658
2020-06-19,2,0,0,5,FR_MAY,772,52,668
2020-06-20,6,0,0,7,FR_MAY,784,52,682
2020-06-21,3,2,1,1,FR_MAY,790,54,684
2020-06-22,10,2,0,7,FR_MAY,810,54,698
2020-06-23,4,1,0,10,FR_MAY,818,54,718
2020-06-24,3,0,1,1,FR_MAY,824,56,720
2020-03-19,1,0,0,0,FR_MQ,1,0,0
2020-03-20,2,0,0,0,FR_MQ,4,0,0
2020-03-21,0,0,0,0,FR_MQ,6,0,0
2020-03-22,1,1,0,0,FR_MQ,7,0,0
2020-03-23,0,0,0,0,FR_MQ,8,0,0
2020-03-24,5,2,0,11,FR_MQ,13,0,11
2020-03-25,11,2,0,1,FR_MQ,29,0,23
2020-03-26,8,4,0,1,FR_MQ,48,0,25
2020-03-27,14,3,0,0,FR_MQ,70,0,26
2020-03-28,11,0,0,2,FR_MQ,95,0,28
2020-03-29,9,2,2,2,FR_MQ,115,2,32
2020-03-30,0,0,0,0,FR_MQ,124,4,34
2020-03-31,11,3,0,3,FR_MQ,135,4,37
2020-04-01,4,1,1,5,FR_MQ,150,5,45
2020-04-02,2,1,0,7,FR_MQ,156,6,57
2020-04-03,0,0,0,3,FR_MQ,158,6,67
2020-04-04,6,2,0,1,FR_MQ,164,6,71
2020-04-05,5,2,0,2,FR_MQ,175,6,74
2020-04-06,2,0,1,0,FR_MQ,182,7,76
2020-04-07,1,0,0,4,FR_MQ,185,8,80
2020-04-08,0,1,0,2,FR_MQ,186,8,86
2020-04-09,1,0,1,2,FR_MQ,187,9,90
2020-04-10,0,0,0,3,FR_MQ,188,10,95
2020-04-11,1,0,0,2,FR_MQ,189,10,100
2020-04-12,0,0,1,2,FR_MQ,190,11,104
2020-04-13,1,1,0,0,FR_MQ,191,12,106
2020-04-14,0,0,0,0,FR_MQ,192,12,106
2020-04-15,0,0,0,1,FR_MQ,192,12,107
2020-04-16,4,1,0,2,FR_MQ,196,12,110
2020-04-17,2,0,0,4,FR_MQ,202,12,116
2020-04-18,0,0,1,1,FR_MQ,204,13,121
2020-04-19,1,0,0,1,FR_MQ,205,14,123
2020-04-20,0,0,2,0,FR_MQ,206,16,124
2020-04-21,5,0,4,0,FR_MQ,211,22,124
2020-04-22,0,0,0,2,FR_MQ,216,26,126
2020-04-23,1,0,1,0,FR_MQ,217,27,128
2020-04-24,0,0,0,1,FR_MQ,218,28,129
2020-04-25,0,0,0,0,FR_MQ,218,28,130
2020-04-26,0,0,0,0,FR_MQ,218,28,130
2020-04-27,0,0,0,0,FR_MQ,218,28,130
2020-04-28,0,0,0,1,FR_MQ,218,28,131
2020-04-29,0,0,0,0,FR_MQ,218,28,132
2020-04-30,2,1,0,13,FR_MQ,220,28,145
2020-05-01,0,0,0,0,FR_MQ,222,28,158
2020-05-02,0,0,0,0,FR_MQ,222,28,158
2020-05-03,0,0,0,0,FR_MQ,222,28,158
2020-05-04,0,0,0,0,FR_MQ,222,28,158
2020-05-05,0,0,0,1,FR_MQ,222,28,159
2020-05-06,0,0,0,0,FR_MQ,222,28,160
2020-05-07,0,0,0,0,FR_MQ,222,28,160
2020-05-08,0,0,0,0,FR_MQ,222,28,160
2020-05-09,0,0,0,1,FR_MQ,222,28,161
2020-05-10,1,0,0,0,FR_MQ,223,28,162
2020-05-11,0,0,0,0,FR_MQ,224,28,162
2020-05-12,0,0,0,0,FR_MQ,224,28,162
2020-05-13,0,0,0,0,FR_MQ,224,28,162
2020-05-14,0,0,0,0,FR_MQ,224,28,162
2020-05-15,1,0,0,0,FR_MQ,225,28,162
2020-05-16,0,0,0,1,FR_MQ,226,28,163
2020-05-17,0,0,0,0,FR_MQ,226,28,164
2020-05-18,0,0,0,0,FR_MQ,226,28,164
2020-05-19,0,0,0,0,FR_MQ,226,28,164
2020-05-20,0,0,0,1,FR_MQ,226,28,165
2020-05-21,0,0,0,0,FR_MQ,226,28,166
2020-05-22,0,1,0,0,FR_MQ,226,28,166
2020-05-23,0,0,0,0,FR_MQ,226,28,166
2020-05-24,0,0,0,0,FR_MQ,226,28,166
2020-05-25,0,0,0,0,FR_MQ,226,28,166
2020-05-26,0,0,0,0,FR_MQ,226,28,166
2020-05-27,0,0,0,0,FR_MQ,226,28,166
2020-05-28,0,0,0,0,FR_MQ,226,28,166
2020-05-29,0,0,0,0,FR_MQ,226,28,166
2020-05-30,0,0,0,0,FR_MQ,226,28,166
2020-05-31,0,0,0,4,FR_MQ,226,28,170
2020-06-01,0,0,0,0,FR_MQ,226,28,174
2020-06-02,0,0,0,0,FR_MQ,226,28,174
2020-06-03,0,0,0,0,FR_MQ,226,28,174
2020-06-04,0,0,0,0,FR_MQ,226,28,174
2020-06-05,0,0,0,1,FR_MQ,226,28,175
2020-06-06,0,0,0,0,FR_MQ,226,28,176
2020-06-07,0,0,0,1,FR_MQ,226,28,177
2020-06-08,0,0,0,0,FR_MQ,226,28,178
2020-06-09,2,2,0,0,FR_MQ,228,28,178
2020-06-10,0,0,0,0,FR_MQ,230,28,178
2020-06-11,0,0,0,0,FR_MQ,230,28,178
2020-06-12,0,0,0,0,FR_MQ,230,28,178
2020-06-13,0,0,0,2,FR_MQ,230,28,180
2020-06-14,1,0,0,0,FR_MQ,231,28,182
2020-06-15,1,2,0,0,FR_MQ,233,28,182
2020-06-16,0,0,0,0,FR_MQ,234,28,182
2020-06-17,1,1,0,0,FR_MQ,235,28,182
2020-06-18,0,0,0,0,FR_MQ,236,28,182
2020-06-19,0,0,0,0,FR_MQ,236,28,182
2020-06-20,1,0,0,0,FR_MQ,237,28,182
2020-06-21,0,0,0,0,FR_MQ,238,28,182
2020-06-22,0,0,0,0,FR_MQ,238,28,182
2020-06-23,0,0,0,0,FR_MQ,238,28,182
2020-06-24,0,0,0,0,FR_MQ,238,28,182
2020-03-19,1,0,0,0,FR_MQ,2,0,0
2020-03-20,2,0,0,0,FR_MQ,6,0,0
2020-03-21,0,0,0,0,FR_MQ,6,0,0
2020-03-22,1,1,0,0,FR_MQ,8,0,0
2020-03-23,0,0,0,0,FR_MQ,8,0,0
2020-03-24,5,2,0,11,FR_MQ,18,0,22
2020-03-25,11,2,0,1,FR_MQ,40,0,24
2020-03-26,8,4,0,1,FR_MQ,56,0,26
2020-03-27,14,3,0,0,FR_MQ,84,0,26
2020-03-28,11,0,0,2,FR_MQ,106,0,30
2020-03-29,9,2,2,2,FR_MQ,124,4,34
2020-03-30,0,0,0,0,FR_MQ,124,4,34
2020-03-31,11,3,0,3,FR_MQ,146,4,40
2020-04-01,4,1,1,5,FR_MQ,154,6,50
2020-04-02,2,1,0,7,FR_MQ,158,6,64
2020-04-03,0,0,0,3,FR_MQ,158,6,70
2020-04-04,6,2,0,1,FR_MQ,170,6,72
2020-04-05,5,2,0,2,FR_MQ,180,6,76
2020-04-06,2,0,1,0,FR_MQ,184,8,76
2020-04-07,1,0,0,4,FR_MQ,186,8,84
2020-04-08,0,1,0,2,FR_MQ,186,8,88
2020-04-09,1,0,1,2,FR_MQ,188,10,92
2020-04-10,0,0,0,3,FR_MQ,188,10,98
2020-04-11,1,0,0,2,FR_MQ,190,10,102
2020-04-12,0,0,1,2,FR_MQ,190,12,106
2020-04-13,1,1,0,0,FR_MQ,192,12,106
2020-04-14,0,0,0,0,FR_MQ,192,12,106
2020-04-15,0,0,0,1,FR_MQ,192,12,108
2020-04-16,4,1,0,2,FR_MQ,200,12,112
2020-04-17,2,0,0,4,FR_MQ,204,12,120
2020-04-18,0,0,1,1,FR_MQ,204,14,122
2020-04-19,1,0,0,1,FR_MQ,206,14,124
2020-04-20,0,0,2,0,FR_MQ,206,18,124
2020-04-21,5,0,4,0,FR_MQ,216,26,124
2020-04-22,0,0,0,2,FR_MQ,216,26,128
2020-04-23,1,0,1,0,FR_MQ,218,28,128
2020-04-24,0,0,0,1,FR_MQ,218,28,130
2020-04-25,0,0,0,0,FR_MQ,218,28,130
2020-04-26,0,0,0,0,FR_MQ,218,28,130
2020-04-27,0,0,0,0,FR_MQ,218,28,130
2020-04-28,0,0,0,1,FR_MQ,218,28,132
2020-04-29,0,0,0,0,FR_MQ,218,28,132
2020-04-30,2,1,0,13,FR_MQ,222,28,158
2020-05-01,0,0,0,0,FR_MQ,222,28,158
2020-05-02,0,0,0,0,FR_MQ,222,28,158
2020-05-03,0,0,0,0,FR_MQ,222,28,158
2020-05-04,0,0,0,0,FR_MQ,222,28,158
2020-05-05,0,0,0,1,FR_MQ,222,28,160
2020-05-06,0,0,0,0,FR_MQ,222,28,160
2020-05-07,0,0,0,0,FR_MQ,222,28,160
2020-05-08,0,0,0,0,FR_MQ,222,28,160
2020-05-09,0,0,0,1,FR_MQ,222,28,162
2020-05-10,1,0,0,0,FR_MQ,224,28,162
2020-05-11,0,0,0,0,FR_MQ,224,28,162
2020-05-12,0,0,0,0,FR_MQ,224,28,162
2020-05-13,0,0,0,0,FR_MQ,224,28,162
2020-05-14,0,0,0,0,FR_MQ,224,28,162
2020-05-15,1,0,0,0,FR_MQ,226,28,162
2020-05-16,0,0,0,1,FR_MQ,226,28,164
2020-05-17,0,0,0,0,FR_MQ,226,28,164
2020-05-18,0,0,0,0,FR_MQ,226,28,164
2020-05-19,0,0,0,0,FR_MQ,226,28,164
2020-05-20,0,0,0,1,FR_MQ,226,28,166
2020-05-21,0,0,0,0,FR_MQ,226,28,166
2020-05-22,0,1,0,0,FR_MQ,226,28,166
2020-05-23,0,0,0,0,FR_MQ,226,28,166
2020-05-24,0,0,0,0,FR_MQ,226,28,166
2020-05-25,0,0,0,0,FR_MQ,226,28,166
2020-05-26,0,0,0,0,FR_MQ,226,28,166
2020-05-27,0,0,0,0,FR_MQ,226,28,166
2020-05-28,0,0,0,0,FR_MQ,226,28,166
2020-05-29,0,0,0,0,FR_MQ,226,28,166
2020-05-30,0,0,0,0,FR_MQ,226,28,166
2020-05-31,0,0,0,4,FR_MQ,226,28,174
2020-06-01,0,0,0,0,FR_MQ,226,28,174
2020-06-02,0,0,0,0,FR_MQ,226,28,174
2020-06-03,0,0,0,0,FR_MQ,226,28,174
2020-06-04,0,0,0,0,FR_MQ,226,28,174
2020-06-05,0,0,0,1,FR_MQ,226,28,176
2020-06-06,0,0,0,0,FR_MQ,226,28,176
2020-06-07,0,0,0,1,FR_MQ,226,28,178
2020-06-08,0,0,0,0,FR_MQ,226,28,178
2020-06-09,2,2,0,0,FR_MQ,230,28,178
2020-06-10,0,0,0,0,FR_MQ,230,28,178
2020-06-11,0,0,0,0,FR_MQ,230,28,178
2020-06-12,0,0,0,0,FR_MQ,230,28,178
2020-06-13,0,0,0,2,FR_MQ,230,28,182
2020-06-14,1,0,0,0,FR_MQ,232,28,182
2020-06-15,1,2,0,0,FR_MQ,234,28,182
2020-06-16,0,0,0,0,FR_MQ,234,28,182
2020-06-17,1,1,0,0,FR_MQ,236,28,182
2020-06-18,0,0,0,0,FR_MQ,236,28,182
2020-06-19,0,0,0,0,FR_MQ,236,28,182
2020-06-20,1,0,0,0,FR_MQ,238,28,182
2020-06-21,0,0,0,0,FR_MQ,238,28,182
2020-06-22,0,0,0,0,FR_MQ,238,28,182
2020-06-23,0,0,0,0,FR_MQ,238,28,182
2020-06-24,0,0,0,0,FR_MQ,238,28,182
2020-03-19,39,7,1,10,FR_NAQ,39,1,10
2020-03-20,19,6,1,10,FR_NAQ,58,2,20
2020-03-21,62,19,1,5,FR_NAQ,120,3,25
2020-03-22,32,5,4,3,FR_NAQ,152,7,28
2020-03-23,79,13,4,20,FR_NAQ,231,11,48
2020-03-24,98,31,4,19,FR_NAQ,329,15,67
2020-03-25,160,23,9,37,FR_NAQ,489,24,104
2020-03-26,130,28,9,48,FR_NAQ,619,33,152
2020-03-27,136,27,8,28,FR_NAQ,755,41,180
2020-03-28,91,23,10,34,FR_NAQ,846,51,214
2020-03-29,90,35,8,17,FR_NAQ,936,59,231
2020-03-30,158,25,14,51,FR_NAQ,1094,73,282
2020-03-31,118,32,14,78,FR_NAQ,1212,87,360
2020-04-01,119,23,4,68,FR_NAQ,1331,91,428
2020-04-02,116,19,12,82,FR_NAQ,1447,103,510
2020-04-03,85,12,6,39,FR_NAQ,1532,109,549
2020-04-04,65,11,11,50,FR_NAQ,1597,120,599
2020-04-05,44,7,9,27,FR_NAQ,1641,129,626
2020-04-06,80,11,18,34,FR_NAQ,1721,147,660
2020-04-07,87,14,14,59,FR_NAQ,1808,161,719
2020-04-08,115,18,15,74,FR_NAQ,1923,176,793
2020-04-09,77,12,8,53,FR_NAQ,2000,184,846
2020-04-10,66,13,5,63,FR_NAQ,2066,189,909
2020-04-11,63,5,6,53,FR_NAQ,2129,195,962
2020-04-12,44,4,10,25,FR_NAQ,2173,205,987
2020-04-13,50,10,4,13,FR_NAQ,2223,209,1000
2020-04-14,64,5,13,40,FR_NAQ,2287,222,1040
2020-04-15,48,5,9,58,FR_NAQ,2335,231,1098
2020-04-16,44,2,7,50,FR_NAQ,2379,238,1148
2020-04-17,65,6,13,32,FR_NAQ,2444,251,1180
2020-04-18,41,5,8,48,FR_NAQ,2485,259,1228
2020-04-19,35,5,6,15,FR_NAQ,2520,265,1243
2020-04-20,53,4,12,22,FR_NAQ,2573,277,1265
2020-04-21,36,0,7,35,FR_NAQ,2609,284,1300
2020-04-22,24,3,2,38,FR_NAQ,2633,286,1338
2020-04-23,38,5,10,57,FR_NAQ,2671,296,1395
2020-04-24,15,3,8,44,FR_NAQ,2686,304,1439
2020-04-25,19,0,4,34,FR_NAQ,2705,308,1473
2020-04-26,18,3,5,8,FR_NAQ,2723,313,1481
2020-04-27,37,2,7,18,FR_NAQ,2760,320,1499
2020-04-28,24,2,7,41,FR_NAQ,2784,327,1540
2020-04-29,23,3,6,44,FR_NAQ,2807,333,1584
2020-04-30,33,2,11,62,FR_NAQ,2840,344,1646
2020-05-01,7,2,0,25,FR_NAQ,2847,344,1671
2020-05-02,5,0,3,5,FR_NAQ,2852,347,1676
2020-05-03,18,4,2,12,FR_NAQ,2870,349,1688
2020-05-04,17,3,7,16,FR_NAQ,2887,356,1704
2020-05-05,20,3,0,30,FR_NAQ,2907,356,1734
2020-05-06,11,0,6,34,FR_NAQ,2918,362,1768
2020-05-07,25,3,5,28,FR_NAQ,2943,367,1796
2020-05-08,9,1,1,29,FR_NAQ,2952,368,1825
2020-05-09,14,1,4,8,FR_NAQ,2966,372,1833
2020-05-10,13,1,2,17,FR_NAQ,2979,374,1850
2020-05-11,15,4,5,10,FR_NAQ,2994,379,1860
2020-05-12,10,0,4,28,FR_NAQ,3004,383,1888
2020-05-13,26,3,2,16,FR_NAQ,3030,385,1904
2020-05-14,13,0,3,17,FR_NAQ,3043,388,1921
2020-05-15,9,0,3,17,FR_NAQ,3052,391,1938
2020-05-16,6,0,1,11,FR_NAQ,3058,392,1949
2020-05-17,1,0,2,4,FR_NAQ,3059,394,1953
2020-05-18,9,1,3,8,FR_NAQ,3068,397,1961
2020-05-19,19,5,1,27,FR_NAQ,3087,398,1988
2020-05-20,3,0,3,20,FR_NAQ,3090,401,2008
2020-05-21,2,0,0,9,FR_NAQ,3092,401,2017
2020-05-22,5,2,1,11,FR_NAQ,3097,402,2028
2020-05-23,13,2,1,10,FR_NAQ,3110,403,2038
2020-05-24,7,1,0,1,FR_NAQ,3117,403,2039
2020-05-25,12,3,3,31,FR_NAQ,3129,406,2070
2020-05-26,6,1,3,14,FR_NAQ,3135,409,2084
2020-05-27,12,1,2,9,FR_NAQ,3147,411,2093
2020-05-28,4,1,4,22,FR_NAQ,3151,415,2115
2020-05-29,4,1,1,21,FR_NAQ,3155,416,2136
2020-05-30,3,0,0,9,FR_NAQ,3158,416,2145
2020-05-31,3,1,1,1,FR_NAQ,3161,417,2146
2020-06-01,1,0,0,1,FR_NAQ,3162,417,2147
2020-06-02,4,1,3,41,FR_NAQ,3166,420,2188
2020-06-03,8,0,2,24,FR_NAQ,3174,422,2212
2020-06-04,6,1,0,27,FR_NAQ,3180,422,2239
2020-06-05,9,0,1,11,FR_NAQ,3189,423,2250
2020-06-06,2,0,2,5,FR_NAQ,3191,425,2255
2020-06-07,3,0,0,3,FR_NAQ,3194,425,2258
2020-06-08,3,0,0,15,FR_NAQ,3197,425,2273
2020-06-09,6,0,2,10,FR_NAQ,3203,427,2283
2020-06-10,3,3,1,9,FR_NAQ,3206,428,2292
2020-06-11,2,0,1,7,FR_NAQ,3208,429,2299
2020-06-12,2,0,1,2,FR_NAQ,3210,430,2301
2020-06-13,0,0,0,5,FR_NAQ,3210,430,2306
2020-06-14,1,0,0,4,FR_NAQ,3211,430,2310
2020-06-15,3,0,2,4,FR_NAQ,3214,432,2314
2020-06-16,3,0,1,11,FR_NAQ,3217,433,2325
2020-06-17,2,0,0,6,FR_NAQ,3219,433,2331
2020-06-18,0,0,1,6,FR_NAQ,3219,434,2337
2020-06-19,1,0,0,3,FR_NAQ,3220,434,2340
2020-06-20,1,0,0,2,FR_NAQ,3221,434,2342
2020-06-21,0,0,0,0,FR_NAQ,3221,434,2342
2020-06-22,1,0,0,4,FR_NAQ,3222,434,2346
2020-06-23,0,0,0,3,FR_NAQ,3222,434,2349
2020-06-24,0,0,0,12,FR_NAQ,3222,434,2361
2020-03-19,18,7,2,5,FR_NOR,18,2,5
2020-03-20,23,3,2,3,FR_NOR,41,4,8
2020-03-21,32,9,0,3,FR_NOR,73,4,11
2020-03-22,31,8,2,2,FR_NOR,104,6,13
2020-03-23,36,7,1,7,FR_NOR,140,7,20
2020-03-24,37,11,6,8,FR_NOR,177,13,28
2020-03-25,79,18,3,19,FR_NOR,256,16,47
2020-03-26,61,22,2,12,FR_NOR,317,18,59
2020-03-27,59,21,4,11,FR_NOR,376,22,70
2020-03-28,96,25,2,22,FR_NOR,472,24,92
2020-03-29,88,19,6,8,FR_NOR,560,30,100
2020-03-30,44,18,10,10,FR_NOR,604,40,110
2020-03-31,122,32,20,39,FR_NOR,726,60,149
2020-04-01,98,19,7,50,FR_NOR,824,67,199
2020-04-02,108,29,12,26,FR_NOR,932,79,225
2020-04-03,65,17,13,35,FR_NOR,997,92,260
2020-04-04,67,16,6,39,FR_NOR,1064,98,299
2020-04-05,55,11,12,12,FR_NOR,1119,110,311
2020-04-06,56,14,16,30,FR_NOR,1175,126,341
2020-04-07,84,11,20,56,FR_NOR,1259,146,397
2020-04-08,56,7,19,62,FR_NOR,1315,165,459
2020-04-09,60,9,14,27,FR_NOR,1375,179,486
2020-04-10,95,10,9,37,FR_NOR,1470,188,523
2020-04-11,38,7,9,42,FR_NOR,1508,197,565
2020-04-12,33,2,6,32,FR_NOR,1541,203,597
2020-04-13,20,7,10,12,FR_NOR,1561,213,609
2020-04-14,44,4,20,28,FR_NOR,1605,233,637
2020-04-15,43,4,12,44,FR_NOR,1648,245,681
2020-04-16,43,8,10,39,FR_NOR,1691,255,720
2020-04-17,45,8,10,41,FR_NOR,1736,265,761
2020-04-18,49,3,5,46,FR_NOR,1785,270,807
2020-04-19,33,9,7,16,FR_NOR,1818,277,823
2020-04-20,30,5,10,16,FR_NOR,1848,287,839
2020-04-21,43,3,9,46,FR_NOR,1891,296,885
2020-04-22,22,3,7,30,FR_NOR,1913,303,915
2020-04-23,34,8,8,35,FR_NOR,1947,311,950
2020-04-24,48,4,5,38,FR_NOR,1995,316,988
2020-04-25,16,1,2,8,FR_NOR,2011,318,996
2020-04-26,9,4,5,11,FR_NOR,2020,323,1007
2020-04-27,11,2,5,10,FR_NOR,2031,328,1017
2020-04-28,43,7,10,28,FR_NOR,2074,338,1045
2020-04-29,21,0,9,36,FR_NOR,2095,347,1081
2020-04-30,23,0,4,15,FR_NOR,2118,351,1096
2020-05-01,16,1,1,22,FR_NOR,2134,352,1118
2020-05-02,8,0,3,5,FR_NOR,2142,355,1123
2020-05-03,5,0,1,2,FR_NOR,2147,356,1125
2020-05-04,32,2,8,21,FR_NOR,2179,364,1146
2020-05-05,26,2,4,20,FR_NOR,2205,368,1166
2020-05-06,8,1,2,18,FR_NOR,2213,370,1184
2020-05-07,10,0,2,16,FR_NOR,2223,372,1200
2020-05-08,13,1,3,34,FR_NOR,2236,375,1234
2020-05-09,6,0,0,3,FR_NOR,2242,375,1237
2020-05-10,4,1,1,2,FR_NOR,2246,376,1239
2020-05-11,20,0,9,11,FR_NOR,2266,385,1250
2020-05-12,13,2,4,16,FR_NOR,2279,389,1266
2020-05-13,7,1,4,10,FR_NOR,2286,393,1276
2020-05-14,15,1,4,22,FR_NOR,2301,397,1298
2020-05-15,8,2,2,17,FR_NOR,2309,399,1315
2020-05-16,8,0,1,21,FR_NOR,2317,400,1336
2020-05-17,6,0,0,2,FR_NOR,2323,400,1338
2020-05-18,9,2,3,10,FR_NOR,2332,403,1348
2020-05-19,16,1,7,11,FR_NOR,2348,410,1359
2020-05-20,8,0,1,19,FR_NOR,2356,411,1378
2020-05-21,2,0,2,15,FR_NOR,2358,413,1393
2020-05-22,6,2,0,7,FR_NOR,2364,413,1400
2020-05-23,4,0,1,9,FR_NOR,2368,414,1409
2020-05-24,8,1,0,2,FR_NOR,2376,414,1411
2020-05-25,11,2,5,4,FR_NOR,2387,419,1415
2020-05-26,17,0,4,20,FR_NOR,2404,423,1435
2020-05-27,1,1,1,41,FR_NOR,2405,424,1476
2020-05-28,3,1,0,16,FR_NOR,2408,424,1492
2020-05-29,5,0,2,16,FR_NOR,2413,426,1508
2020-05-30,0,0,0,5,FR_NOR,2413,426,1513
2020-05-31,0,1,0,0,FR_NOR,2413,426,1513
2020-06-01,1,0,0,0,FR_NOR,2414,426,1513
2020-06-02,3,1,0,11,FR_NOR,2417,426,1524
2020-06-03,7,0,1,17,FR_NOR,2424,427,1541
2020-06-04,0,0,0,7,FR_NOR,2424,427,1548
2020-06-05,4,1,1,1,FR_NOR,2428,428,1549
2020-06-06,4,0,0,7,FR_NOR,2432,428,1556
2020-06-07,0,0,1,1,FR_NOR,2432,429,1557
2020-06-08,1,0,2,2,FR_NOR,2433,431,1559
2020-06-09,4,0,0,15,FR_NOR,2437,431,1574
2020-06-10,0,0,0,5,FR_NOR,2437,431,1579
2020-06-11,0,0,0,2,FR_NOR,2437,431,1581
2020-06-12,1,0,0,10,FR_NOR,2438,431,1591
2020-06-13,1,0,0,5,FR_NOR,2439,431,1596
2020-06-14,0,0,0,1,FR_NOR,2439,431,1597
2020-06-15,1,0,0,1,FR_NOR,2440,431,1598
2020-06-16,5,0,2,3,FR_NOR,2445,433,1601
2020-06-17,3,0,1,9,FR_NOR,2448,434,1610
2020-06-18,5,0,0,14,FR_NOR,2453,434,1624
2020-06-19,4,0,0,4,FR_NOR,2457,434,1628
2020-06-20,7,1,0,14,FR_NOR,2464,434,1642
2020-06-21,0,0,0,1,FR_NOR,2464,434,1643
2020-06-22,2,0,2,5,FR_NOR,2466,436,1648
2020-06-23,0,0,0,3,FR_NOR,2466,436,1651
2020-06-24,3,0,0,7,FR_NOR,2469,436,1658
2020-03-19,82,29,11,18,FR_OCC,82,11,18
2020-03-20,57,19,5,5,FR_OCC,139,16,23
2020-03-21,58,10,5,24,FR_OCC,197,21,47
2020-03-22,86,16,4,13,FR_OCC,283,25,60
2020-03-23,86,30,4,10,FR_OCC,369,29,70
2020-03-24,95,32,7,34,FR_OCC,464,36,104
2020-03-25,134,34,7,34,FR_OCC,598,43,138
2020-03-26,138,44,9,44,FR_OCC,736,52,182
2020-03-27,116,26,7,33,FR_OCC,852,59,215
2020-03-28,150,35,7,45,FR_OCC,1002,66,260
2020-03-29,127,27,8,16,FR_OCC,1129,74,276
2020-03-30,122,51,6,39,FR_OCC,1251,80,315
2020-03-31,138,27,10,93,FR_OCC,1389,90,408
2020-04-01,163,41,17,81,FR_OCC,1552,107,489
2020-04-02,138,32,11,74,FR_OCC,1690,118,563
2020-04-03,109,19,13,62,FR_OCC,1799,131,625
2020-04-04,68,17,17,56,FR_OCC,1867,148,681
2020-04-05,94,17,10,48,FR_OCC,1961,158,729
2020-04-06,96,26,14,49,FR_OCC,2057,172,778
2020-04-07,110,20,10,115,FR_OCC,2167,182,893
2020-04-08,70,21,15,84,FR_OCC,2237,197,977
2020-04-09,93,10,8,88,FR_OCC,2330,205,1065
2020-04-10,103,23,19,111,FR_OCC,2433,224,1176
2020-04-11,66,10,11,86,FR_OCC,2499,235,1262
2020-04-12,58,3,6,18,FR_OCC,2557,241,1280
2020-04-13,57,9,9,28,FR_OCC,2614,250,1308
2020-04-14,65,11,18,49,FR_OCC,2679,268,1357
2020-04-15,68,14,12,97,FR_OCC,2747,280,1454
2020-04-16,42,8,3,75,FR_OCC,2789,283,1529
2020-04-17,78,11,9,67,FR_OCC,2867,292,1596
2020-04-18,90,4,3,95,FR_OCC,2957,295,1691
2020-04-19,33,10,3,12,FR_OCC,2990,298,1703
2020-04-20,88,16,17,43,FR_OCC,3078,315,1746
2020-04-21,60,5,11,58,FR_OCC,3138,326,1804
2020-04-22,31,5,6,44,FR_OCC,3169,332,1848
2020-04-23,30,6,14,64,FR_OCC,3199,346,1912
2020-04-24,43,6,14,89,FR_OCC,3242,360,2001
2020-04-25,20,0,5,35,FR_OCC,3262,365,2036
2020-04-26,15,0,1,9,FR_OCC,3277,366,2045
2020-04-27,39,6,12,16,FR_OCC,3316,378,2061
2020-04-28,36,6,10,58,FR_OCC,3352,388,2119
2020-04-29,22,3,7,37,FR_OCC,3374,395,2156
2020-04-30,33,5,12,38,FR_OCC,3407,407,2194
2020-05-01,20,1,0,46,FR_OCC,3427,407,2240
2020-05-02,17,2,15,8,FR_OCC,3444,422,2248
2020-05-03,11,0,1,2,FR_OCC,3455,423,2250
2020-05-04,23,2,14,29,FR_OCC,3478,437,2279
2020-05-05,43,5,12,60,FR_OCC,3521,449,2339
2020-05-06,15,1,5,43,FR_OCC,3536,454,2382
2020-05-07,19,3,8,34,FR_OCC,3555,462,2416
2020-05-08,18,6,2,41,FR_OCC,3573,464,2457
2020-05-09,6,2,2,7,FR_OCC,3579,466,2464
2020-05-10,11,1,1,6,FR_OCC,3590,467,2470
2020-05-11,12,2,1,15,FR_OCC,3602,468,2485
2020-05-12,18,6,5,42,FR_OCC,3620,473,2527
2020-05-13,32,6,1,28,FR_OCC,3652,474,2555
2020-05-14,9,3,5,33,FR_OCC,3661,479,2588
2020-05-15,5,2,2,22,FR_OCC,3666,481,2610
2020-05-16,13,3,2,15,FR_OCC,3679,483,2625
2020-05-17,10,1,1,10,FR_OCC,3689,484,2635
2020-05-18,15,4,2,25,FR_OCC,3704,486,2660
2020-05-19,7,0,1,17,FR_OCC,3711,487,2677
2020-05-20,19,0,6,28,FR_OCC,3730,493,2705
2020-05-21,9,0,1,14,FR_OCC,3739,494,2719
2020-05-22,18,3,3,9,FR_OCC,3757,497,2728
2020-05-23,2,0,1,6,FR_OCC,3759,498,2734
2020-05-24,4,1,1,1,FR_OCC,3763,499,2735
2020-05-25,12,1,3,16,FR_OCC,3775,502,2751
2020-05-26,16,4,2,21,FR_OCC,3791,504,2772
2020-05-27,11,0,0,12,FR_OCC,3802,504,2784
2020-05-28,6,3,3,17,FR_OCC,3808,507,2801
2020-05-29,5,0,1,7,FR_OCC,3813,508,2808
2020-05-30,11,0,0,17,FR_OCC,3824,508,2825
2020-05-31,3,0,3,4,FR_OCC,3827,511,2829
2020-06-01,2,0,1,0,FR_OCC,3829,512,2829
2020-06-02,10,3,1,6,FR_OCC,3839,513,2835
2020-06-03,2,0,2,20,FR_OCC,3841,515,2855
2020-06-04,3,1,0,13,FR_OCC,3844,515,2868
2020-06-05,2,1,2,15,FR_OCC,3846,517,2883
2020-06-06,4,0,1,13,FR_OCC,3850,518,2896
2020-06-07,0,0,0,0,FR_OCC,3850,518,2896
2020-06-08,2,0,0,6,FR_OCC,3852,518,2902
2020-06-09,4,0,1,7,FR_OCC,3856,519,2909
2020-06-10,2,1,0,12,FR_OCC,3858,519,2921
2020-06-11,3,1,1,5,FR_OCC,3861,520,2926
2020-06-12,2,1,2,13,FR_OCC,3863,522,2939
2020-06-13,2,0,0,2,FR_OCC,3865,522,2941
2020-06-14,2,0,0,3,FR_OCC,3867,522,2944
2020-06-15,2,0,2,7,FR_OCC,3869,524,2951
2020-06-16,1,0,0,19,FR_OCC,3870,524,2970
2020-06-17,0,0,0,3,FR_OCC,3870,524,2973
2020-06-18,0,0,0,6,FR_OCC,3870,524,2979
2020-06-19,2,0,0,1,FR_OCC,3872,524,2980
2020-06-20,1,0,0,7,FR_OCC,3873,524,2987
2020-06-21,5,0,0,4,FR_OCC,3878,524,2991
2020-06-22,4,0,0,2,FR_OCC,3882,524,2993
2020-06-23,1,1,0,4,FR_OCC,3883,524,2997
2020-06-24,0,0,2,3,FR_OCC,3883,526,3000
2020-03-19,123,26,2,59,FR_PAC,123,2,59
2020-03-20,78,11,2,20,FR_PAC,201,4,79
2020-03-21,98,17,2,36,FR_PAC,299,6,115
2020-03-22,78,6,2,25,FR_PAC,377,8,140
2020-03-23,124,27,5,42,FR_PAC,501,13,182
2020-03-24,130,25,6,62,FR_PAC,631,19,244
2020-03-25,177,17,7,102,FR_PAC,808,26,346
2020-03-26,171,27,11,73,FR_PAC,979,37,419
2020-03-27,190,27,4,57,FR_PAC,1169,41,476
2020-03-28,175,29,7,53,FR_PAC,1344,48,529
2020-03-29,172,38,10,22,FR_PAC,1516,58,551
2020-03-30,221,50,15,51,FR_PAC,1737,73,602
2020-03-31,243,40,23,143,FR_PAC,1980,96,745
2020-04-01,224,45,21,133,FR_PAC,2204,117,878
2020-04-02,215,51,17,63,FR_PAC,2419,134,941
2020-04-03,238,45,20,106,FR_PAC,2657,154,1047
2020-04-04,172,32,17,99,FR_PAC,2829,171,1146
2020-04-05,129,23,17,33,FR_PAC,2958,188,1179
2020-04-06,231,33,36,81,FR_PAC,3189,224,1260
2020-04-07,143,29,22,195,FR_PAC,3332,246,1455
2020-04-08,225,41,19,119,FR_PAC,3557,265,1574
2020-04-09,145,17,17,161,FR_PAC,3702,282,1735
2020-04-10,206,41,13,111,FR_PAC,3908,295,1846
2020-04-11,93,15,18,110,FR_PAC,4001,313,1956
2020-04-12,123,14,11,46,FR_PAC,4124,324,2002
2020-04-13,86,15,20,29,FR_PAC,4210,344,2031
2020-04-14,193,19,26,116,FR_PAC,4403,370,2147
2020-04-15,148,18,19,113,FR_PAC,4551,389,2260
2020-04-16,125,22,28,114,FR_PAC,4676,417,2374
2020-04-17,164,21,28,121,FR_PAC,4840,445,2495
2020-04-18,104,13,16,111,FR_PAC,4944,461,2606
2020-04-19,50,9,9,88,FR_PAC,4994,470,2694
2020-04-20,125,32,31,77,FR_PAC,5119,501,2771
2020-04-21,145,11,27,117,FR_PAC,5264,528,2888
2020-04-22,173,19,35,117,FR_PAC,5437,563,3005
2020-04-23,108,20,14,93,FR_PAC,5545,577,3098
2020-04-24,120,26,35,104,FR_PAC,5665,612,3202
2020-04-25,77,9,15,128,FR_PAC,5742,627,3330
2020-04-26,41,11,6,10,FR_PAC,5783,633,3340
2020-04-27,108,16,25,81,FR_PAC,5891,658,3421
2020-04-28,89,19,15,117,FR_PAC,5980,673,3538
2020-04-29,114,16,12,127,FR_PAC,6094,685,3665
2020-04-30,60,8,14,108,FR_PAC,6154,699,3773
2020-05-01,50,4,8,56,FR_PAC,6204,707,3829
2020-05-02,41,0,4,42,FR_PAC,6245,711,3871
2020-05-03,32,5,6,18,FR_PAC,6277,717,3889
2020-05-04,69,7,20,71,FR_PAC,6346,737,3960
2020-05-05,54,7,15,94,FR_PAC,6400,752,4054
2020-05-06,59,5,10,71,FR_PAC,6459,762,4125
2020-05-07,50,7,8,68,FR_PAC,6509,770,4193
2020-05-08,31,5,6,42,FR_PAC,6540,776,4235
2020-05-09,17,3,3,10,FR_PAC,6557,779,4245
2020-05-10,14,7,4,8,FR_PAC,6571,783,4253
2020-05-11,42,10,20,41,FR_PAC,6613,803,4294
2020-05-12,32,6,8,51,FR_PAC,6645,811,4345
2020-05-13,31,5,11,66,FR_PAC,6676,822,4411
2020-05-14,25,5,8,53,FR_PAC,6701,830,4464
2020-05-15,33,6,7,71,FR_PAC,6734,837,4535
2020-05-16,23,3,5,32,FR_PAC,6757,842,4567
2020-05-17,11,1,4,5,FR_PAC,6768,846,4572
2020-05-18,23,2,9,26,FR_PAC,6791,855,4598
2020-05-19,24,2,6,34,FR_PAC,6815,861,4632
2020-05-20,24,1,7,62,FR_PAC,6839,868,4694
2020-05-21,23,0,7,26,FR_PAC,6862,875,4720
2020-05-22,4,2,5,19,FR_PAC,6866,880,4739
2020-05-23,14,1,2,11,FR_PAC,6880,882,4750
2020-05-24,9,0,2,3,FR_PAC,6889,884,4753
2020-05-25,17,3,6,39,FR_PAC,6906,890,4792
2020-05-26,14,2,5,39,FR_PAC,6920,895,4831
2020-05-27,12,4,1,27,FR_PAC,6932,896,4858
2020-05-28,12,3,3,30,FR_PAC,6944,899,4888
2020-05-29,13,1,5,40,FR_PAC,6957,904,4928
2020-05-30,9,0,0,7,FR_PAC,6966,904,4935
2020-05-31,8,0,0,2,FR_PAC,6974,904,4937
2020-06-01,2,0,0,7,FR_PAC,6976,904,4944
2020-06-02,17,1,10,22,FR_PAC,6993,914,4966
2020-06-03,19,1,3,34,FR_PAC,7012,917,5000
2020-06-04,11,1,1,48,FR_PAC,7023,918,5048
2020-06-05,27,2,1,32,FR_PAC,7050,919,5080
2020-06-06,6,0,0,12,FR_PAC,7056,919,5092
2020-06-07,1,0,0,3,FR_PAC,7057,919,5095
2020-06-08,9,3,4,15,FR_PAC,7066,923,5110
2020-06-09,11,0,2,15,FR_PAC,7077,925,5125
2020-06-10,9,0,1,25,FR_PAC,7086,926,5150
2020-06-11,5,0,2,21,FR_PAC,7091,928,5171
2020-06-12,6,0,2,21,FR_PAC,7097,930,5192
2020-06-13,9,0,0,6,FR_PAC,7106,930,5198
2020-06-14,1,0,0,2,FR_PAC,7107,930,5200
2020-06-15,7,0,2,5,FR_PAC,7114,932,5205
2020-06-16,9,1,2,21,FR_PAC,7123,934,5226
2020-06-17,3,1,0,15,FR_PAC,7126,934,5241
2020-06-18,7,2,2,12,FR_PAC,7133,936,5253
2020-06-19,5,1,4,12,FR_PAC,7138,940,5265
2020-06-20,2,1,2,20,FR_PAC,7140,942,5285
2020-06-21,3,0,0,4,FR_PAC,7143,942,5289
2020-06-22,2,1,1,9,FR_PAC,7145,943,5298
2020-06-23,5,0,4,14,FR_PAC,7150,947,5312
2020-06-24,6,1,1,38,FR_PAC,7156,948,5350
2020-03-19,40,11,0,18,FR_PDL,40,0,18
2020-03-20,16,3,0,8,FR_PDL,56,0,26
2020-03-21,28,8,2,6,FR_PDL,84,2,32
2020-03-22,32,9,1,10,FR_PDL,116,3,42
2020-03-23,47,11,5,1,FR_PDL,163,8,43
2020-03-24,67,12,4,20,FR_PDL,230,12,63
2020-03-25,67,9,3,13,FR_PDL,297,15,76
2020-03-26,81,17,8,21,FR_PDL,378,23,97
2020-03-27,104,20,8,15,FR_PDL,482,31,112
2020-03-28,102,21,11,22,FR_PDL,584,42,134
2020-03-29,84,9,5,19,FR_PDL,668,47,153
2020-03-30,68,20,12,20,FR_PDL,736,59,173
2020-03-31,100,25,13,63,FR_PDL,836,72,236
2020-04-01,102,20,11,44,FR_PDL,938,83,280
2020-04-02,76,15,10,43,FR_PDL,1014,93,323
2020-04-03,79,12,17,51,FR_PDL,1093,110,374
2020-04-04,76,8,9,34,FR_PDL,1169,119,408
2020-04-05,45,8,5,25,FR_PDL,1214,124,433
2020-04-06,40,8,11,18,FR_PDL,1254,135,451
2020-04-07,82,8,10,62,FR_PDL,1336,145,513
2020-04-08,73,12,9,56,FR_PDL,1409,154,569
2020-04-09,96,10,5,48,FR_PDL,1505,159,617
2020-04-10,71,10,12,48,FR_PDL,1576,171,665
2020-04-11,66,5,9,54,FR_PDL,1642,180,719
2020-04-12,52,7,4,16,FR_PDL,1694,184,735
2020-04-13,39,2,10,17,FR_PDL,1733,194,752
2020-04-14,53,4,17,30,FR_PDL,1786,211,782
2020-04-15,65,6,13,71,FR_PDL,1851,224,853
2020-04-16,86,1,15,59,FR_PDL,1937,239,912
2020-04-17,49,1,7,40,FR_PDL,1986,246,952
2020-04-18,29,4,9,32,FR_PDL,2015,255,984
2020-04-19,17,1,7,9,FR_PDL,2032,262,993
2020-04-20,24,4,10,13,FR_PDL,2056,272,1006
2020-04-21,34,1,8,40,FR_PDL,2090,280,1046
2020-04-22,41,2,9,45,FR_PDL,2131,289,1091
2020-04-23,45,2,6,35,FR_PDL,2176,295,1126
2020-04-24,21,0,12,30,FR_PDL,2197,307,1156
2020-04-25,22,2,4,25,FR_PDL,2219,311,1181
2020-04-26,9,1,7,8,FR_PDL,2228,318,1189
2020-04-27,38,2,9,32,FR_PDL,2266,327,1221
2020-04-28,23,0,8,40,FR_PDL,2289,335,1261
2020-04-29,24,2,5,39,FR_PDL,2313,340,1300
2020-04-30,21,0,5,34,FR_PDL,2334,345,1334
2020-05-01,23,0,2,27,FR_PDL,2357,347,1361
2020-05-02,11,3,5,3,FR_PDL,2368,352,1364
2020-05-03,14,5,3,5,FR_PDL,2382,355,1369
2020-05-04,12,0,6,10,FR_PDL,2394,361,1379
2020-05-05,33,6,5,39,FR_PDL,2427,366,1418
2020-05-06,22,0,6,26,FR_PDL,2449,372,1444
2020-05-07,6,1,4,17,FR_PDL,2455,376,1461
2020-05-08,13,2,5,20,FR_PDL,2468,381,1481
2020-05-09,5,0,5,12,FR_PDL,2473,386,1493
2020-05-10,8,0,1,5,FR_PDL,2481,387,1498
2020-05-11,8,1,2,10,FR_PDL,2489,389,1508
2020-05-12,25,0,3,38,FR_PDL,2514,392,1546
2020-05-13,13,2,0,20,FR_PDL,2527,392,1566
2020-05-14,22,0,7,30,FR_PDL,2549,399,1596
2020-05-15,24,3,6,32,FR_PDL,2573,405,1628
2020-05-16,8,1,6,11,FR_PDL,2581,411,1639
2020-05-17,5,0,0,2,FR_PDL,2586,411,1641
2020-05-18,12,1,7,14,FR_PDL,2598,418,1655
2020-05-19,15,4,2,25,FR_PDL,2613,420,1680
2020-05-20,10,1,2,23,FR_PDL,2623,422,1703
2020-05-21,8,0,3,15,FR_PDL,2631,425,1718
2020-05-22,14,1,2,10,FR_PDL,2645,427,1728
2020-05-23,7,0,3,12,FR_PDL,2652,430,1740
2020-05-24,9,1,2,2,FR_PDL,2661,432,1742
2020-05-25,11,2,3,9,FR_PDL,2672,435,1751
2020-05-26,9,1,1,18,FR_PDL,2681,436,1769
2020-05-27,8,1,4,18,FR_PDL,2689,440,1787
2020-05-28,15,1,0,26,FR_PDL,2704,440,1813
2020-05-29,10,0,3,13,FR_PDL,2714,443,1826
2020-05-30,8,0,0,20,FR_PDL,2722,443,1846
2020-05-31,8,0,2,9,FR_PDL,2730,445,1855
2020-06-01,3,1,0,3,FR_PDL,2733,445,1858
2020-06-02,12,2,2,18,FR_PDL,2745,447,1876
2020-06-03,2,0,2,22,FR_PDL,2747,449,1898
2020-06-04,9,1,2,27,FR_PDL,2756,451,1925
2020-06-05,10,1,5,16,FR_PDL,2766,456,1941
2020-06-06,7,1,1,16,FR_PDL,2773,457,1957
2020-06-07,3,1,2,2,FR_PDL,2776,459,1959
2020-06-08,7,1,2,6,FR_PDL,2783,461,1965
2020-06-09,7,0,1,21,FR_PDL,2790,462,1986
2020-06-10,8,0,1,13,FR_PDL,2798,463,1999
2020-06-11,19,1,3,24,FR_PDL,2817,466,2023
2020-06-12,5,1,1,17,FR_PDL,2822,467,2040
2020-06-13,5,2,0,4,FR_PDL,2827,467,2044
2020-06-14,2,0,1,1,FR_PDL,2829,468,2045
2020-06-15,2,0,0,4,FR_PDL,2831,468,2049
2020-06-16,4,0,0,6,FR_PDL,2835,468,2055
2020-06-17,9,2,1,33,FR_PDL,2844,469,2088
2020-06-18,2,0,2,8,FR_PDL,2846,471,2096
2020-06-19,2,0,0,16,FR_PDL,2848,471,2112
2020-06-20,1,0,0,5,FR_PDL,2849,471,2117
2020-06-21,0,0,1,0,FR_PDL,2849,472,2117
2020-06-22,8,2,0,14,FR_PDL,2857,472,2131
2020-06-23,4,1,0,5,FR_PDL,2861,472,2136
2020-06-24,1,0,2,13,FR_PDL,2862,474,2149
2020-03-19,1,0,0,0,FR_ARA_01,1,0,0
2020-03-20,0,0,0,1,FR_ARA_01,1,0,1
2020-03-21,4,0,0,0,FR_ARA_01,5,0,1
2020-03-22,3,1,0,1,FR_ARA_01,8,0,2
2020-03-23,14,1,0,5,FR_ARA_01,22,0,7
2020-03-24,11,1,0,4,FR_ARA_01,33,0,11
2020-03-25,13,2,0,5,FR_ARA_01,46,0,16
2020-03-26,14,3,2,2,FR_ARA_01,60,2,18
2020-03-27,14,2,0,0,FR_ARA_01,74,2,18
2020-03-28,7,3,1,3,FR_ARA_01,81,3,21
2020-03-29,10,2,3,3,FR_ARA_01,91,6,24
2020-03-30,20,7,4,1,FR_ARA_01,111,10,25
2020-03-31,20,0,1,10,FR_ARA_01,131,11,35
2020-04-01,38,14,2,10,FR_ARA_01,169,13,45
2020-04-02,32,6,2,19,FR_ARA_01,201,15,64
2020-04-03,15,4,3,13,FR_ARA_01,216,18,77
2020-04-04,24,8,5,9,FR_ARA_01,240,23,86
2020-04-05,13,5,2,3,FR_ARA_01,253,25,89
2020-04-06,11,3,1,6,FR_ARA_01,264,26,95
2020-04-07,15,3,2,5,FR_ARA_01,279,28,100
2020-04-08,19,8,4,9,FR_ARA_01,298,32,109
2020-04-09,12,3,4,8,FR_ARA_01,310,36,117
2020-04-10,17,2,5,8,FR_ARA_01,327,41,125
2020-04-11,7,3,2,15,FR_ARA_01,334,43,140
2020-04-12,4,2,0,4,FR_ARA_01,338,43,144
2020-04-13,12,1,2,3,FR_ARA_01,350,45,147
2020-04-14,14,1,2,5,FR_ARA_01,364,47,152
2020-04-15,35,0,6,28,FR_ARA_01,399,53,180
2020-04-16,16,1,0,3,FR_ARA_01,415,53,183
2020-04-17,9,2,3,9,FR_ARA_01,424,56,192
2020-04-18,31,3,5,4,FR_ARA_01,455,61,196
2020-04-19,3,1,0,1,FR_ARA_01,458,61,197
2020-04-20,4,2,2,3,FR_ARA_01,462,63,200
2020-04-21,12,3,2,11,FR_ARA_01,474,65,211
2020-04-22,13,1,4,15,FR_ARA_01,487,69,226
2020-04-23,10,0,4,9,FR_ARA_01,497,73,235
2020-04-24,6,0,1,5,FR_ARA_01,503,74,240
2020-04-25,4,0,2,5,FR_ARA_01,507,76,245
2020-04-26,4,0,0,1,FR_ARA_01,511,76,246
2020-04-27,4,0,0,7,FR_ARA_01,515,76,253
2020-04-28,4,0,3,4,FR_ARA_01,519,79,257
2020-04-29,14,0,1,11,FR_ARA_01,533,80,268
2020-04-30,8,2,1,8,FR_ARA_01,541,81,276
2020-05-01,4,0,1,5,FR_ARA_01,545,82,281
2020-05-02,1,1,0,0,FR_ARA_01,546,82,281
2020-05-03,1,0,0,0,FR_ARA_01,547,82,281
2020-05-04,2,0,0,2,FR_ARA_01,549,82,283
2020-05-05,7,2,4,12,FR_ARA_01,556,86,295
2020-05-06,8,0,0,14,FR_ARA_01,564,86,309
2020-05-07,1,0,0,7,FR_ARA_01,565,86,316
2020-05-08,1,0,0,2,FR_ARA_01,566,86,318
2020-05-09,1,0,1,3,FR_ARA_01,567,87,321
2020-05-10,3,0,0,1,FR_ARA_01,570,87,322
2020-05-11,6,2,2,6,FR_ARA_01,576,89,328
2020-05-12,4,1,0,2,FR_ARA_01,580,89,330
2020-05-13,6,0,0,4,FR_ARA_01,586,89,334
2020-05-14,4,0,0,4,FR_ARA_01,590,89,338
2020-05-15,4,0,1,5,FR_ARA_01,594,90,343
2020-05-16,1,0,1,2,FR_ARA_01,595,91,345
2020-05-17,1,0,0,1,FR_ARA_01,596,91,346
2020-05-18,1,0,0,5,FR_ARA_01,597,91,351
2020-05-19,5,0,2,13,FR_ARA_01,602,93,364
2020-05-20,2,0,0,6,FR_ARA_01,604,93,370
2020-05-21,0,0,1,4,FR_ARA_01,604,94,374
2020-05-22,0,0,1,1,FR_ARA_01,604,95,375
2020-05-23,4,0,1,5,FR_ARA_01,608,96,380
2020-05-24,0,0,0,0,FR_ARA_01,608,96,380
2020-05-25,1,0,0,1,FR_ARA_01,609,96,381
2020-05-26,2,0,0,10,FR_ARA_01,611,96,391
2020-05-27,0,0,0,1,FR_ARA_01,611,96,392
2020-05-28,0,0,0,6,FR_ARA_01,611,96,398
2020-05-29,0,0,0,0,FR_ARA_01,611,96,398
2020-05-30,1,0,0,9,FR_ARA_01,612,96,407
2020-05-31,0,0,0,0,FR_ARA_01,612,96,407
2020-06-01,0,0,0,0,FR_ARA_01,612,96,407
2020-06-02,1,0,0,2,FR_ARA_01,613,96,409
2020-06-03,2,0,1,7,FR_ARA_01,615,97,416
2020-06-04,4,0,1,1,FR_ARA_01,619,98,417
2020-06-05,0,0,0,1,FR_ARA_01,619,98,418
2020-06-06,0,0,1,6,FR_ARA_01,619,99,424
2020-06-07,0,0,0,0,FR_ARA_01,619,99,424
2020-06-08,3,1,2,1,FR_ARA_01,622,101,425
2020-06-09,0,0,0,2,FR_ARA_01,622,101,427
2020-06-10,1,0,0,1,FR_ARA_01,623,101,428
2020-06-11,0,0,0,5,FR_ARA_01,623,101,433
2020-06-12,0,0,1,2,FR_ARA_01,623,102,435
2020-06-13,0,0,0,0,FR_ARA_01,623,102,435
2020-06-14,0,0,0,0,FR_ARA_01,623,102,435
2020-06-15,0,0,0,1,FR_ARA_01,623,102,436
2020-06-16,2,0,0,0,FR_ARA_01,625,102,436
2020-06-17,1,0,1,2,FR_ARA_01,626,103,438
2020-06-18,0,0,0,0,FR_ARA_01,626,103,438
2020-06-19,0,0,0,0,FR_ARA_01,626,103,438
2020-06-20,0,0,0,2,FR_ARA_01,626,103,440
2020-06-21,0,0,0,0,FR_ARA_01,626,103,440
2020-06-22,0,0,0,0,FR_ARA_01,626,103,440
2020-06-23,0,0,1,0,FR_ARA_01,626,104,440
2020-06-24,1,0,0,3,FR_ARA_01,627,104,443
2020-03-19,38,8,10,15,FR_HDF_02,38,10,15
2020-03-20,10,3,3,9,FR_HDF_02,48,13,24
2020-03-21,30,4,1,9,FR_HDF_02,78,14,33
2020-03-22,13,1,3,8,FR_HDF_02,91,17,41
2020-03-23,27,1,2,5,FR_HDF_02,118,19,46
2020-03-24,46,4,3,23,FR_HDF_02,164,22,69
2020-03-25,15,5,1,8,FR_HDF_02,179,23,77
2020-03-26,22,3,2,10,FR_HDF_02,201,25,87
2020-03-27,16,3,1,5,FR_HDF_02,217,26,92
2020-03-28,26,2,4,13,FR_HDF_02,243,30,105
2020-03-29,4,1,1,1,FR_HDF_02,247,31,106
2020-03-30,9,4,2,3,FR_HDF_02,256,33,109
2020-03-31,58,6,7,41,FR_HDF_02,314,40,150
2020-04-01,41,4,8,13,FR_HDF_02,355,48,163
2020-04-02,58,1,8,27,FR_HDF_02,413,56,190
2020-04-03,58,4,18,16,FR_HDF_02,471,74,206
2020-04-04,42,4,10,19,FR_HDF_02,513,84,225
2020-04-05,7,0,6,2,FR_HDF_02,520,90,227
2020-04-06,14,1,6,7,FR_HDF_02,534,96,234
2020-04-07,66,2,9,31,FR_HDF_02,600,105,265
2020-04-08,23,5,4,13,FR_HDF_02,623,109,278
2020-04-09,39,4,9,20,FR_HDF_02,662,118,298
2020-04-10,32,7,8,14,FR_HDF_02,694,126,312
2020-04-11,25,0,4,22,FR_HDF_02,719,130,334
2020-04-12,9,1,2,2,FR_HDF_02,728,132,336
2020-04-13,9,0,5,1,FR_HDF_02,737,137,337
2020-04-14,9,1,5,16,FR_HDF_02,746,142,353
2020-04-15,28,4,3,25,FR_HDF_02,774,145,378
2020-04-16,13,1,4,14,FR_HDF_02,787,149,392
2020-04-17,18,1,6,12,FR_HDF_02,805,155,404
2020-04-18,13,0,3,10,FR_HDF_02,818,158,414
2020-04-19,8,1,1,1,FR_HDF_02,826,159,415
2020-04-20,106,7,6,70,FR_HDF_02,932,165,485
2020-04-21,94,1,13,90,FR_HDF_02,1026,178,575
2020-04-22,29,1,5,39,FR_HDF_02,1055,183,614
2020-04-23,24,1,1,20,FR_HDF_02,1079,184,634
2020-04-24,25,1,3,14,FR_HDF_02,1104,187,648
2020-04-25,10,0,4,12,FR_HDF_02,1114,191,660
2020-04-26,12,0,3,0,FR_HDF_02,1126,194,660
2020-04-27,4,0,2,8,FR_HDF_02,1130,196,668
2020-04-28,29,3,5,20,FR_HDF_02,1159,201,688
2020-04-29,15,4,5,18,FR_HDF_02,1174,206,706
2020-04-30,16,1,1,17,FR_HDF_02,1190,207,723
2020-05-01,6,0,2,11,FR_HDF_02,1196,209,734
2020-05-02,7,0,0,3,FR_HDF_02,1203,209,737
2020-05-03,1,0,4,0,FR_HDF_02,1204,213,737
2020-05-04,11,0,5,8,FR_HDF_02,1215,218,745
2020-05-05,20,0,3,25,FR_HDF_02,1235,221,770
2020-05-06,20,1,1,18,FR_HDF_02,1255,222,788
2020-05-07,29,4,2,45,FR_HDF_02,1284,224,833
2020-05-08,21,2,2,28,FR_HDF_02,1305,226,861
2020-05-09,0,0,1,0,FR_HDF_02,1305,227,861
2020-05-10,2,0,2,1,FR_HDF_02,1307,229,862
2020-05-11,14,2,4,9,FR_HDF_02,1321,233,871
2020-05-12,7,0,4,21,FR_HDF_02,1328,237,892
2020-05-13,13,0,3,25,FR_HDF_02,1341,240,917
2020-05-14,12,1,0,33,FR_HDF_02,1353,240,950
2020-05-15,5,0,2,7,FR_HDF_02,1358,242,957
2020-05-16,12,0,2,5,FR_HDF_02,1370,244,962
2020-05-17,3,0,3,0,FR_HDF_02,1373,247,962
2020-05-18,10,0,1,5,FR_HDF_02,1383,248,967
2020-05-19,3,1,0,7,FR_HDF_02,1386,248,974
2020-05-20,6,0,2,6,FR_HDF_02,1392,250,980
2020-05-21,1,0,0,5,FR_HDF_02,1393,250,985
2020-05-22,2,0,0,4,FR_HDF_02,1395,250,989
2020-05-23,1,0,3,2,FR_HDF_02,1396,253,991
2020-05-24,1,0,0,0,FR_HDF_02,1397,253,991
2020-05-25,5,0,2,16,FR_HDF_02,1402,255,1007
2020-05-26,19,2,1,7,FR_HDF_02,1421,256,1014
2020-05-27,2,0,1,10,FR_HDF_02,1423,257,1024
2020-05-28,7,2,2,5,FR_HDF_02,1430,259,1029
2020-05-29,6,1,2,7,FR_HDF_02,1436,261,1036
2020-05-30,3,0,0,2,FR_HDF_02,1439,261,1038
2020-05-31,0,0,1,0,FR_HDF_02,1439,262,1038
2020-06-01,0,0,1,1,FR_HDF_02,1439,263,1039
2020-06-02,2,1,1,1,FR_HDF_02,1441,264,1040
2020-06-03,5,0,0,9,FR_HDF_02,1446,264,1049
2020-06-04,3,2,1,3,FR_HDF_02,1449,265,1052
2020-06-05,3,1,0,6,FR_HDF_02,1452,265,1058
2020-06-06,1,0,0,0,FR_HDF_02,1453,265,1058
2020-06-07,1,0,0,1,FR_HDF_02,1454,265,1059
2020-06-08,4,0,3,6,FR_HDF_02,1458,268,1065
2020-06-09,3,0,0,7,FR_HDF_02,1461,268,1072
2020-06-10,1,0,0,6,FR_HDF_02,1462,268,1078
2020-06-11,0,0,0,2,FR_HDF_02,1462,268,1080
2020-06-12,4,1,0,7,FR_HDF_02,1466,268,1087
2020-06-13,0,0,0,1,FR_HDF_02,1466,268,1088
2020-06-14,0,0,0,0,FR_HDF_02,1466,268,1088
2020-06-15,1,0,0,4,FR_HDF_02,1467,268,1092
2020-06-16,6,0,2,3,FR_HDF_02,1473,270,1095
2020-06-17,0,0,0,1,FR_HDF_02,1473,270,1096
2020-06-18,4,0,0,11,FR_HDF_02,1477,270,1107
2020-06-19,0,0,0,1,FR_HDF_02,1477,270,1108
2020-06-20,2,0,0,3,FR_HDF_02,1479,270,1111
2020-06-21,5,0,0,0,FR_HDF_02,1484,270,1111
2020-06-22,0,0,0,2,FR_HDF_02,1484,270,1113
2020-06-23,3,0,0,4,FR_HDF_02,1487,270,1117
2020-06-24,0,0,1,2,FR_HDF_02,1487,271,1119
2020-03-19,2,0,0,6,FR_ARA_03,2,0,6
2020-03-20,4,0,0,3,FR_ARA_03,6,0,9
2020-03-21,4,0,0,1,FR_ARA_03,10,0,10
2020-03-22,1,0,0,2,FR_ARA_03,11,0,12
2020-03-23,11,0,1,4,FR_ARA_03,22,1,16
2020-03-24,1,0,0,0,FR_ARA_03,23,1,16
2020-03-25,6,0,0,4,FR_ARA_03,29,1,20
2020-03-26,10,1,1,6,FR_ARA_03,39,2,26
2020-03-27,6,1,2,1,FR_ARA_03,45,4,27
2020-03-28,8,0,0,4,FR_ARA_03,53,4,31
2020-03-29,3,3,0,1,FR_ARA_03,56,4,32
2020-03-30,14,4,0,6,FR_ARA_03,70,4,38
2020-03-31,5,1,1,3,FR_ARA_03,75,5,41
2020-04-01,9,1,0,7,FR_ARA_03,84,5,48
2020-04-02,5,3,1,6,FR_ARA_03,89,6,54
2020-04-03,5,0,1,1,FR_ARA_03,94,7,55
2020-04-04,6,0,0,2,FR_ARA_03,100,7,57
2020-04-05,6,4,1,4,FR_ARA_03,106,8,61
2020-04-06,6,1,0,2,FR_ARA_03,112,8,63
2020-04-07,5,0,0,4,FR_ARA_03,117,8,67
2020-04-08,9,2,2,2,FR_ARA_03,126,10,69
2020-04-09,3,1,0,0,FR_ARA_03,129,10,69
2020-04-10,5,2,0,6,FR_ARA_03,134,10,75
2020-04-11,8,1,2,2,FR_ARA_03,142,12,77
2020-04-12,4,0,1,6,FR_ARA_03,146,13,83
2020-04-13,3,0,0,3,FR_ARA_03,149,13,86
2020-04-14,6,2,3,0,FR_ARA_03,155,16,86
2020-04-15,2,0,1,4,FR_ARA_03,157,17,90
2020-04-16,4,0,2,1,FR_ARA_03,161,19,91
2020-04-17,2,0,0,1,FR_ARA_03,163,19,92
2020-04-18,2,0,3,3,FR_ARA_03,165,22,95
2020-04-19,0,1,0,0,FR_ARA_03,165,22,95
2020-04-20,5,0,0,0,FR_ARA_03,170,22,95
2020-04-21,5,0,1,9,FR_ARA_03,175,23,104
2020-04-22,5,1,1,3,FR_ARA_03,180,24,107
2020-04-23,3,0,0,4,FR_ARA_03,183,24,111
2020-04-24,2,0,1,3,FR_ARA_03,185,25,114
2020-04-25,5,0,0,3,FR_ARA_03,190,25,117
2020-04-26,3,0,0,1,FR_ARA_03,193,25,118
2020-04-27,0,0,0,1,FR_ARA_03,193,25,119
2020-04-28,1,0,1,4,FR_ARA_03,194,26,123
2020-04-29,0,2,1,4,FR_ARA_03,194,27,127
2020-04-30,2,0,0,3,FR_ARA_03,196,27,130
2020-05-01,2,0,1,1,FR_ARA_03,198,28,131
2020-05-02,2,0,0,1,FR_ARA_03,200,28,132
2020-05-03,0,0,0,0,FR_ARA_03,200,28,132
2020-05-04,1,0,0,0,FR_ARA_03,201,28,132
2020-05-05,2,0,2,6,FR_ARA_03,203,30,138
2020-05-06,2,1,0,2,FR_ARA_03,205,30,140
2020-05-07,2,0,0,2,FR_ARA_03,207,30,142
2020-05-08,3,0,1,2,FR_ARA_03,210,31,144
2020-05-09,0,1,0,0,FR_ARA_03,210,31,144
2020-05-10,1,0,0,0,FR_ARA_03,211,31,144
2020-05-11,0,1,0,0,FR_ARA_03,211,31,144
2020-05-12,2,0,1,10,FR_ARA_03,213,32,154
2020-05-13,0,0,1,2,FR_ARA_03,213,33,156
2020-05-14,1,0,0,1,FR_ARA_03,214,33,157
2020-05-15,0,0,0,1,FR_ARA_03,214,33,158
2020-05-16,0,0,0,2,FR_ARA_03,214,33,160
2020-05-17,0,0,0,0,FR_ARA_03,214,33,160
2020-05-18,0,0,0,0,FR_ARA_03,214,33,160
2020-05-19,5,0,2,4,FR_ARA_03,219,35,164
2020-05-20,4,0,3,1,FR_ARA_03,223,38,165
2020-05-21,0,0,0,0,FR_ARA_03,223,38,165
2020-05-22,0,0,0,1,FR_ARA_03,223,38,166
2020-05-23,5,0,0,3,FR_ARA_03,228,38,169
2020-05-24,3,0,0,2,FR_ARA_03,231,38,171
2020-05-25,3,0,0,1,FR_ARA_03,234,38,172
2020-05-26,1,0,0,1,FR_ARA_03,235,38,173
2020-05-27,3,0,0,7,FR_ARA_03,238,38,180
2020-05-28,0,0,1,0,FR_ARA_03,238,39,180
2020-05-29,0,0,0,2,FR_ARA_03,238,39,182
2020-05-30,0,0,0,2,FR_ARA_03,238,39,184
2020-05-31,2,0,0,3,FR_ARA_03,240,39,187
2020-06-01,1,0,0,0,FR_ARA_03,241,39,187
2020-06-02,4,0,1,1,FR_ARA_03,245,40,188
2020-06-03,0,0,0,0,FR_ARA_03,245,40,188
2020-06-04,0,0,0,0,FR_ARA_03,245,40,188
2020-06-05,4,0,0,2,FR_ARA_03,249,40,190
2020-06-06,0,0,0,0,FR_ARA_03,249,40,190
2020-06-07,0,0,0,0,FR_ARA_03,249,40,190
2020-06-08,4,1,0,1,FR_ARA_03,253,40,191
2020-06-09,0,0,0,2,FR_ARA_03,253,40,193
2020-06-10,1,0,0,3,FR_ARA_03,254,40,196
2020-06-11,3,0,0,3,FR_ARA_03,257,40,199
2020-06-12,2,0,0,1,FR_ARA_03,259,40,200
2020-06-13,0,0,0,0,FR_ARA_03,259,40,200
2020-06-14,0,0,0,0,FR_ARA_03,259,40,200
2020-06-15,0,0,0,0,FR_ARA_03,259,40,200
2020-06-16,1,0,0,0,FR_ARA_03,260,40,200
2020-06-17,1,1,0,0,FR_ARA_03,261,40,200
2020-06-18,0,0,0,0,FR_ARA_03,261,40,200
2020-06-19,0,0,0,4,FR_ARA_03,261,40,204
2020-06-20,0,0,0,0,FR_ARA_03,261,40,204
2020-06-21,0,0,0,0,FR_ARA_03,261,40,204
2020-06-22,1,0,1,0,FR_ARA_03,262,41,204
2020-06-23,0,0,0,0,FR_ARA_03,262,41,204
2020-06-24,0,0,0,0,FR_ARA_03,262,41,204
2020-03-19,1,0,0,1,FR_PAC_04,1,0,1
2020-03-20,0,0,0,0,FR_PAC_04,1,0,1
2020-03-21,1,0,0,0,FR_PAC_04,2,0,1
2020-03-22,0,0,0,0,FR_PAC_04,2,0,1
2020-03-23,0,0,0,0,FR_PAC_04,2,0,1
2020-03-24,0,0,0,0,FR_PAC_04,2,0,1
2020-03-25,17,0,0,13,FR_PAC_04,19,0,14
2020-03-26,1,0,0,0,FR_PAC_04,20,0,14
2020-03-27,4,0,0,2,FR_PAC_04,24,0,16
2020-03-28,4,0,0,3,FR_PAC_04,28,0,19
2020-03-29,0,0,0,0,FR_PAC_04,28,0,19
2020-03-30,15,3,1,8,FR_PAC_04,43,1,27
2020-03-31,5,0,1,3,FR_PAC_04,48,2,30
2020-04-01,4,1,0,2,FR_PAC_04,52,2,32
2020-04-02,15,0,1,13,FR_PAC_04,67,3,45
2020-04-03,5,1,0,1,FR_PAC_04,72,3,46
2020-04-04,0,0,0,0,FR_PAC_04,72,3,46
2020-04-05,2,2,0,0,FR_PAC_04,74,3,46
2020-04-06,11,0,1,5,FR_PAC_04,85,4,51
2020-04-07,1,0,0,7,FR_PAC_04,86,4,58
2020-04-08,3,0,0,2,FR_PAC_04,89,4,60
2020-04-09,1,0,0,0,FR_PAC_04,90,4,60
2020-04-10,6,1,0,3,FR_PAC_04,96,4,63
2020-04-11,3,1,0,4,FR_PAC_04,99,4,67
2020-04-12,0,0,1,0,FR_PAC_04,99,5,67
2020-04-13,0,0,0,0,FR_PAC_04,99,5,67
2020-04-14,8,0,0,8,FR_PAC_04,107,5,75
2020-04-15,4,0,0,1,FR_PAC_04,111,5,76
2020-04-16,0,0,1,2,FR_PAC_04,111,6,78
2020-04-17,1,0,0,1,FR_PAC_04,112,6,79
2020-04-18,1,0,0,1,FR_PAC_04,113,6,80
2020-04-19,6,0,0,2,FR_PAC_04,119,6,82
2020-04-20,10,0,0,2,FR_PAC_04,129,6,84
2020-04-21,1,0,1,4,FR_PAC_04,130,7,88
2020-04-22,4,0,0,8,FR_PAC_04,134,7,96
2020-04-23,4,1,0,4,FR_PAC_04,138,7,100
2020-04-24,3,0,0,2,FR_PAC_04,141,7,102
2020-04-25,1,0,0,2,FR_PAC_04,142,7,104
2020-04-26,0,0,0,0,FR_PAC_04,142,7,104
2020-04-27,1,0,0,3,FR_PAC_04,143,7,107
2020-04-28,2,0,0,2,FR_PAC_04,145,7,109
2020-04-29,1,1,0,1,FR_PAC_04,146,7,110
2020-04-30,2,0,0,1,FR_PAC_04,148,7,111
2020-05-01,0,0,1,0,FR_PAC_04,148,8,111
2020-05-02,0,0,0,0,FR_PAC_04,148,8,111
2020-05-03,0,0,0,0,FR_PAC_04,148,8,111
2020-05-04,0,0,0,1,FR_PAC_04,148,8,112
2020-05-05,1,0,0,1,FR_PAC_04,149,8,113
2020-05-06,1,0,0,2,FR_PAC_04,150,8,115
2020-05-07,0,0,1,1,FR_PAC_04,150,9,116
2020-05-08,0,0,0,2,FR_PAC_04,150,9,118
2020-05-09,0,0,0,0,FR_PAC_04,150,9,118
2020-05-10,0,0,0,0,FR_PAC_04,150,9,118
2020-05-11,1,0,0,1,FR_PAC_04,151,9,119
2020-05-12,0,1,0,0,FR_PAC_04,151,9,119
2020-05-13,0,0,0,0,FR_PAC_04,151,9,119
2020-05-14,0,0,0,1,FR_PAC_04,151,9,120
2020-05-15,0,0,0,0,FR_PAC_04,151,9,120
2020-05-16,3,0,0,0,FR_PAC_04,154,9,120
2020-05-17,0,0,1,0,FR_PAC_04,154,10,120
2020-05-18,1,0,0,1,FR_PAC_04,155,10,121
2020-05-19,1,0,1,0,FR_PAC_04,156,11,121
2020-05-20,0,0,0,0,FR_PAC_04,156,11,121
2020-05-21,0,0,0,0,FR_PAC_04,156,11,121
2020-05-22,0,0,0,0,FR_PAC_04,156,11,121
2020-05-23,0,0,0,0,FR_PAC_04,156,11,121
2020-05-24,0,0,0,0,FR_PAC_04,156,11,121
2020-05-25,0,0,0,1,FR_PAC_04,156,11,122
2020-05-26,0,0,0,0,FR_PAC_04,156,11,122
2020-05-27,0,0,1,0,FR_PAC_04,156,12,122
2020-05-28,0,0,0,0,FR_PAC_04,156,12,122
2020-05-29,0,0,0,0,FR_PAC_04,156,12,122
2020-05-30,0,0,0,0,FR_PAC_04,156,12,122
2020-05-31,0,0,0,0,FR_PAC_04,156,12,122
2020-06-01,0,0,0,1,FR_PAC_04,156,12,123
2020-06-02,0,0,0,0,FR_PAC_04,156,12,123
2020-06-03,1,0,0,1,FR_PAC_04,157,12,124
2020-06-04,0,0,0,0,FR_PAC_04,157,12,124
2020-06-05,0,0,0,0,FR_PAC_04,157,12,124
2020-06-06,0,0,0,0,FR_PAC_04,157,12,124
2020-06-07,0,0,0,0,FR_PAC_04,157,12,124
2020-06-08,0,0,0,1,FR_PAC_04,157,12,125
2020-06-09,0,0,0,0,FR_PAC_04,157,12,125
2020-06-10,0,0,0,0,FR_PAC_04,157,12,125
2020-06-11,0,0,0,4,FR_PAC_04,157,12,129
2020-06-12,0,0,1,3,FR_PAC_04,157,13,132
2020-06-13,0,0,0,0,FR_PAC_04,157,13,132
2020-06-14,0,0,0,0,FR_PAC_04,157,13,132
2020-06-15,0,0,0,0,FR_PAC_04,157,13,132
2020-06-16,0,0,0,0,FR_PAC_04,157,13,132
2020-06-17,0,0,0,1,FR_PAC_04,157,13,133
2020-06-18,0,0,0,0,FR_PAC_04,157,13,133
2020-06-19,0,0,0,0,FR_PAC_04,157,13,133
2020-06-20,0,0,0,0,FR_PAC_04,157,13,133
2020-06-21,0,0,0,0,FR_PAC_04,157,13,133
2020-06-22,0,0,0,0,FR_PAC_04,157,13,133
2020-06-23,0,0,0,0,FR_PAC_04,157,13,133
2020-06-24,1,0,0,1,FR_PAC_04,158,13,134
2020-03-19,4,0,0,1,FR_PAC_05,4,0,1
2020-03-20,2,0,0,0,FR_PAC_05,6,0,1
2020-03-21,3,0,0,1,FR_PAC_05,9,0,2
2020-03-22,3,0,0,0,FR_PAC_05,12,0,2
2020-03-23,5,3,0,2,FR_PAC_05,17,0,4
2020-03-24,4,1,1,4,FR_PAC_05,21,1,8
2020-03-25,7,0,0,3,FR_PAC_05,28,1,11
2020-03-26,7,2,0,1,FR_PAC_05,35,1,12
2020-03-27,5,1,0,2,FR_PAC_05,40,1,14
2020-03-28,4,0,0,4,FR_PAC_05,44,1,18
2020-03-29,8,2,0,1,FR_PAC_05,52,1,19
2020-03-30,9,0,0,6,FR_PAC_05,61,1,25
2020-03-31,7,1,0,3,FR_PAC_05,68,1,28
2020-04-01,7,2,0,0,FR_PAC_05,75,1,28
2020-04-02,8,5,0,2,FR_PAC_05,83,1,30
2020-04-03,6,2,0,0,FR_PAC_05,89,1,30
2020-04-04,1,1,0,5,FR_PAC_05,90,1,35
2020-04-05,2,0,0,3,FR_PAC_05,92,1,38
2020-04-06,6,1,1,1,FR_PAC_05,98,2,39
2020-04-07,2,1,0,2,FR_PAC_05,100,2,41
2020-04-08,2,2,0,5,FR_PAC_05,102,2,46
2020-04-09,1,0,0,8,FR_PAC_05,103,2,54
2020-04-10,2,0,0,4,FR_PAC_05,105,2,58
2020-04-11,1,0,0,3,FR_PAC_05,106,2,61
2020-04-12,1,0,1,0,FR_PAC_05,107,3,61
2020-04-13,2,0,0,2,FR_PAC_05,109,3,63
2020-04-14,0,0,0,4,FR_PAC_05,109,3,67
2020-04-15,4,0,1,5,FR_PAC_05,113,4,72
2020-04-16,2,0,0,3,FR_PAC_05,115,4,75
2020-04-17,1,0,1,1,FR_PAC_05,116,5,76
2020-04-18,2,0,1,4,FR_PAC_05,118,6,80
2020-04-19,0,0,0,0,FR_PAC_05,118,6,80
2020-04-20,0,1,0,0,FR_PAC_05,118,6,80
2020-04-21,6,0,0,2,FR_PAC_05,124,6,82
2020-04-22,1,0,0,1,FR_PAC_05,125,6,83
2020-04-23,1,0,0,1,FR_PAC_05,126,6,84
2020-04-24,1,0,0,3,FR_PAC_05,127,6,87
2020-04-25,3,0,0,1,FR_PAC_05,130,6,88
2020-04-26,0,0,0,0,FR_PAC_05,130,6,88
2020-04-27,0,0,0,5,FR_PAC_05,130,6,93
2020-04-28,0,0,0,1,FR_PAC_05,130,6,94
2020-04-29,0,0,2,0,FR_PAC_05,130,8,94
2020-04-30,3,0,0,0,FR_PAC_05,133,8,94
2020-05-01,1,0,0,0,FR_PAC_05,134,8,94
2020-05-02,2,0,0,0,FR_PAC_05,136,8,94
2020-05-03,0,0,0,0,FR_PAC_05,136,8,94
2020-05-04,0,0,0,0,FR_PAC_05,136,8,94
2020-05-05,4,0,2,1,FR_PAC_05,140,10,95
2020-05-06,0,0,0,0,FR_PAC_05,140,10,95
2020-05-07,0,0,1,2,FR_PAC_05,140,11,97
2020-05-08,0,0,0,0,FR_PAC_05,140,11,97
2020-05-09,1,1,0,1,FR_PAC_05,141,11,98
2020-05-10,0,0,0,0,FR_PAC_05,141,11,98
2020-05-11,1,0,1,1,FR_PAC_05,142,12,99
2020-05-12,0,0,1,0,FR_PAC_05,142,13,99
2020-05-13,0,0,0,1,FR_PAC_05,142,13,100
2020-05-14,0,0,2,1,FR_PAC_05,142,15,101
2020-05-15,0,0,0,0,FR_PAC_05,142,15,101
2020-05-16,0,0,0,0,FR_PAC_05,142,15,101
2020-05-17,0,0,0,0,FR_PAC_05,142,15,101
2020-05-18,2,0,1,1,FR_PAC_05,144,16,102
2020-05-19,0,0,0,1,FR_PAC_05,144,16,103
2020-05-20,0,0,0,0,FR_PAC_05,144,16,103
2020-05-21,0,0,0,0,FR_PAC_05,144,16,103
2020-05-22,0,0,1,0,FR_PAC_05,144,17,103
2020-05-23,0,0,0,0,FR_PAC_05,144,17,103
2020-05-24,0,0,0,0,FR_PAC_05,144,17,103
2020-05-25,0,0,0,0,FR_PAC_05,144,17,103
2020-05-26,0,0,0,1,FR_PAC_05,144,17,104
2020-05-27,0,0,0,0,FR_PAC_05,144,17,104
2020-05-28,1,0,0,0,FR_PAC_05,145,17,104
2020-05-29,0,0,0,0,FR_PAC_05,145,17,104
2020-05-30,0,0,0,0,FR_PAC_05,145,17,104
2020-05-31,0,0,0,0,FR_PAC_05,145,17,104
2020-06-01,0,0,0,0,FR_PAC_05,145,17,104
2020-06-02,0,0,1,3,FR_PAC_05,145,18,107
2020-06-03,0,0,0,0,FR_PAC_05,145,18,107
2020-06-04,0,0,0,1,FR_PAC_05,145,18,108
2020-06-05,0,0,0,0,FR_PAC_05,145,18,108
2020-06-06,0,0,0,2,FR_PAC_05,145,18,110
2020-06-07,0,0,0,0,FR_PAC_05,145,18,110
2020-06-08,0,0,0,0,FR_PAC_05,145,18,110
2020-06-09,1,0,0,0,FR_PAC_05,146,18,110
2020-06-10,0,0,0,0,FR_PAC_05,146,18,110
2020-06-11,0,0,0,4,FR_PAC_05,146,18,114
2020-06-12,0,0,0,6,FR_PAC_05,146,18,120
2020-06-13,0,0,0,1,FR_PAC_05,146,18,121
2020-06-14,0,0,0,0,FR_PAC_05,146,18,121
2020-06-15,0,0,0,0,FR_PAC_05,146,18,121
2020-06-16,0,0,0,0,FR_PAC_05,146,18,121
2020-06-17,1,1,0,1,FR_PAC_05,147,18,122
2020-06-18,0,0,0,0,FR_PAC_05,147,18,122
2020-06-19,0,0,0,0,FR_PAC_05,147,18,122
2020-06-20,0,0,0,0,FR_PAC_05,147,18,122
2020-06-21,0,0,0,0,FR_PAC_05,147,18,122
2020-06-22,0,0,0,0,FR_PAC_05,147,18,122
2020-06-23,0,0,0,1,FR_PAC_05,147,18,123
2020-06-24,0,0,0,0,FR_PAC_05,147,18,123
2020-03-19,12,4,0,4,FR_PAC_06,12,0,4
2020-03-20,22,3,2,10,FR_PAC_06,34,2,14
2020-03-21,5,0,2,1,FR_PAC_06,39,4,15
2020-03-22,2,1,2,2,FR_PAC_06,41,6,17
2020-03-23,22,5,0,0,FR_PAC_06,63,6,17
2020-03-24,12,1,0,23,FR_PAC_06,75,6,40
2020-03-25,29,5,1,8,FR_PAC_06,104,7,48
2020-03-26,17,1,3,5,FR_PAC_06,121,10,53
2020-03-27,19,4,0,5,FR_PAC_06,140,10,58
2020-03-28,22,4,3,11,FR_PAC_06,162,13,69
2020-03-29,19,5,2,10,FR_PAC_06,181,15,79
2020-03-30,11,5,3,1,FR_PAC_06,192,18,80
2020-03-31,22,3,3,7,FR_PAC_06,214,21,87
2020-04-01,40,9,6,18,FR_PAC_06,254,27,105
2020-04-02,43,17,3,9,FR_PAC_06,297,30,114
2020-04-03,36,9,3,9,FR_PAC_06,333,33,123
2020-04-04,37,11,3,18,FR_PAC_06,370,36,141
2020-04-05,11,2,5,4,FR_PAC_06,381,41,145
2020-04-06,31,11,4,10,FR_PAC_06,412,45,155
2020-04-07,37,11,1,13,FR_PAC_06,449,46,168
2020-04-08,32,16,8,16,FR_PAC_06,481,54,184
2020-04-09,26,5,5,11,FR_PAC_06,507,59,195
2020-04-10,39,7,2,14,FR_PAC_06,546,61,209
2020-04-11,11,2,4,20,FR_PAC_06,557,65,229
2020-04-12,6,2,1,2,FR_PAC_06,563,66,231
2020-04-13,22,4,7,8,FR_PAC_06,585,73,239
2020-04-14,28,4,6,14,FR_PAC_06,613,79,253
2020-04-15,13,1,4,15,FR_PAC_06,626,83,268
2020-04-16,18,2,3,13,FR_PAC_06,644,86,281
2020-04-17,24,3,8,29,FR_PAC_06,668,94,310
2020-04-18,17,1,2,3,FR_PAC_06,685,96,313
2020-04-19,5,0,1,0,FR_PAC_06,690,97,313
2020-04-20,19,4,9,14,FR_PAC_06,709,106,327
2020-04-21,12,0,1,14,FR_PAC_06,721,107,341
2020-04-22,22,4,2,14,FR_PAC_06,743,109,355
2020-04-23,11,3,1,13,FR_PAC_06,754,110,368
2020-04-24,11,5,7,5,FR_PAC_06,765,117,373
2020-04-25,6,1,4,14,FR_PAC_06,771,121,387
2020-04-26,5,5,1,3,FR_PAC_06,776,122,390
2020-04-27,10,3,4,2,FR_PAC_06,786,126,392
2020-04-28,14,4,2,14,FR_PAC_06,800,128,406
2020-04-29,11,7,0,11,FR_PAC_06,811,128,417
2020-04-30,4,2,5,15,FR_PAC_06,815,133,432
2020-05-01,6,1,1,14,FR_PAC_06,821,134,446
2020-05-02,0,0,1,24,FR_PAC_06,821,135,470
2020-05-03,6,0,0,2,FR_PAC_06,827,135,472
2020-05-04,19,2,10,4,FR_PAC_06,846,145,476
2020-05-05,14,2,2,10,FR_PAC_06,860,147,486
2020-05-06,10,2,4,16,FR_PAC_06,870,151,502
2020-05-07,18,0,1,5,FR_PAC_06,888,152,507
2020-05-08,9,2,5,3,FR_PAC_06,897,157,510
2020-05-09,5,2,0,1,FR_PAC_06,902,157,511
2020-05-10,1,0,0,0,FR_PAC_06,903,157,511
2020-05-11,5,0,2,10,FR_PAC_06,908,159,521
2020-05-12,6,0,2,8,FR_PAC_06,914,161,529
2020-05-13,3,0,2,9,FR_PAC_06,917,163,538
2020-05-14,6,2,1,10,FR_PAC_06,923,164,548
2020-05-15,6,3,2,21,FR_PAC_06,929,166,569
2020-05-16,4,0,1,2,FR_PAC_06,933,167,571
2020-05-17,0,0,1,1,FR_PAC_06,933,168,572
2020-05-18,0,0,1,15,FR_PAC_06,933,169,587
2020-05-19,2,1,2,5,FR_PAC_06,935,171,592
2020-05-20,6,0,0,9,FR_PAC_06,941,171,601
2020-05-21,7,0,1,7,FR_PAC_06,948,172,608
2020-05-22,2,0,1,2,FR_PAC_06,950,173,610
2020-05-23,0,0,0,0,FR_PAC_06,950,173,610
2020-05-24,2,0,1,1,FR_PAC_06,952,174,611
2020-05-25,1,0,1,4,FR_PAC_06,953,175,615
2020-05-26,2,0,2,6,FR_PAC_06,955,177,621
2020-05-27,2,1,0,6,FR_PAC_06,957,177,627
2020-05-28,2,1,1,7,FR_PAC_06,959,178,634
2020-05-29,3,0,0,5,FR_PAC_06,962,178,639
2020-05-30,2,0,0,3,FR_PAC_06,964,178,642
2020-05-31,1,0,0,0,FR_PAC_06,965,178,642
2020-06-01,1,0,0,2,FR_PAC_06,966,178,644
2020-06-02,1,1,2,3,FR_PAC_06,967,180,647
2020-06-03,0,0,1,3,FR_PAC_06,967,181,650
2020-06-04,1,0,1,3,FR_PAC_06,968,182,653
2020-06-05,7,0,0,7,FR_PAC_06,975,182,660
2020-06-06,0,0,0,1,FR_PAC_06,975,182,661
2020-06-07,0,0,0,1,FR_PAC_06,975,182,662
2020-06-08,2,0,0,0,FR_PAC_06,977,182,662
2020-06-09,3,0,0,6,FR_PAC_06,980,182,668
2020-06-10,0,0,0,4,FR_PAC_06,980,182,672
2020-06-11,1,0,0,3,FR_PAC_06,981,182,675
2020-06-12,1,0,1,0,FR_PAC_06,982,183,675
2020-06-13,0,0,0,1,FR_PAC_06,982,183,676
2020-06-14,0,0,0,0,FR_PAC_06,982,183,676
2020-06-15,0,0,0,2,FR_PAC_06,982,183,678
2020-06-16,4,0,1,4,FR_PAC_06,986,184,682
2020-06-17,1,0,0,5,FR_PAC_06,987,184,687
2020-06-18,4,0,0,4,FR_PAC_06,991,184,691
2020-06-19,3,0,2,2,FR_PAC_06,994,186,693
2020-06-20,0,0,1,13,FR_PAC_06,994,187,706
2020-06-21,0,0,0,0,FR_PAC_06,994,187,706
2020-06-22,0,0,0,1,FR_PAC_06,994,187,707
2020-06-23,1,0,1,2,FR_PAC_06,995,188,709
2020-06-24,0,0,0,1,FR_PAC_06,995,188,710
2020-03-19,7,1,0,0,FR_ARA_07,7,0,0
2020-03-20,7,0,1,3,FR_ARA_07,14,1,3
2020-03-21,6,0,0,1,FR_ARA_07,20,1,4
2020-03-22,3,1,0,0,FR_ARA_07,23,1,4
2020-03-23,7,0,1,0,FR_ARA_07,30,2,4
2020-03-24,8,2,1,1,FR_ARA_07,38,3,5
2020-03-25,44,1,1,33,FR_ARA_07,82,4,38
2020-03-26,11,1,1,5,FR_ARA_07,93,5,43
2020-03-27,12,2,4,6,FR_ARA_07,105,9,49
2020-03-28,34,1,1,21,FR_ARA_07,139,10,70
2020-03-29,7,0,1,1,FR_ARA_07,146,11,71
2020-03-30,21,0,1,12,FR_ARA_07,167,12,83
2020-03-31,33,5,1,20,FR_ARA_07,200,13,103
2020-04-01,15,1,4,11,FR_ARA_07,215,17,114
2020-04-02,12,2,6,10,FR_ARA_07,227,23,124
2020-04-03,19,2,1,5,FR_ARA_07,246,24,129
2020-04-04,1,0,2,7,FR_ARA_07,247,26,136
2020-04-05,6,1,0,0,FR_ARA_07,253,26,136
2020-04-06,23,4,4,9,FR_ARA_07,276,30,145
2020-04-07,14,0,2,10,FR_ARA_07,290,32,155
2020-04-08,9,2,3,6,FR_ARA_07,299,35,161
2020-04-09,7,2,3,10,FR_ARA_07,306,38,171
2020-04-10,10,2,2,10,FR_ARA_07,316,40,181
2020-04-11,2,1,0,6,FR_ARA_07,318,40,187
2020-04-12,2,1,0,2,FR_ARA_07,320,40,189
2020-04-13,10,0,3,1,FR_ARA_07,330,43,190
2020-04-14,10,2,3,8,FR_ARA_07,340,46,198
2020-04-15,7,1,0,12,FR_ARA_07,347,46,210
2020-04-16,4,0,0,3,FR_ARA_07,351,46,213
2020-04-17,14,1,3,9,FR_ARA_07,365,49,222
2020-04-18,8,0,1,6,FR_ARA_07,373,50,228
2020-04-19,1,0,0,0,FR_ARA_07,374,50,228
2020-04-20,4,1,3,9,FR_ARA_07,378,53,237
2020-04-21,6,3,1,5,FR_ARA_07,384,54,242
2020-04-22,4,0,1,5,FR_ARA_07,388,55,247
2020-04-23,8,0,2,10,FR_ARA_07,396,57,257
2020-04-24,3,1,0,1,FR_ARA_07,399,57,258
2020-04-25,6,2,2,7,FR_ARA_07,405,59,265
2020-04-26,7,0,1,1,FR_ARA_07,412,60,266
2020-04-27,11,0,6,2,FR_ARA_07,423,66,268
2020-04-28,51,2,2,6,FR_ARA_07,474,68,274
2020-04-29,3,1,1,4,FR_ARA_07,477,69,278
2020-04-30,28,0,1,25,FR_ARA_07,505,70,303
2020-05-01,9,0,1,8,FR_ARA_07,514,71,311
2020-05-02,2,0,0,3,FR_ARA_07,516,71,314
2020-05-03,0,0,2,0,FR_ARA_07,516,73,314
2020-05-04,4,1,2,6,FR_ARA_07,520,75,320
2020-05-05,36,0,5,14,FR_ARA_07,556,80,334
2020-05-06,16,0,2,30,FR_ARA_07,572,82,364
2020-05-07,8,0,3,5,FR_ARA_07,580,85,369
2020-05-08,4,0,2,5,FR_ARA_07,584,87,374
2020-05-09,3,0,1,1,FR_ARA_07,587,88,375
2020-05-10,9,1,2,6,FR_ARA_07,596,90,381
2020-05-11,1,0,0,5,FR_ARA_07,597,90,386
2020-05-12,4,0,0,9,FR_ARA_07,601,90,395
2020-05-13,9,0,5,13,FR_ARA_07,610,95,408
2020-05-14,7,0,1,6,FR_ARA_07,617,96,414
2020-05-15,1,1,3,5,FR_ARA_07,618,99,419
2020-05-16,1,0,1,15,FR_ARA_07,619,100,434
2020-05-17,0,0,0,0,FR_ARA_07,619,100,434
2020-05-18,6,0,1,2,FR_ARA_07,625,101,436
2020-05-19,4,0,1,8,FR_ARA_07,629,102,444
2020-05-20,5,0,2,13,FR_ARA_07,634,104,457
2020-05-21,0,0,0,10,FR_ARA_07,634,104,467
2020-05-22,3,1,0,2,FR_ARA_07,637,104,469
2020-05-23,0,0,0,1,FR_ARA_07,637,104,470
2020-05-24,2,0,0,0,FR_ARA_07,639,104,470
2020-05-25,2,1,1,2,FR_ARA_07,641,105,472
2020-05-26,4,0,1,6,FR_ARA_07,645,106,478
2020-05-27,4,0,2,9,FR_ARA_07,649,108,487
2020-05-28,0,0,1,15,FR_ARA_07,649,109,502
2020-05-29,0,0,0,12,FR_ARA_07,649,109,514
2020-05-30,0,0,0,4,FR_ARA_07,649,109,518
2020-05-31,1,0,0,0,FR_ARA_07,650,109,518
2020-06-01,2,0,0,0,FR_ARA_07,652,109,518
2020-06-02,3,1,1,1,FR_ARA_07,655,110,519
2020-06-03,0,0,0,8,FR_ARA_07,655,110,527
2020-06-04,1,1,1,3,FR_ARA_07,656,111,530
2020-06-05,0,0,0,0,FR_ARA_07,656,111,530
2020-06-06,0,0,0,1,FR_ARA_07,656,111,531
2020-06-07,0,0,0,0,FR_ARA_07,656,111,531
2020-06-08,2,0,1,2,FR_ARA_07,658,112,533
2020-06-09,0,0,0,3,FR_ARA_07,658,112,536
2020-06-10,1,0,0,1,FR_ARA_07,659,112,537
2020-06-11,1,0,0,3,FR_ARA_07,660,112,540
2020-06-12,1,0,0,3,FR_ARA_07,661,112,543
2020-06-13,0,0,0,0,FR_ARA_07,661,112,543
2020-06-14,0,0,0,0,FR_ARA_07,661,112,543
2020-06-15,0,0,0,2,FR_ARA_07,661,112,545
2020-06-16,0,0,0,0,FR_ARA_07,661,112,545
2020-06-17,0,0,0,3,FR_ARA_07,661,112,548
2020-06-18,0,0,0,2,FR_ARA_07,661,112,550
2020-06-19,0,0,0,1,FR_ARA_07,661,112,551
2020-06-20,0,0,0,7,FR_ARA_07,661,112,558
2020-06-21,0,0,0,1,FR_ARA_07,661,112,559
2020-06-22,0,0,0,0,FR_ARA_07,661,112,559
2020-06-23,0,0,0,1,FR_ARA_07,661,112,560
2020-06-24,1,0,0,1,FR_ARA_07,662,112,561
2020-03-19,1,1,0,0,FR_GES_08,1,0,0
2020-03-20,0,0,0,0,FR_GES_08,1,0,0
2020-03-21,2,0,0,0,FR_GES_08,3,0,0
2020-03-22,1,0,0,0,FR_GES_08,4,0,0
2020-03-23,1,1,0,0,FR_GES_08,5,0,0
2020-03-24,0,0,0,1,FR_GES_08,5,0,1
2020-03-25,2,1,0,0,FR_GES_08,7,0,1
2020-03-26,8,4,0,0,FR_GES_08,15,0,1
2020-03-27,0,1,0,0,FR_GES_08,15,0,1
2020-03-28,11,0,0,0,FR_GES_08,26,0,1
2020-03-29,7,3,0,2,FR_GES_08,33,0,3
2020-03-30,0,0,0,0,FR_GES_08,33,0,3
2020-03-31,22,7,0,4,FR_GES_08,55,0,7
2020-04-01,7,0,1,0,FR_GES_08,62,1,7
2020-04-02,13,1,0,2,FR_GES_08,75,1,9
2020-04-03,5,0,1,3,FR_GES_08,80,2,12
2020-04-04,11,2,1,7,FR_GES_08,91,3,19
2020-04-05,10,0,1,3,FR_GES_08,101,4,22
2020-04-06,8,0,2,7,FR_GES_08,109,6,29
2020-04-07,13,1,0,7,FR_GES_08,122,6,36
2020-04-08,0,0,1,2,FR_GES_08,122,7,38
2020-04-09,11,2,2,5,FR_GES_08,133,9,43
2020-04-10,9,0,2,8,FR_GES_08,142,11,51
2020-04-11,3,1,2,5,FR_GES_08,145,13,56
2020-04-12,23,0,4,9,FR_GES_08,168,17,65
2020-04-13,0,0,0,0,FR_GES_08,168,17,65
2020-04-14,9,3,4,5,FR_GES_08,177,21,70
2020-04-15,7,1,4,8,FR_GES_08,184,25,78
2020-04-16,3,0,0,5,FR_GES_08,187,25,83
2020-04-17,14,3,2,9,FR_GES_08,201,27,92
2020-04-18,11,1,5,7,FR_GES_08,212,32,99
2020-04-19,6,0,3,3,FR_GES_08,218,35,102
2020-04-20,3,0,5,0,FR_GES_08,221,40,102
2020-04-21,4,0,1,2,FR_GES_08,225,41,104
2020-04-22,10,2,2,6,FR_GES_08,235,43,110
2020-04-23,2,0,0,1,FR_GES_08,237,43,111
2020-04-24,4,1,0,1,FR_GES_08,241,43,112
2020-04-25,3,1,1,1,FR_GES_08,244,44,113
2020-04-26,4,0,0,3,FR_GES_08,248,44,116
2020-04-27,4,0,2,1,FR_GES_08,252,46,117
2020-04-28,1,0,0,0,FR_GES_08,253,46,117
2020-04-29,4,0,0,7,FR_GES_08,257,46,124
2020-04-30,0,0,0,1,FR_GES_08,257,46,125
2020-05-01,3,0,2,0,FR_GES_08,260,48,125
2020-05-02,2,0,0,0,FR_GES_08,262,48,125
2020-05-03,2,2,1,0,FR_GES_08,264,49,125
2020-05-04,0,0,1,1,FR_GES_08,264,50,126
2020-05-05,2,0,0,1,FR_GES_08,266,50,127
2020-05-06,12,0,0,2,FR_GES_08,278,50,129
2020-05-07,6,1,0,2,FR_GES_08,284,50,131
2020-05-08,0,0,0,0,FR_GES_08,284,50,131
2020-05-09,7,1,4,0,FR_GES_08,291,54,131
2020-05-10,3,0,0,1,FR_GES_08,294,54,132
2020-05-11,1,0,1,0,FR_GES_08,295,55,132
2020-05-12,1,0,1,2,FR_GES_08,296,56,134
2020-05-13,0,0,0,0,FR_GES_08,296,56,134
2020-05-14,7,0,2,2,FR_GES_08,303,58,136
2020-05-15,6,0,1,4,FR_GES_08,309,59,140
2020-05-16,0,0,0,1,FR_GES_08,309,59,141
2020-05-17,2,1,0,0,FR_GES_08,311,59,141
2020-05-18,0,0,0,0,FR_GES_08,311,59,141
2020-05-19,29,3,2,1,FR_GES_08,340,61,142
2020-05-20,0,0,0,1,FR_GES_08,340,61,143
2020-05-21,0,0,1,0,FR_GES_08,340,62,143
2020-05-22,3,0,0,2,FR_GES_08,343,62,145
2020-05-23,0,0,0,0,FR_GES_08,343,62,145
2020-05-24,0,0,0,2,FR_GES_08,343,62,147
2020-05-25,0,0,0,0,FR_GES_08,343,62,147
2020-05-26,1,0,0,8,FR_GES_08,344,62,155
2020-05-27,1,0,0,0,FR_GES_08,345,62,155
2020-05-28,1,0,0,3,FR_GES_08,346,62,158
2020-05-29,1,1,0,0,FR_GES_08,347,62,158
2020-05-30,2,0,1,26,FR_GES_08,349,63,184
2020-05-31,0,0,0,0,FR_GES_08,349,63,184
2020-06-01,3,1,0,2,FR_GES_08,352,63,186
2020-06-02,0,0,0,0,FR_GES_08,352,63,186
2020-06-03,0,0,0,0,FR_GES_08,352,63,186
2020-06-04,1,0,0,3,FR_GES_08,353,63,189
2020-06-05,0,0,0,10,FR_GES_08,353,63,199
2020-06-06,8,2,0,0,FR_GES_08,361,63,199
2020-06-07,0,0,0,1,FR_GES_08,361,63,200
2020-06-08,0,0,0,0,FR_GES_08,361,63,200
2020-06-09,0,0,0,0,FR_GES_08,361,63,200
2020-06-10,0,0,0,3,FR_GES_08,361,63,203
2020-06-11,6,1,0,16,FR_GES_08,367,63,219
2020-06-12,0,0,0,1,FR_GES_08,367,63,220
2020-06-13,0,0,0,1,FR_GES_08,367,63,221
2020-06-14,0,0,0,1,FR_GES_08,367,63,222
2020-06-15,0,0,2,0,FR_GES_08,367,65,222
2020-06-16,0,0,0,1,FR_GES_08,367,65,223
2020-06-17,0,0,0,1,FR_GES_08,367,65,224
2020-06-18,0,0,0,0,FR_GES_08,367,65,224
2020-06-19,0,0,0,1,FR_GES_08,367,65,225
2020-06-20,0,0,2,0,FR_GES_08,367,67,225
2020-06-21,0,0,0,0,FR_GES_08,367,67,225
2020-06-22,0,0,1,0,FR_GES_08,367,68,225
2020-06-23,0,0,0,1,FR_GES_08,367,68,226
2020-06-24,0,0,0,0,FR_GES_08,367,68,226
2020-03-19,0,0,0,0,FR_OCC_09,0,0,0
2020-03-20,1,0,0,0,FR_OCC_09,1,0,0
2020-03-21,1,0,0,1,FR_OCC_09,2,0,1
2020-03-22,1,0,0,0,FR_OCC_09,3,0,1
2020-03-23,1,2,0,0,FR_OCC_09,4,0,1
2020-03-24,1,0,0,0,FR_OCC_09,5,0,1
2020-03-25,5,0,0,1,FR_OCC_09,10,0,2
2020-03-26,0,1,0,0,FR_OCC_09,10,0,2
2020-03-27,1,0,0,0,FR_OCC_09,11,0,2
2020-03-28,0,0,0,0,FR_OCC_09,11,0,2
2020-03-29,0,1,0,0,FR_OCC_09,11,0,2
2020-03-30,2,1,0,0,FR_OCC_09,13,0,2
2020-03-31,3,0,0,2,FR_OCC_09,16,0,4
2020-04-01,5,3,0,1,FR_OCC_09,21,0,5
2020-04-02,2,0,1,1,FR_OCC_09,23,1,6
2020-04-03,0,0,0,0,FR_OCC_09,23,1,6
2020-04-04,1,0,0,2,FR_OCC_09,24,1,8
2020-04-05,3,0,0,0,FR_OCC_09,27,1,8
2020-04-06,1,0,0,1,FR_OCC_09,28,1,9
2020-04-07,2,0,0,1,FR_OCC_09,30,1,10
2020-04-08,3,0,0,1,FR_OCC_09,33,1,11
2020-04-09,1,0,0,1,FR_OCC_09,34,1,12
2020-04-10,1,0,0,4,FR_OCC_09,35,1,16
2020-04-11,0,0,0,0,FR_OCC_09,35,1,16
2020-04-12,1,0,0,0,FR_OCC_09,36,1,16
2020-04-13,0,0,0,0,FR_OCC_09,36,1,16
2020-04-14,0,0,0,0,FR_OCC_09,36,1,16
2020-04-15,2,0,0,0,FR_OCC_09,38,1,16
2020-04-16,0,0,0,0,FR_OCC_09,38,1,16
2020-04-17,2,1,1,4,FR_OCC_09,40,2,20
2020-04-18,0,0,0,0,FR_OCC_09,40,2,20
2020-04-19,0,0,0,1,FR_OCC_09,40,2,21
2020-04-20,1,0,0,1,FR_OCC_09,41,2,22
2020-04-21,0,0,0,1,FR_OCC_09,41,2,23
2020-04-22,0,0,0,0,FR_OCC_09,41,2,23
2020-04-23,1,0,0,0,FR_OCC_09,42,2,23
2020-04-24,1,0,0,4,FR_OCC_09,43,2,27
2020-04-25,0,0,0,0,FR_OCC_09,43,2,27
2020-04-26,0,0,0,0,FR_OCC_09,43,2,27
2020-04-27,0,0,0,1,FR_OCC_09,43,2,28
2020-04-28,0,0,0,0,FR_OCC_09,43,2,28
2020-04-29,0,0,0,0,FR_OCC_09,43,2,28
2020-04-30,0,0,0,0,FR_OCC_09,43,2,28
2020-05-01,0,0,0,3,FR_OCC_09,43,2,31
2020-05-02,0,0,0,1,FR_OCC_09,43,2,32
2020-05-03,0,0,0,0,FR_OCC_09,43,2,32
2020-05-04,0,0,0,0,FR_OCC_09,43,2,32
2020-05-05,0,0,0,0,FR_OCC_09,43,2,32
2020-05-06,0,0,0,0,FR_OCC_09,43,2,32
2020-05-07,0,0,0,0,FR_OCC_09,43,2,32
2020-05-08,0,1,0,0,FR_OCC_09,43,2,32
2020-05-09,0,0,0,0,FR_OCC_09,43,2,32
2020-05-10,0,0,0,0,FR_OCC_09,43,2,32
2020-05-11,0,0,0,0,FR_OCC_09,43,2,32
2020-05-12,0,0,0,0,FR_OCC_09,43,2,32
2020-05-13,0,0,0,0,FR_OCC_09,43,2,32
2020-05-14,0,0,0,0,FR_OCC_09,43,2,32
2020-05-15,0,0,0,0,FR_OCC_09,43,2,32
2020-05-16,0,0,0,0,FR_OCC_09,43,2,32
2020-05-17,0,0,0,0,FR_OCC_09,43,2,32
2020-05-18,0,0,0,0,FR_OCC_09,43,2,32
2020-05-19,0,0,0,0,FR_OCC_09,43,2,32
2020-05-20,2,0,0,0,FR_OCC_09,45,2,32
2020-05-21,1,0,0,0,FR_OCC_09,46,2,32
2020-05-22,0,0,1,2,FR_OCC_09,46,3,34
2020-05-23,0,0,0,0,FR_OCC_09,46,3,34
2020-05-24,0,0,0,0,FR_OCC_09,46,3,34
2020-05-25,0,0,0,0,FR_OCC_09,46,3,34
2020-05-26,0,0,0,0,FR_OCC_09,46,3,34
2020-05-27,0,0,0,1,FR_OCC_09,46,3,35
2020-05-28,0,0,0,0,FR_OCC_09,46,3,35
2020-05-29,0,0,0,0,FR_OCC_09,46,3,35
2020-05-30,0,0,0,0,FR_OCC_09,46,3,35
2020-05-31,0,0,0,0,FR_OCC_09,46,3,35
2020-06-01,0,0,0,0,FR_OCC_09,46,3,35
2020-06-02,0,0,0,0,FR_OCC_09,46,3,35
2020-06-03,0,0,0,0,FR_OCC_09,46,3,35
2020-06-04,0,0,0,0,FR_OCC_09,46,3,35
2020-06-05,0,0,0,0,FR_OCC_09,46,3,35
2020-06-06,0,0,0,0,FR_OCC_09,46,3,35
2020-06-07,0,0,0,0,FR_OCC_09,46,3,35
2020-06-08,0,0,0,0,FR_OCC_09,46,3,35
2020-06-09,0,0,0,0,FR_OCC_09,46,3,35
2020-06-10,0,0,0,0,FR_OCC_09,46,3,35
2020-06-11,0,0,0,1,FR_OCC_09,46,3,36
2020-06-12,0,0,0,0,FR_OCC_09,46,3,36
2020-06-13,0,0,0,0,FR_OCC_09,46,3,36
2020-06-14,0,0,0,0,FR_OCC_09,46,3,36
2020-06-15,0,0,0,0,FR_OCC_09,46,3,36
2020-06-16,0,0,0,0,FR_OCC_09,46,3,36
2020-06-17,0,0,0,0,FR_OCC_09,46,3,36
2020-06-18,0,0,0,0,FR_OCC_09,46,3,36
2020-06-19,0,0,0,0,FR_OCC_09,46,3,36
2020-06-20,0,0,0,0,FR_OCC_09,46,3,36
2020-06-21,0,0,0,0,FR_OCC_09,46,3,36
2020-06-22,0,0,0,0,FR_OCC_09,46,3,36
2020-06-23,0,0,0,0,FR_OCC_09,46,3,36
2020-06-24,0,0,0,0,FR_OCC_09,46,3,36
2020-03-19,6,2,0,0,FR_GES_10,6,0,0
2020-03-20,2,0,0,0,FR_GES_10,8,0,0
2020-03-21,6,2,0,0,FR_GES_10,14,0,0
2020-03-22,9,0,0,0,FR_GES_10,23,0,0
2020-03-23,9,0,2,0,FR_GES_10,32,2,0
2020-03-24,3,0,0,0,FR_GES_10,35,2,0
2020-03-25,17,5,4,3,FR_GES_10,52,6,3
2020-03-26,12,2,0,0,FR_GES_10,64,6,3
2020-03-27,4,0,0,0,FR_GES_10,68,6,3
2020-03-28,4,0,1,0,FR_GES_10,72,7,3
2020-03-29,1,0,0,0,FR_GES_10,73,7,3
2020-03-30,6,0,0,1,FR_GES_10,79,7,4
2020-03-31,13,1,1,0,FR_GES_10,92,8,4
2020-04-01,34,5,10,17,FR_GES_10,126,18,21
2020-04-02,23,2,2,3,FR_GES_10,149,20,24
2020-04-03,9,0,1,1,FR_GES_10,158,21,25
2020-04-04,38,4,10,2,FR_GES_10,196,31,27
2020-04-05,10,1,3,0,FR_GES_10,206,34,27
2020-04-06,3,0,1,0,FR_GES_10,209,35,27
2020-04-07,13,2,3,3,FR_GES_10,222,38,30
2020-04-08,29,2,9,24,FR_GES_10,251,47,54
2020-04-09,157,5,11,95,FR_GES_10,408,58,149
2020-04-10,62,0,1,49,FR_GES_10,470,59,198
2020-04-11,9,0,2,0,FR_GES_10,479,61,198
2020-04-12,24,0,0,1,FR_GES_10,503,61,199
2020-04-13,24,0,1,1,FR_GES_10,527,62,200
2020-04-14,19,1,3,0,FR_GES_10,546,65,200
2020-04-15,11,0,5,14,FR_GES_10,557,70,214
2020-04-16,18,0,2,18,FR_GES_10,575,72,232
2020-04-17,13,0,2,13,FR_GES_10,588,74,245
2020-04-18,6,0,0,1,FR_GES_10,594,74,246
2020-04-19,4,1,2,0,FR_GES_10,598,76,246
2020-04-20,12,0,6,19,FR_GES_10,610,82,265
2020-04-21,7,5,4,10,FR_GES_10,617,86,275
2020-04-22,37,0,7,27,FR_GES_10,654,93,302
2020-04-23,29,2,5,14,FR_GES_10,683,98,316
2020-04-24,29,0,4,27,FR_GES_10,712,102,343
2020-04-25,12,0,3,2,FR_GES_10,724,105,345
2020-04-26,0,0,1,0,FR_GES_10,724,106,345
2020-04-27,6,0,2,7,FR_GES_10,730,108,352
2020-04-28,29,5,1,22,FR_GES_10,759,109,374
2020-04-29,26,4,3,27,FR_GES_10,785,112,401
2020-04-30,16,3,2,10,FR_GES_10,801,114,411
2020-05-01,19,0,1,18,FR_GES_10,820,115,429
2020-05-02,13,2,0,3,FR_GES_10,833,115,432
2020-05-03,14,5,0,20,FR_GES_10,847,115,452
2020-05-04,4,0,1,0,FR_GES_10,851,116,452
2020-05-05,4,0,0,10,FR_GES_10,855,116,462
2020-05-06,10,0,2,16,FR_GES_10,865,118,478
2020-05-07,20,0,4,27,FR_GES_10,885,122,505
2020-05-08,5,0,1,3,FR_GES_10,890,123,508
2020-05-09,1,0,0,0,FR_GES_10,891,123,508
2020-05-10,4,0,0,2,FR_GES_10,895,123,510
2020-05-11,2,0,1,0,FR_GES_10,897,124,510
2020-05-12,2,0,0,5,FR_GES_10,899,124,515
2020-05-13,2,0,0,5,FR_GES_10,901,124,520
2020-05-14,6,0,0,1,FR_GES_10,907,124,521
2020-05-15,1,0,0,8,FR_GES_10,908,124,529
2020-05-16,5,0,0,4,FR_GES_10,913,124,533
2020-05-17,2,0,3,1,FR_GES_10,915,127,534
2020-05-18,7,0,0,0,FR_GES_10,922,127,534
2020-05-19,1,0,0,5,FR_GES_10,923,127,539
2020-05-20,3,0,2,12,FR_GES_10,926,129,551
2020-05-21,5,0,0,2,FR_GES_10,931,129,553
2020-05-22,1,0,0,0,FR_GES_10,932,129,553
2020-05-23,1,0,0,0,FR_GES_10,933,129,553
2020-05-24,1,0,2,0,FR_GES_10,934,131,553
2020-05-25,0,0,0,0,FR_GES_10,934,131,553
2020-05-26,1,0,2,5,FR_GES_10,935,133,558
2020-05-27,2,0,1,19,FR_GES_10,937,134,577
2020-05-28,4,0,2,3,FR_GES_10,941,136,580
2020-05-29,2,0,1,5,FR_GES_10,943,137,585
2020-05-30,0,0,0,3,FR_GES_10,943,137,588
2020-05-31,0,0,0,1,FR_GES_10,943,137,589
2020-06-01,1,0,0,0,FR_GES_10,944,137,589
2020-06-02,0,0,1,0,FR_GES_10,944,138,589
2020-06-03,0,0,0,4,FR_GES_10,944,138,593
2020-06-04,0,0,0,3,FR_GES_10,944,138,596
2020-06-05,1,0,1,12,FR_GES_10,945,139,608
2020-06-06,1,0,0,2,FR_GES_10,946,139,610
2020-06-07,1,0,0,0,FR_GES_10,947,139,610
2020-06-08,0,0,0,0,FR_GES_10,947,139,610
2020-06-09,2,0,0,2,FR_GES_10,949,139,612
2020-06-10,0,0,0,4,FR_GES_10,949,139,616
2020-06-11,4,1,0,1,FR_GES_10,953,139,617
2020-06-12,0,0,0,0,FR_GES_10,953,139,617
2020-06-13,0,0,0,3,FR_GES_10,953,139,620
2020-06-14,0,0,1,0,FR_GES_10,953,140,620
2020-06-15,0,0,0,0,FR_GES_10,953,140,620
2020-06-16,2,0,0,2,FR_GES_10,955,140,622
2020-06-17,1,0,0,3,FR_GES_10,956,140,625
2020-06-18,1,0,0,0,FR_GES_10,957,140,625
2020-06-19,0,0,0,0,FR_GES_10,957,140,625
2020-06-20,2,0,0,0,FR_GES_10,959,140,625
2020-06-21,0,0,0,0,FR_GES_10,959,140,625
2020-06-22,0,0,0,0,FR_GES_10,959,140,625
2020-06-23,0,0,0,3,FR_GES_10,959,140,628
2020-06-24,0,0,0,1,FR_GES_10,959,140,629
2020-03-19,19,5,3,4,FR_OCC_11,19,3,4
2020-03-20,10,2,2,1,FR_OCC_11,29,5,5
2020-03-21,2,0,3,0,FR_OCC_11,31,8,5
2020-03-22,5,1,1,0,FR_OCC_11,36,9,5
2020-03-23,14,4,0,0,FR_OCC_11,50,9,5
2020-03-24,5,1,2,0,FR_OCC_11,55,11,5
2020-03-25,12,1,3,4,FR_OCC_11,67,14,9
2020-03-26,13,3,1,6,FR_OCC_11,80,15,15
2020-03-27,12,2,0,3,FR_OCC_11,92,15,18
2020-03-28,21,4,2,8,FR_OCC_11,113,17,26
2020-03-29,18,1,0,1,FR_OCC_11,131,17,27
2020-03-30,19,2,1,1,FR_OCC_11,150,18,28
2020-03-31,15,1,2,3,FR_OCC_11,165,20,31
2020-04-01,17,3,2,7,FR_OCC_11,182,22,38
2020-04-02,31,1,0,6,FR_OCC_11,213,22,44
2020-04-03,7,1,4,3,FR_OCC_11,220,26,47
2020-04-04,8,1,0,3,FR_OCC_11,228,26,50
2020-04-05,8,0,3,6,FR_OCC_11,236,29,56
2020-04-06,7,2,4,4,FR_OCC_11,243,33,60
2020-04-07,13,2,0,9,FR_OCC_11,256,33,69
2020-04-08,4,0,3,5,FR_OCC_11,260,36,74
2020-04-09,3,1,2,5,FR_OCC_11,263,38,79
2020-04-10,6,2,1,7,FR_OCC_11,269,39,86
2020-04-11,7,0,0,5,FR_OCC_11,276,39,91
2020-04-12,17,0,1,0,FR_OCC_11,293,40,91
2020-04-13,13,1,2,0,FR_OCC_11,306,42,91
2020-04-14,4,0,1,2,FR_OCC_11,310,43,93
2020-04-15,4,0,0,10,FR_OCC_11,314,43,103
2020-04-16,3,0,0,4,FR_OCC_11,317,43,107
2020-04-17,7,1,0,7,FR_OCC_11,324,43,114
2020-04-18,7,0,1,9,FR_OCC_11,331,44,123
2020-04-19,3,1,0,0,FR_OCC_11,334,44,123
2020-04-20,2,0,1,1,FR_OCC_11,336,45,124
2020-04-21,11,1,1,6,FR_OCC_11,347,46,130
2020-04-22,1,0,1,2,FR_OCC_11,348,47,132
2020-04-23,1,0,1,5,FR_OCC_11,349,48,137
2020-04-24,5,0,2,3,FR_OCC_11,354,50,140
2020-04-25,3,0,1,5,FR_OCC_11,357,51,145
2020-04-26,1,0,1,2,FR_OCC_11,358,52,147
2020-04-27,3,1,0,0,FR_OCC_11,361,52,147
2020-04-28,8,2,1,7,FR_OCC_11,369,53,154
2020-04-29,0,0,0,2,FR_OCC_11,369,53,156
2020-04-30,7,0,2,11,FR_OCC_11,376,55,167
2020-05-01,5,0,0,1,FR_OCC_11,381,55,168
2020-05-02,1,0,0,1,FR_OCC_11,382,55,169
2020-05-03,5,0,0,0,FR_OCC_11,387,55,169
2020-05-04,2,0,1,4,FR_OCC_11,389,56,173
2020-05-05,1,0,1,3,FR_OCC_11,390,57,176
2020-05-06,0,0,0,9,FR_OCC_11,390,57,185
2020-05-07,2,0,1,2,FR_OCC_11,392,58,187
2020-05-08,1,0,0,0,FR_OCC_11,393,58,187
2020-05-09,0,1,1,1,FR_OCC_11,393,59,188
2020-05-10,0,0,0,0,FR_OCC_11,393,59,188
2020-05-11,0,0,0,0,FR_OCC_11,393,59,188
2020-05-12,0,0,0,3,FR_OCC_11,393,59,191
2020-05-13,9,1,0,2,FR_OCC_11,402,59,193
2020-05-14,0,0,0,3,FR_OCC_11,402,59,196
2020-05-15,0,0,0,3,FR_OCC_11,402,59,199
2020-05-16,7,1,0,0,FR_OCC_11,409,59,199
2020-05-17,3,0,0,3,FR_OCC_11,412,59,202
2020-05-18,3,1,0,0,FR_OCC_11,415,59,202
2020-05-19,2,0,0,2,FR_OCC_11,417,59,204
2020-05-20,2,0,0,5,FR_OCC_11,419,59,209
2020-05-21,2,0,0,2,FR_OCC_11,421,59,211
2020-05-22,7,2,0,1,FR_OCC_11,428,59,212
2020-05-23,0,0,0,0,FR_OCC_11,428,59,212
2020-05-24,0,0,0,0,FR_OCC_11,428,59,212
2020-05-25,1,0,0,0,FR_OCC_11,429,59,212
2020-05-26,0,0,0,1,FR_OCC_11,429,59,213
2020-05-27,0,0,0,1,FR_OCC_11,429,59,214
2020-05-28,2,0,0,4,FR_OCC_11,431,59,218
2020-05-29,1,0,0,1,FR_OCC_11,432,59,219
2020-05-30,1,0,0,1,FR_OCC_11,433,59,220
2020-05-31,2,0,1,0,FR_OCC_11,435,60,220
2020-06-01,0,0,1,0,FR_OCC_11,435,61,220
2020-06-02,2,0,1,0,FR_OCC_11,437,62,220
2020-06-03,0,0,0,2,FR_OCC_11,437,62,222
2020-06-04,0,0,0,2,FR_OCC_11,437,62,224
2020-06-05,1,0,0,1,FR_OCC_11,438,62,225
2020-06-06,0,0,0,1,FR_OCC_11,438,62,226
2020-06-07,0,0,0,0,FR_OCC_11,438,62,226
2020-06-08,0,0,0,0,FR_OCC_11,438,62,226
2020-06-09,0,0,0,0,FR_OCC_11,438,62,226
2020-06-10,0,0,0,0,FR_OCC_11,438,62,226
2020-06-11,1,0,0,0,FR_OCC_11,439,62,226
2020-06-12,0,0,0,0,FR_OCC_11,439,62,226
2020-06-13,0,0,0,0,FR_OCC_11,439,62,226
2020-06-14,0,0,0,0,FR_OCC_11,439,62,226
2020-06-15,1,0,0,1,FR_OCC_11,440,62,227
2020-06-16,0,0,0,2,FR_OCC_11,440,62,229
2020-06-17,0,0,0,0,FR_OCC_11,440,62,229
2020-06-18,0,0,0,1,FR_OCC_11,440,62,230
2020-06-19,0,0,0,0,FR_OCC_11,440,62,230
2020-06-20,1,0,0,1,FR_OCC_11,441,62,231
2020-06-21,3,0,0,0,FR_OCC_11,444,62,231
2020-06-22,1,0,0,0,FR_OCC_11,445,62,231
2020-06-23,1,0,0,0,FR_OCC_11,446,62,231
2020-06-24,0,0,0,1,FR_OCC_11,446,62,232
2020-03-19,4,0,1,1,FR_OCC_12,4,1,1
2020-03-20,4,0,0,1,FR_OCC_12,8,1,2
2020-03-21,1,0,0,1,FR_OCC_12,9,1,3
2020-03-22,2,0,0,0,FR_OCC_12,11,1,3
2020-03-23,1,0,0,0,FR_OCC_12,12,1,3
2020-03-24,6,1,0,1,FR_OCC_12,18,1,4
2020-03-25,3,1,0,5,FR_OCC_12,21,1,9
2020-03-26,8,2,3,0,FR_OCC_12,29,4,9
2020-03-27,6,1,1,3,FR_OCC_12,35,5,12
2020-03-28,13,0,1,3,FR_OCC_12,48,6,15
2020-03-29,2,0,0,0,FR_OCC_12,50,6,15
2020-03-30,10,2,0,3,FR_OCC_12,60,6,18
2020-03-31,6,2,0,2,FR_OCC_12,66,6,20
2020-04-01,4,0,1,0,FR_OCC_12,70,7,20
2020-04-02,9,1,0,3,FR_OCC_12,79,7,23
2020-04-03,13,1,1,2,FR_OCC_12,92,8,25
2020-04-04,10,2,2,5,FR_OCC_12,102,10,30
2020-04-05,3,0,2,3,FR_OCC_12,105,12,33
2020-04-06,6,0,0,1,FR_OCC_12,111,12,34
2020-04-07,4,0,1,7,FR_OCC_12,115,13,41
2020-04-08,3,0,1,5,FR_OCC_12,118,14,46
2020-04-09,4,1,1,3,FR_OCC_12,122,15,49
2020-04-10,7,2,2,6,FR_OCC_12,129,17,55
2020-04-11,8,0,0,2,FR_OCC_12,137,17,57
2020-04-12,2,0,1,0,FR_OCC_12,139,18,57
2020-04-13,3,0,1,1,FR_OCC_12,142,19,58
2020-04-14,1,0,0,2,FR_OCC_12,143,19,60
2020-04-15,3,0,0,4,FR_OCC_12,146,19,64
2020-04-16,1,0,0,1,FR_OCC_12,147,19,65
2020-04-17,5,0,0,2,FR_OCC_12,152,19,67
2020-04-18,8,0,0,2,FR_OCC_12,160,19,69
2020-04-19,1,0,0,2,FR_OCC_12,161,19,71
2020-04-20,4,0,0,1,FR_OCC_12,165,19,72
2020-04-21,1,0,1,2,FR_OCC_12,166,20,74
2020-04-22,3,0,0,6,FR_OCC_12,169,20,80
2020-04-23,3,0,0,6,FR_OCC_12,172,20,86
2020-04-24,0,0,0,13,FR_OCC_12,172,20,99
2020-04-25,0,0,0,2,FR_OCC_12,172,20,101
2020-04-26,0,0,0,0,FR_OCC_12,172,20,101
2020-04-27,0,0,0,0,FR_OCC_12,172,20,101
2020-04-28,0,0,0,3,FR_OCC_12,172,20,104
2020-04-29,0,0,1,2,FR_OCC_12,172,21,106
2020-04-30,1,0,1,4,FR_OCC_12,173,22,110
2020-05-01,0,0,0,5,FR_OCC_12,173,22,115
2020-05-02,0,0,0,4,FR_OCC_12,173,22,119
2020-05-03,0,0,0,0,FR_OCC_12,173,22,119
2020-05-04,0,0,0,0,FR_OCC_12,173,22,119
2020-05-05,0,0,0,3,FR_OCC_12,173,22,122
2020-05-06,2,0,0,1,FR_OCC_12,175,22,123
2020-05-07,0,0,0,0,FR_OCC_12,175,22,123
2020-05-08,0,0,0,0,FR_OCC_12,175,22,123
2020-05-09,0,0,0,1,FR_OCC_12,175,22,124
2020-05-10,0,0,0,0,FR_OCC_12,175,22,124
2020-05-11,0,0,0,0,FR_OCC_12,175,22,124
2020-05-12,0,0,0,1,FR_OCC_12,175,22,125
2020-05-13,1,0,0,0,FR_OCC_12,176,22,125
2020-05-14,0,0,1,2,FR_OCC_12,176,23,127
2020-05-15,0,0,0,0,FR_OCC_12,176,23,127
2020-05-16,0,0,0,4,FR_OCC_12,176,23,131
2020-05-17,0,0,0,0,FR_OCC_12,176,23,131
2020-05-18,0,0,0,0,FR_OCC_12,176,23,131
2020-05-19,0,0,0,0,FR_OCC_12,176,23,131
2020-05-20,0,0,0,0,FR_OCC_12,176,23,131
2020-05-21,0,0,0,0,FR_OCC_12,176,23,131
2020-05-22,1,0,0,4,FR_OCC_12,177,23,135
2020-05-23,0,0,0,0,FR_OCC_12,177,23,135
2020-05-24,0,0,0,0,FR_OCC_12,177,23,135
2020-05-25,0,0,0,0,FR_OCC_12,177,23,135
2020-05-26,0,0,0,0,FR_OCC_12,177,23,135
2020-05-27,0,0,0,0,FR_OCC_12,177,23,135
2020-05-28,0,0,1,1,FR_OCC_12,177,24,136
2020-05-29,0,0,0,0,FR_OCC_12,177,24,136
2020-05-30,0,0,0,4,FR_OCC_12,177,24,140
2020-05-31,0,0,0,0,FR_OCC_12,177,24,140
2020-06-01,0,0,0,0,FR_OCC_12,177,24,140
2020-06-02,0,0,0,0,FR_OCC_12,177,24,140
2020-06-03,0,0,0,0,FR_OCC_12,177,24,140
2020-06-04,0,0,0,0,FR_OCC_12,177,24,140
2020-06-05,0,0,0,0,FR_OCC_12,177,24,140
2020-06-06,0,0,0,0,FR_OCC_12,177,24,140
2020-06-07,0,0,0,0,FR_OCC_12,177,24,140
2020-06-08,0,0,0,0,FR_OCC_12,177,24,140
2020-06-09,0,0,0,0,FR_OCC_12,177,24,140
2020-06-10,0,0,0,0,FR_OCC_12,177,24,140
2020-06-11,0,0,0,1,FR_OCC_12,177,24,141
2020-06-12,0,0,0,0,FR_OCC_12,177,24,141
2020-06-13,0,0,0,0,FR_OCC_12,177,24,141
2020-06-14,0,0,0,0,FR_OCC_12,177,24,141
2020-06-15,0,0,0,5,FR_OCC_12,177,24,146
2020-06-16,0,0,0,0,FR_OCC_12,177,24,146
2020-06-17,0,0,0,0,FR_OCC_12,177,24,146
2020-06-18,0,0,0,0,FR_OCC_12,177,24,146
2020-06-19,0,0,0,0,FR_OCC_12,177,24,146
2020-06-20,0,0,0,0,FR_OCC_12,177,24,146
2020-06-21,0,0,0,0,FR_OCC_12,177,24,146
2020-06-22,0,0,0,0,FR_OCC_12,177,24,146
2020-06-23,0,0,0,0,FR_OCC_12,177,24,146
2020-06-24,0,0,0,0,FR_OCC_12,177,24,146
2020-03-19,90,17,0,43,FR_PAC_13,90,0,43
2020-03-20,44,5,0,7,FR_PAC_13,134,0,50
2020-03-21,63,12,0,21,FR_PAC_13,197,0,71
2020-03-22,48,1,0,11,FR_PAC_13,245,0,82
2020-03-23,80,15,0,30,FR_PAC_13,325,0,112
2020-03-24,94,20,3,30,FR_PAC_13,419,3,142
2020-03-25,80,5,5,65,FR_PAC_13,499,8,207
2020-03-26,114,20,4,53,FR_PAC_13,613,12,260
2020-03-27,136,16,4,38,FR_PAC_13,749,16,298
2020-03-28,107,15,3,27,FR_PAC_13,856,19,325
2020-03-29,117,25,7,6,FR_PAC_13,973,26,331
2020-03-30,138,34,5,22,FR_PAC_13,1111,31,353
2020-03-31,166,22,12,101,FR_PAC_13,1277,43,454
2020-04-01,140,28,8,94,FR_PAC_13,1417,51,548
2020-04-02,106,21,10,33,FR_PAC_13,1523,61,581
2020-04-03,160,29,14,67,FR_PAC_13,1683,75,648
2020-04-04,98,15,11,62,FR_PAC_13,1781,86,710
2020-04-05,77,10,6,19,FR_PAC_13,1858,92,729
2020-04-06,149,18,25,45,FR_PAC_13,2007,117,774
2020-04-07,67,10,16,138,FR_PAC_13,2074,133,912
2020-04-08,136,19,8,71,FR_PAC_13,2210,141,983
2020-04-09,75,10,10,120,FR_PAC_13,2285,151,1103
2020-04-10,127,30,6,62,FR_PAC_13,2412,157,1165
2020-04-11,47,9,13,56,FR_PAC_13,2459,170,1221
2020-04-12,84,8,2,11,FR_PAC_13,2543,172,1232
2020-04-13,41,8,7,16,FR_PAC_13,2584,179,1248
2020-04-14,96,12,17,74,FR_PAC_13,2680,196,1322
2020-04-15,86,15,10,60,FR_PAC_13,2766,206,1382
2020-04-16,86,17,19,76,FR_PAC_13,2852,225,1458
2020-04-17,119,13,11,67,FR_PAC_13,2971,236,1525
2020-04-18,60,9,9,85,FR_PAC_13,3031,245,1610
2020-04-19,27,6,6,82,FR_PAC_13,3058,251,1692
2020-04-20,84,21,19,55,FR_PAC_13,3142,270,1747
2020-04-21,106,7,20,82,FR_PAC_13,3248,290,1829
2020-04-22,114,7,30,84,FR_PAC_13,3362,320,1913
2020-04-23,68,13,9,56,FR_PAC_13,3430,329,1969
2020-04-24,80,17,25,82,FR_PAC_13,3510,354,2051
2020-04-25,53,5,9,68,FR_PAC_13,3563,363,2119
2020-04-26,32,4,4,5,FR_PAC_13,3595,367,2124
2020-04-27,58,9,15,33,FR_PAC_13,3653,382,2157
2020-04-28,54,7,11,76,FR_PAC_13,3707,393,2233
2020-04-29,62,8,8,51,FR_PAC_13,3769,401,2284
2020-04-30,29,6,9,63,FR_PAC_13,3798,410,2347
2020-05-01,32,1,6,32,FR_PAC_13,3830,416,2379
2020-05-02,34,0,2,12,FR_PAC_13,3864,418,2391
2020-05-03,21,4,5,11,FR_PAC_13,3885,423,2402
2020-05-04,33,4,8,48,FR_PAC_13,3918,431,2450
2020-05-05,25,3,9,54,FR_PAC_13,3943,440,2504
2020-05-06,39,2,3,42,FR_PAC_13,3982,443,2546
2020-05-07,24,6,5,48,FR_PAC_13,4006,448,2594
2020-05-08,18,3,1,28,FR_PAC_13,4024,449,2622
2020-05-09,10,0,3,7,FR_PAC_13,4034,452,2629
2020-05-10,12,7,4,7,FR_PAC_13,4046,456,2636
2020-05-11,34,10,11,19,FR_PAC_13,4080,467,2655
2020-05-12,15,4,5,25,FR_PAC_13,4095,472,2680
2020-05-13,22,5,6,27,FR_PAC_13,4117,478,2707
2020-05-14,16,3,5,29,FR_PAC_13,4133,483,2736
2020-05-15,22,3,5,39,FR_PAC_13,4155,488,2775
2020-05-16,11,3,4,12,FR_PAC_13,4166,492,2787
2020-05-17,11,1,2,3,FR_PAC_13,4177,494,2790
2020-05-18,12,2,5,7,FR_PAC_13,4189,499,2797
2020-05-19,18,1,2,23,FR_PAC_13,4207,501,2820
2020-05-20,17,1,7,48,FR_PAC_13,4224,508,2868
2020-05-21,13,0,6,17,FR_PAC_13,4237,514,2885
2020-05-22,2,2,3,13,FR_PAC_13,4239,517,2898
2020-05-23,12,1,1,11,FR_PAC_13,4251,518,2909
2020-05-24,4,0,1,2,FR_PAC_13,4255,519,2911
2020-05-25,11,3,4,23,FR_PAC_13,4266,523,2934
2020-05-26,10,2,3,27,FR_PAC_13,4276,526,2961
2020-05-27,7,2,0,18,FR_PAC_13,4283,526,2979
2020-05-28,4,2,2,19,FR_PAC_13,4287,528,2998
2020-05-29,8,1,3,29,FR_PAC_13,4295,531,3027
2020-05-30,5,0,0,2,FR_PAC_13,4300,531,3029
2020-05-31,5,0,0,2,FR_PAC_13,4305,531,3031
2020-06-01,1,0,0,4,FR_PAC_13,4306,531,3035
2020-06-02,8,0,4,12,FR_PAC_13,4314,535,3047
2020-06-03,10,1,2,21,FR_PAC_13,4324,537,3068
2020-06-04,8,1,0,34,FR_PAC_13,4332,537,3102
2020-06-05,19,2,1,20,FR_PAC_13,4351,538,3122
2020-06-06,6,0,0,6,FR_PAC_13,4357,538,3128
2020-06-07,1,0,0,2,FR_PAC_13,4358,538,3130
2020-06-08,7,3,4,11,FR_PAC_13,4365,542,3141
2020-06-09,5,0,2,5,FR_PAC_13,4370,544,3146
2020-06-10,6,0,1,15,FR_PAC_13,4376,545,3161
2020-06-11,3,0,1,7,FR_PAC_13,4379,546,3168
2020-06-12,3,0,0,9,FR_PAC_13,4382,546,3177
2020-06-13,8,0,0,4,FR_PAC_13,4390,546,3181
2020-06-14,1,0,0,2,FR_PAC_13,4391,546,3183
2020-06-15,4,0,1,1,FR_PAC_13,4395,547,3184
2020-06-16,4,1,1,15,FR_PAC_13,4399,548,3199
2020-06-17,1,0,0,5,FR_PAC_13,4400,548,3204
2020-06-18,2,2,2,8,FR_PAC_13,4402,550,3212
2020-06-19,2,1,1,9,FR_PAC_13,4404,551,3221
2020-06-20,1,1,1,7,FR_PAC_13,4405,552,3228
2020-06-21,0,0,0,2,FR_PAC_13,4405,552,3230
2020-06-22,2,1,1,8,FR_PAC_13,4407,553,3238
2020-06-23,4,0,3,9,FR_PAC_13,4411,556,3247
2020-06-24,4,1,1,33,FR_PAC_13,4415,557,3280
2020-03-19,3,0,0,1,FR_NOR_14,3,0,1
2020-03-20,1,0,1,2,FR_NOR_14,4,1,3
2020-03-21,6,3,0,1,FR_NOR_14,10,1,4
2020-03-22,10,2,0,0,FR_NOR_14,20,1,4
2020-03-23,11,2,0,2,FR_NOR_14,31,1,6
2020-03-24,5,4,0,2,FR_NOR_14,36,1,8
2020-03-25,17,4,0,1,FR_NOR_14,53,1,9
2020-03-26,9,3,0,4,FR_NOR_14,62,1,13
2020-03-27,16,5,1,1,FR_NOR_14,78,2,14
2020-03-28,22,7,0,4,FR_NOR_14,100,2,18
2020-03-29,16,4,0,1,FR_NOR_14,116,2,19
2020-03-30,7,1,5,1,FR_NOR_14,123,7,20
2020-03-31,11,6,0,4,FR_NOR_14,134,7,24
2020-04-01,25,7,1,7,FR_NOR_14,159,8,31
2020-04-02,19,8,1,0,FR_NOR_14,178,9,31
2020-04-03,11,6,2,8,FR_NOR_14,189,11,39
2020-04-04,10,5,2,14,FR_NOR_14,199,13,53
2020-04-05,14,3,3,1,FR_NOR_14,213,16,54
2020-04-06,19,5,7,7,FR_NOR_14,232,23,61
2020-04-07,16,1,3,6,FR_NOR_14,248,26,67
2020-04-08,13,3,3,4,FR_NOR_14,261,29,71
2020-04-09,7,2,2,5,FR_NOR_14,268,31,76
2020-04-10,13,1,1,1,FR_NOR_14,281,32,77
2020-04-11,10,1,2,10,FR_NOR_14,291,34,87
2020-04-12,8,0,2,8,FR_NOR_14,299,36,95
2020-04-13,2,0,1,4,FR_NOR_14,301,37,99
2020-04-14,7,0,5,5,FR_NOR_14,308,42,104
2020-04-15,9,1,5,6,FR_NOR_14,317,47,110
2020-04-16,4,4,1,8,FR_NOR_14,321,48,118
2020-04-17,7,2,2,10,FR_NOR_14,328,50,128
2020-04-18,8,0,0,9,FR_NOR_14,336,50,137
2020-04-19,9,2,1,1,FR_NOR_14,345,51,138
2020-04-20,2,0,1,1,FR_NOR_14,347,52,139
2020-04-21,11,1,1,8,FR_NOR_14,358,53,147
2020-04-22,3,1,0,4,FR_NOR_14,361,53,151
2020-04-23,2,1,1,4,FR_NOR_14,363,54,155
2020-04-24,11,1,1,3,FR_NOR_14,374,55,158
2020-04-25,1,0,1,0,FR_NOR_14,375,56,158
2020-04-26,1,1,0,0,FR_NOR_14,376,56,158
2020-04-27,1,0,0,1,FR_NOR_14,377,56,159
2020-04-28,7,1,2,7,FR_NOR_14,384,58,166
2020-04-29,10,0,2,11,FR_NOR_14,394,60,177
2020-04-30,1,0,1,2,FR_NOR_14,395,61,179
2020-05-01,6,1,0,5,FR_NOR_14,401,61,184
2020-05-02,4,0,2,1,FR_NOR_14,405,63,185
2020-05-03,1,0,0,0,FR_NOR_14,406,63,185
2020-05-04,4,0,1,1,FR_NOR_14,410,64,186
2020-05-05,10,0,0,7,FR_NOR_14,420,64,193
2020-05-06,3,0,0,3,FR_NOR_14,423,64,196
2020-05-07,4,0,1,6,FR_NOR_14,427,65,202
2020-05-08,3,0,2,4,FR_NOR_14,430,67,206
2020-05-09,2,0,0,0,FR_NOR_14,432,67,206
2020-05-10,1,1,0,0,FR_NOR_14,433,67,206
2020-05-11,1,0,3,1,FR_NOR_14,434,70,207
2020-05-12,6,0,2,5,FR_NOR_14,440,72,212
2020-05-13,2,1,2,5,FR_NOR_14,442,74,217
2020-05-14,2,0,0,4,FR_NOR_14,444,74,221
2020-05-15,4,0,0,9,FR_NOR_14,448,74,230
2020-05-16,4,0,0,5,FR_NOR_14,452,74,235
2020-05-17,1,0,0,0,FR_NOR_14,453,74,235
2020-05-18,0,1,1,5,FR_NOR_14,453,75,240
2020-05-19,5,0,1,4,FR_NOR_14,458,76,244
2020-05-20,1,0,0,3,FR_NOR_14,459,76,247
2020-05-21,1,0,2,5,FR_NOR_14,460,78,252
2020-05-22,2,0,0,5,FR_NOR_14,462,78,257
2020-05-23,1,0,1,1,FR_NOR_14,463,79,258
2020-05-24,2,1,0,0,FR_NOR_14,465,79,258
2020-05-25,3,0,2,0,FR_NOR_14,468,81,258
2020-05-26,1,0,1,3,FR_NOR_14,469,82,261
2020-05-27,0,0,0,23,FR_NOR_14,469,82,284
2020-05-28,0,0,0,2,FR_NOR_14,469,82,286
2020-05-29,0,0,1,6,FR_NOR_14,469,83,292
2020-05-30,0,0,0,1,FR_NOR_14,469,83,293
2020-05-31,0,0,0,0,FR_NOR_14,469,83,293
2020-06-01,0,0,0,0,FR_NOR_14,469,83,293
2020-06-02,0,0,0,1,FR_NOR_14,469,83,294
2020-06-03,0,0,0,2,FR_NOR_14,469,83,296
2020-06-04,0,0,0,1,FR_NOR_14,469,83,297
2020-06-05,0,0,0,0,FR_NOR_14,469,83,297
2020-06-06,0,0,0,0,FR_NOR_14,469,83,297
2020-06-07,0,0,1,0,FR_NOR_14,469,84,297
2020-06-08,0,0,0,0,FR_NOR_14,469,84,297
2020-06-09,1,0,0,0,FR_NOR_14,470,84,297
2020-06-10,0,0,0,2,FR_NOR_14,470,84,299
2020-06-11,0,0,0,1,FR_NOR_14,470,84,300
2020-06-12,1,0,0,9,FR_NOR_14,471,84,309
2020-06-13,0,0,0,0,FR_NOR_14,471,84,309
2020-06-14,0,0,0,1,FR_NOR_14,471,84,310
2020-06-15,0,0,0,1,FR_NOR_14,471,84,311
2020-06-16,1,0,0,1,FR_NOR_14,472,84,312
2020-06-17,0,0,0,0,FR_NOR_14,472,84,312
2020-06-18,1,0,0,0,FR_NOR_14,473,84,312
2020-06-19,0,0,0,0,FR_NOR_14,473,84,312
2020-06-20,0,0,0,12,FR_NOR_14,473,84,324
2020-06-21,0,0,0,0,FR_NOR_14,473,84,324
2020-06-22,0,0,0,0,FR_NOR_14,473,84,324
2020-06-23,0,0,0,3,FR_NOR_14,473,84,327
2020-06-24,1,0,0,3,FR_NOR_14,474,84,330
2020-03-19,1,0,0,0,FR_ARA_15,1,0,0
2020-03-20,1,0,0,0,FR_ARA_15,2,0,0
2020-03-21,1,0,0,0,FR_ARA_15,3,0,0
2020-03-22,0,1,0,0,FR_ARA_15,3,0,0
2020-03-23,0,0,0,0,FR_ARA_15,3,0,0
2020-03-24,2,1,0,0,FR_ARA_15,5,0,0
2020-03-25,1,1,0,1,FR_ARA_15,6,0,1
2020-03-26,0,0,0,1,FR_ARA_15,6,0,2
2020-03-27,1,0,0,0,FR_ARA_15,7,0,2
2020-03-28,1,0,0,0,FR_ARA_15,8,0,2
2020-03-29,0,0,0,0,FR_ARA_15,8,0,2
2020-03-30,3,0,0,0,FR_ARA_15,11,0,2
2020-03-31,3,1,0,0,FR_ARA_15,14,0,2
2020-04-01,1,1,0,1,FR_ARA_15,15,0,3
2020-04-02,9,1,0,1,FR_ARA_15,24,0,4
2020-04-03,3,2,0,0,FR_ARA_15,27,0,4
2020-04-04,1,0,0,0,FR_ARA_15,28,0,4
2020-04-05,2,1,0,0,FR_ARA_15,30,0,4
2020-04-06,2,0,0,0,FR_ARA_15,32,0,4
2020-04-07,0,1,0,3,FR_ARA_15,32,0,7
2020-04-08,2,1,0,2,FR_ARA_15,34,0,9
2020-04-09,2,0,0,1,FR_ARA_15,36,0,10
2020-04-10,0,0,0,0,FR_ARA_15,36,0,10
2020-04-11,0,0,0,0,FR_ARA_15,36,0,10
2020-04-12,1,0,0,0,FR_ARA_15,37,0,10
2020-04-13,1,0,0,0,FR_ARA_15,38,0,10
2020-04-14,1,2,0,1,FR_ARA_15,39,0,11
2020-04-15,1,0,0,2,FR_ARA_15,40,0,13
2020-04-16,1,1,0,1,FR_ARA_15,41,0,14
2020-04-17,1,0,0,5,FR_ARA_15,42,0,19
2020-04-18,0,0,0,1,FR_ARA_15,42,0,20
2020-04-19,5,0,0,0,FR_ARA_15,47,0,20
2020-04-20,1,1,0,0,FR_ARA_15,48,0,20
2020-04-21,3,0,1,0,FR_ARA_15,51,1,20
2020-04-22,1,0,0,2,FR_ARA_15,52,1,22
2020-04-23,1,0,3,1,FR_ARA_15,53,4,23
2020-04-24,0,0,1,3,FR_ARA_15,53,5,26
2020-04-25,0,0,0,0,FR_ARA_15,53,5,26
2020-04-26,0,0,0,0,FR_ARA_15,53,5,26
2020-04-27,6,0,1,0,FR_ARA_15,59,6,26
2020-04-28,3,0,0,2,FR_ARA_15,62,6,28
2020-04-29,0,0,0,0,FR_ARA_15,62,6,28
2020-04-30,0,1,0,0,FR_ARA_15,62,6,28
2020-05-01,0,0,0,0,FR_ARA_15,62,6,28
2020-05-02,1,0,0,0,FR_ARA_15,63,6,28
2020-05-03,0,0,0,0,FR_ARA_15,63,6,28
2020-05-04,1,0,2,2,FR_ARA_15,64,8,30
2020-05-05,2,1,1,0,FR_ARA_15,66,9,30
2020-05-06,0,0,0,3,FR_ARA_15,66,9,33
2020-05-07,0,0,1,1,FR_ARA_15,66,10,34
2020-05-08,0,0,0,2,FR_ARA_15,66,10,36
2020-05-09,0,0,0,0,FR_ARA_15,66,10,36
2020-05-10,0,0,0,0,FR_ARA_15,66,10,36
2020-05-11,0,0,0,0,FR_ARA_15,66,10,36
2020-05-12,2,0,0,1,FR_ARA_15,68,10,37
2020-05-13,1,1,0,1,FR_ARA_15,69,10,38
2020-05-14,0,0,0,0,FR_ARA_15,69,10,38
2020-05-15,0,0,0,2,FR_ARA_15,69,10,40
2020-05-16,1,0,0,0,FR_ARA_15,70,10,40
2020-05-17,0,0,0,0,FR_ARA_15,70,10,40
2020-05-18,0,0,0,0,FR_ARA_15,70,10,40
2020-05-19,0,0,0,0,FR_ARA_15,70,10,40
2020-05-20,0,0,0,1,FR_ARA_15,70,10,41
2020-05-21,0,0,0,0,FR_ARA_15,70,10,41
2020-05-22,0,0,0,0,FR_ARA_15,70,10,41
2020-05-23,0,0,0,0,FR_ARA_15,70,10,41
2020-05-24,0,0,0,0,FR_ARA_15,70,10,41
2020-05-25,1,1,0,0,FR_ARA_15,71,10,41
2020-05-26,0,0,0,2,FR_ARA_15,71,10,43
2020-05-27,0,0,0,0,FR_ARA_15,71,10,43
2020-05-28,0,0,0,0,FR_ARA_15,71,10,43
2020-05-29,0,0,0,0,FR_ARA_15,71,10,43
2020-05-30,0,0,0,1,FR_ARA_15,71,10,44
2020-05-31,0,0,0,0,FR_ARA_15,71,10,44
2020-06-01,0,0,0,0,FR_ARA_15,71,10,44
2020-06-02,0,0,0,0,FR_ARA_15,71,10,44
2020-06-03,0,0,0,0,FR_ARA_15,71,10,44
2020-06-04,0,0,0,1,FR_ARA_15,71,10,45
2020-06-05,0,0,0,0,FR_ARA_15,71,10,45
2020-06-06,0,0,0,0,FR_ARA_15,71,10,45
2020-06-07,0,0,0,0,FR_ARA_15,71,10,45
2020-06-08,0,0,0,0,FR_ARA_15,71,10,45
2020-06-09,0,0,0,0,FR_ARA_15,71,10,45
2020-06-10,0,0,0,6,FR_ARA_15,71,10,51
2020-06-11,0,0,0,0,FR_ARA_15,71,10,51
2020-06-12,1,0,0,0,FR_ARA_15,72,10,51
2020-06-13,1,0,0,0,FR_ARA_15,73,10,51
2020-06-14,0,0,0,0,FR_ARA_15,73,10,51
2020-06-15,0,0,0,0,FR_ARA_15,73,10,51
2020-06-16,0,0,0,0,FR_ARA_15,73,10,51
2020-06-17,0,0,0,0,FR_ARA_15,73,10,51
2020-06-18,0,0,0,0,FR_ARA_15,73,10,51
2020-06-19,0,0,0,0,FR_ARA_15,73,10,51
2020-06-20,0,0,0,0,FR_ARA_15,73,10,51
2020-06-21,0,0,0,0,FR_ARA_15,73,10,51
2020-06-22,0,0,0,0,FR_ARA_15,73,10,51
2020-06-23,0,0,0,0,FR_ARA_15,73,10,51
2020-06-24,0,0,0,0,FR_ARA_15,73,10,51
2020-03-19,1,0,0,2,FR_NAQ_16,1,0,2
2020-03-20,1,0,0,0,FR_NAQ_16,2,0,2
2020-03-21,2,1,0,0,FR_NAQ_16,4,0,2
2020-03-22,3,2,1,0,FR_NAQ_16,7,1,2
2020-03-23,2,2,0,0,FR_NAQ_16,9,1,2
2020-03-24,8,0,1,0,FR_NAQ_16,17,2,2
2020-03-25,12,1,2,0,FR_NAQ_16,29,4,2
2020-03-26,5,0,0,4,FR_NAQ_16,34,4,6
2020-03-27,10,2,0,2,FR_NAQ_16,44,4,8
2020-03-28,2,1,2,4,FR_NAQ_16,46,6,12
2020-03-29,10,2,1,1,FR_NAQ_16,56,7,13
2020-03-30,6,0,2,0,FR_NAQ_16,62,9,13
2020-03-31,4,0,1,6,FR_NAQ_16,66,10,19
2020-04-01,6,1,0,2,FR_NAQ_16,72,10,21
2020-04-02,4,1,1,2,FR_NAQ_16,76,11,23
2020-04-03,4,1,0,4,FR_NAQ_16,80,11,27
2020-04-04,1,1,0,1,FR_NAQ_16,81,11,28
2020-04-05,3,0,2,1,FR_NAQ_16,84,13,29
2020-04-06,0,0,1,1,FR_NAQ_16,84,14,30
2020-04-07,0,0,1,2,FR_NAQ_16,84,15,32
2020-04-08,3,1,1,2,FR_NAQ_16,87,16,34
2020-04-09,0,0,0,0,FR_NAQ_16,87,16,34
2020-04-10,1,1,0,2,FR_NAQ_16,88,16,36
2020-04-11,0,0,0,0,FR_NAQ_16,88,16,36
2020-04-12,1,0,0,1,FR_NAQ_16,89,16,37
2020-04-13,0,0,0,0,FR_NAQ_16,89,16,37
2020-04-14,0,0,0,0,FR_NAQ_16,89,16,37
2020-04-15,0,0,1,0,FR_NAQ_16,89,17,37
2020-04-16,0,0,0,2,FR_NAQ_16,89,17,39
2020-04-17,1,0,0,0,FR_NAQ_16,90,17,39
2020-04-18,0,0,0,1,FR_NAQ_16,90,17,40
2020-04-19,2,0,0,0,FR_NAQ_16,92,17,40
2020-04-20,0,0,1,0,FR_NAQ_16,92,18,40
2020-04-21,0,0,0,0,FR_NAQ_16,92,18,40
2020-04-22,0,0,0,2,FR_NAQ_16,92,18,42
2020-04-23,0,0,0,0,FR_NAQ_16,92,18,42
2020-04-24,0,0,0,1,FR_NAQ_16,92,18,43
2020-04-25,0,0,0,0,FR_NAQ_16,92,18,43
2020-04-26,0,0,0,0,FR_NAQ_16,92,18,43
2020-04-27,0,0,0,0,FR_NAQ_16,92,18,43
2020-04-28,0,0,1,0,FR_NAQ_16,92,19,43
2020-04-29,0,0,0,0,FR_NAQ_16,92,19,43
2020-04-30,0,0,0,4,FR_NAQ_16,92,19,47
2020-05-01,1,0,0,0,FR_NAQ_16,93,19,47
2020-05-02,0,0,0,0,FR_NAQ_16,93,19,47
2020-05-03,0,0,1,1,FR_NAQ_16,93,20,48
2020-05-04,1,1,0,0,FR_NAQ_16,94,20,48
2020-05-05,0,0,0,0,FR_NAQ_16,94,20,48
2020-05-06,0,0,0,1,FR_NAQ_16,94,20,49
2020-05-07,0,0,0,0,FR_NAQ_16,94,20,49
2020-05-08,0,0,0,0,FR_NAQ_16,94,20,49
2020-05-09,0,0,0,0,FR_NAQ_16,94,20,49
2020-05-10,0,0,0,0,FR_NAQ_16,94,20,49
2020-05-11,0,0,0,0,FR_NAQ_16,94,20,49
2020-05-12,0,0,0,0,FR_NAQ_16,94,20,49
2020-05-13,4,1,0,0,FR_NAQ_16,98,20,49
2020-05-14,0,0,0,0,FR_NAQ_16,98,20,49
2020-05-15,0,0,0,0,FR_NAQ_16,98,20,49
2020-05-16,0,0,0,0,FR_NAQ_16,98,20,49
2020-05-17,0,0,0,1,FR_NAQ_16,98,20,50
2020-05-18,1,0,0,0,FR_NAQ_16,99,20,50
2020-05-19,1,0,0,3,FR_NAQ_16,100,20,53
2020-05-20,0,0,0,0,FR_NAQ_16,100,20,53
2020-05-21,0,0,0,0,FR_NAQ_16,100,20,53
2020-05-22,0,0,0,0,FR_NAQ_16,100,20,53
2020-05-23,1,0,0,0,FR_NAQ_16,101,20,53
2020-05-24,2,0,0,0,FR_NAQ_16,103,20,53
2020-05-25,1,0,0,1,FR_NAQ_16,104,20,54
2020-05-26,1,0,0,2,FR_NAQ_16,105,20,56
2020-05-27,0,0,0,0,FR_NAQ_16,105,20,56
2020-05-28,0,0,0,1,FR_NAQ_16,105,20,57
2020-05-29,0,0,0,0,FR_NAQ_16,105,20,57
2020-05-30,0,0,0,0,FR_NAQ_16,105,20,57
2020-05-31,0,0,0,0,FR_NAQ_16,105,20,57
2020-06-01,0,0,0,0,FR_NAQ_16,105,20,57
2020-06-02,0,0,0,0,FR_NAQ_16,105,20,57
2020-06-03,0,0,0,0,FR_NAQ_16,105,20,57
2020-06-04,0,0,0,0,FR_NAQ_16,105,20,57
2020-06-05,0,0,0,0,FR_NAQ_16,105,20,57
2020-06-06,0,0,0,0,FR_NAQ_16,105,20,57
2020-06-07,3,0,0,3,FR_NAQ_16,108,20,60
2020-06-08,0,0,0,0,FR_NAQ_16,108,20,60
2020-06-09,0,0,0,0,FR_NAQ_16,108,20,60
2020-06-10,0,0,0,0,FR_NAQ_16,108,20,60
2020-06-11,0,0,1,1,FR_NAQ_16,108,21,61
2020-06-12,0,0,0,0,FR_NAQ_16,108,21,61
2020-06-13,0,0,0,0,FR_NAQ_16,108,21,61
2020-06-14,0,0,0,0,FR_NAQ_16,108,21,61
2020-06-15,0,0,0,0,FR_NAQ_16,108,21,61
2020-06-16,0,0,0,0,FR_NAQ_16,108,21,61
2020-06-17,0,0,0,0,FR_NAQ_16,108,21,61
2020-06-18,0,0,0,0,FR_NAQ_16,108,21,61
2020-06-19,0,0,0,0,FR_NAQ_16,108,21,61
2020-06-20,0,0,0,0,FR_NAQ_16,108,21,61
2020-06-21,0,0,0,0,FR_NAQ_16,108,21,61
2020-06-22,0,0,0,0,FR_NAQ_16,108,21,61
2020-06-23,0,0,0,2,FR_NAQ_16,108,21,63
2020-06-24,0,0,0,0,FR_NAQ_16,108,21,63
2020-03-19,2,0,0,0,FR_NAQ_17,2,0,0
2020-03-20,2,1,0,0,FR_NAQ_17,4,0,0
2020-03-21,4,2,0,2,FR_NAQ_17,8,0,2
2020-03-22,2,1,0,1,FR_NAQ_17,10,0,3
2020-03-23,2,1,0,1,FR_NAQ_17,12,0,4
2020-03-24,14,0,0,0,FR_NAQ_17,26,0,4
2020-03-25,11,1,0,1,FR_NAQ_17,37,0,5
2020-03-26,28,7,0,8,FR_NAQ_17,65,0,13
2020-03-27,9,2,0,1,FR_NAQ_17,74,0,14
2020-03-28,9,4,1,3,FR_NAQ_17,83,1,17
2020-03-29,11,5,2,1,FR_NAQ_17,94,3,18
2020-03-30,16,2,3,1,FR_NAQ_17,110,6,19
2020-03-31,8,2,3,6,FR_NAQ_17,118,9,25
2020-04-01,18,2,1,4,FR_NAQ_17,136,10,29
2020-04-02,10,2,1,2,FR_NAQ_17,146,11,31
2020-04-03,11,0,0,0,FR_NAQ_17,157,11,31
2020-04-04,8,0,0,4,FR_NAQ_17,165,11,35
2020-04-05,7,2,2,3,FR_NAQ_17,172,13,38
2020-04-06,6,1,2,2,FR_NAQ_17,178,15,40
2020-04-07,17,1,4,5,FR_NAQ_17,195,19,45
2020-04-08,22,2,2,8,FR_NAQ_17,217,21,53
2020-04-09,7,0,0,5,FR_NAQ_17,224,21,58
2020-04-10,5,1,0,3,FR_NAQ_17,229,21,61
2020-04-11,7,0,1,2,FR_NAQ_17,236,22,63
2020-04-12,8,0,1,0,FR_NAQ_17,244,23,63
2020-04-13,7,0,0,1,FR_NAQ_17,251,23,64
2020-04-14,13,1,2,2,FR_NAQ_17,264,25,66
2020-04-15,7,2,2,4,FR_NAQ_17,271,27,70
2020-04-16,2,0,0,3,FR_NAQ_17,273,27,73
2020-04-17,3,1,1,1,FR_NAQ_17,276,28,74
2020-04-18,6,2,0,4,FR_NAQ_17,282,28,78
2020-04-19,0,0,1,0,FR_NAQ_17,282,29,78
2020-04-20,3,0,3,1,FR_NAQ_17,285,32,79
2020-04-21,3,0,0,3,FR_NAQ_17,288,32,82
2020-04-22,1,0,1,0,FR_NAQ_17,289,33,82
2020-04-23,5,0,1,4,FR_NAQ_17,294,34,86
2020-04-24,0,0,3,2,FR_NAQ_17,294,37,88
2020-04-25,0,0,0,1,FR_NAQ_17,294,37,89
2020-04-26,0,0,3,1,FR_NAQ_17,294,40,90
2020-04-27,4,1,1,0,FR_NAQ_17,298,41,90
2020-04-28,0,0,0,3,FR_NAQ_17,298,41,93
2020-04-29,0,0,0,1,FR_NAQ_17,298,41,94
2020-04-30,2,1,2,6,FR_NAQ_17,300,43,100
2020-05-01,0,0,0,1,FR_NAQ_17,300,43,101
2020-05-02,1,0,0,2,FR_NAQ_17,301,43,103
2020-05-03,0,0,0,0,FR_NAQ_17,301,43,103
2020-05-04,0,0,0,1,FR_NAQ_17,301,43,104
2020-05-05,0,0,0,1,FR_NAQ_17,301,43,105
2020-05-06,1,0,0,4,FR_NAQ_17,302,43,109
2020-05-07,2,1,1,4,FR_NAQ_17,304,44,113
2020-05-08,0,0,0,1,FR_NAQ_17,304,44,114
2020-05-09,0,0,0,0,FR_NAQ_17,304,44,114
2020-05-10,1,0,0,0,FR_NAQ_17,305,44,114
2020-05-11,0,0,0,1,FR_NAQ_17,305,44,115
2020-05-12,0,0,0,3,FR_NAQ_17,305,44,118
2020-05-13,0,0,0,0,FR_NAQ_17,305,44,118
2020-05-14,0,0,1,2,FR_NAQ_17,305,45,120
2020-05-15,0,0,0,3,FR_NAQ_17,305,45,123
2020-05-16,0,0,0,1,FR_NAQ_17,305,45,124
2020-05-17,0,0,0,1,FR_NAQ_17,305,45,125
2020-05-18,0,0,0,0,FR_NAQ_17,305,45,125
2020-05-19,1,0,0,2,FR_NAQ_17,306,45,127
2020-05-20,0,0,1,1,FR_NAQ_17,306,46,128
2020-05-21,0,0,0,0,FR_NAQ_17,306,46,128
2020-05-22,0,0,0,0,FR_NAQ_17,306,46,128
2020-05-23,0,0,0,1,FR_NAQ_17,306,46,129
2020-05-24,0,0,0,0,FR_NAQ_17,306,46,129
2020-05-25,0,0,0,1,FR_NAQ_17,306,46,130
2020-05-26,0,0,1,0,FR_NAQ_17,306,47,130
2020-05-27,0,0,1,1,FR_NAQ_17,306,48,131
2020-05-28,0,0,0,0,FR_NAQ_17,306,48,131
2020-05-29,0,0,0,4,FR_NAQ_17,306,48,135
2020-05-30,0,0,0,0,FR_NAQ_17,306,48,135
2020-05-31,0,0,0,0,FR_NAQ_17,306,48,135
2020-06-01,0,0,0,0,FR_NAQ_17,306,48,135
2020-06-02,0,0,0,0,FR_NAQ_17,306,48,135
2020-06-03,0,0,0,2,FR_NAQ_17,306,48,137
2020-06-04,0,0,0,0,FR_NAQ_17,306,48,137
2020-06-05,1,0,0,1,FR_NAQ_17,307,48,138
2020-06-06,0,0,0,0,FR_NAQ_17,307,48,138
2020-06-07,0,0,0,0,FR_NAQ_17,307,48,138
2020-06-08,0,0,0,0,FR_NAQ_17,307,48,138
2020-06-09,0,0,0,0,FR_NAQ_17,307,48,138
2020-06-10,0,0,0,0,FR_NAQ_17,307,48,138
2020-06-11,0,0,0,0,FR_NAQ_17,307,48,138
2020-06-12,0,0,1,0,FR_NAQ_17,307,49,138
2020-06-13,0,0,0,0,FR_NAQ_17,307,49,138
2020-06-14,0,0,0,0,FR_NAQ_17,307,49,138
2020-06-15,0,0,0,1,FR_NAQ_17,307,49,139
2020-06-16,1,0,0,1,FR_NAQ_17,308,49,140
2020-06-17,0,0,0,0,FR_NAQ_17,308,49,140
2020-06-18,0,0,1,3,FR_NAQ_17,308,50,143
2020-06-19,0,0,0,1,FR_NAQ_17,308,50,144
2020-06-20,0,0,0,1,FR_NAQ_17,308,50,145
2020-06-21,0,0,0,0,FR_NAQ_17,308,50,145
2020-06-22,0,0,0,0,FR_NAQ_17,308,50,145
2020-06-23,0,0,0,0,FR_NAQ_17,308,50,145
2020-06-24,0,0,0,3,FR_NAQ_17,308,50,148
2020-03-19,0,0,0,0,FR_CVL_18,0,0,0
2020-03-20,0,0,0,0,FR_CVL_18,0,0,0
2020-03-21,0,0,0,0,FR_CVL_18,0,0,0
2020-03-22,0,0,0,0,FR_CVL_18,0,0,0
2020-03-23,0,0,0,0,FR_CVL_18,0,0,0
2020-03-24,3,2,0,1,FR_CVL_18,3,0,1
2020-03-25,5,3,0,0,FR_CVL_18,8,0,1
2020-03-26,3,1,1,0,FR_CVL_18,11,1,1
2020-03-27,5,0,1,2,FR_CVL_18,16,2,3
2020-03-28,6,3,2,0,FR_CVL_18,22,4,3
2020-03-29,2,0,0,0,FR_CVL_18,24,4,3
2020-03-30,16,4,2,0,FR_CVL_18,40,6,3
2020-03-31,10,2,2,1,FR_CVL_18,50,8,4
2020-04-01,5,1,3,1,FR_CVL_18,55,11,5
2020-04-02,6,1,3,3,FR_CVL_18,61,14,8
2020-04-03,10,0,1,3,FR_CVL_18,71,15,11
2020-04-04,6,3,1,1,FR_CVL_18,77,16,12
2020-04-05,7,1,4,1,FR_CVL_18,84,20,13
2020-04-06,14,2,3,2,FR_CVL_18,98,23,15
2020-04-07,9,3,2,7,FR_CVL_18,107,25,22
2020-04-08,4,0,2,4,FR_CVL_18,111,27,26
2020-04-09,10,0,0,1,FR_CVL_18,121,27,27
2020-04-10,13,1,2,4,FR_CVL_18,134,29,31
2020-04-11,8,1,1,6,FR_CVL_18,142,30,37
2020-04-12,2,0,2,0,FR_CVL_18,144,32,37
2020-04-13,7,0,4,0,FR_CVL_18,151,36,37
2020-04-14,2,0,0,1,FR_CVL_18,153,36,38
2020-04-15,5,1,1,2,FR_CVL_18,158,37,40
2020-04-16,3,0,1,5,FR_CVL_18,161,38,45
2020-04-17,20,0,3,6,FR_CVL_18,181,41,51
2020-04-18,3,1,1,0,FR_CVL_18,184,42,51
2020-04-19,6,0,1,1,FR_CVL_18,190,43,52
2020-04-20,1,0,1,0,FR_CVL_18,191,44,52
2020-04-21,16,1,1,4,FR_CVL_18,207,45,56
2020-04-22,5,0,4,8,FR_CVL_18,212,49,64
2020-04-23,3,0,1,3,FR_CVL_18,215,50,67
2020-04-24,4,0,2,2,FR_CVL_18,219,52,69
2020-04-25,4,3,1,0,FR_CVL_18,223,53,69
2020-04-26,4,0,1,0,FR_CVL_18,227,54,69
2020-04-27,6,0,4,1,FR_CVL_18,233,58,70
2020-04-28,6,0,1,10,FR_CVL_18,239,59,80
2020-04-29,10,0,3,2,FR_CVL_18,249,62,82
2020-04-30,3,0,0,5,FR_CVL_18,252,62,87
2020-05-01,2,0,0,2,FR_CVL_18,254,62,89
2020-05-02,0,0,0,1,FR_CVL_18,254,62,90
2020-05-03,2,0,0,0,FR_CVL_18,256,62,90
2020-05-04,2,1,0,3,FR_CVL_18,258,62,93
2020-05-05,10,0,3,7,FR_CVL_18,268,65,100
2020-05-06,4,0,2,11,FR_CVL_18,272,67,111
2020-05-07,1,0,1,3,FR_CVL_18,273,68,114
2020-05-08,3,0,0,7,FR_CVL_18,276,68,121
2020-05-09,3,0,0,0,FR_CVL_18,279,68,121
2020-05-10,1,0,1,1,FR_CVL_18,280,69,122
2020-05-11,2,0,1,4,FR_CVL_18,282,70,126
2020-05-12,0,0,0,3,FR_CVL_18,282,70,129
2020-05-13,1,0,0,3,FR_CVL_18,283,70,132
2020-05-14,1,0,0,3,FR_CVL_18,284,70,135
2020-05-15,1,0,1,5,FR_CVL_18,285,71,140
2020-05-16,0,0,0,1,FR_CVL_18,285,71,141
2020-05-17,0,0,1,1,FR_CVL_18,285,72,142
2020-05-18,2,0,1,2,FR_CVL_18,287,73,144
2020-05-19,2,0,0,0,FR_CVL_18,289,73,144
2020-05-20,2,0,2,4,FR_CVL_18,291,75,148
2020-05-21,0,0,0,0,FR_CVL_18,291,75,148
2020-05-22,8,0,1,4,FR_CVL_18,299,76,152
2020-05-23,0,0,0,0,FR_CVL_18,299,76,152
2020-05-24,1,0,0,0,FR_CVL_18,300,76,152
2020-05-25,2,0,0,1,FR_CVL_18,302,76,153
2020-05-26,1,0,0,0,FR_CVL_18,303,76,153
2020-05-27,1,0,0,1,FR_CVL_18,304,76,154
2020-05-28,0,0,0,1,FR_CVL_18,304,76,155
2020-05-29,0,0,0,6,FR_CVL_18,304,76,161
2020-05-30,2,0,0,0,FR_CVL_18,306,76,161
2020-05-31,1,0,1,0,FR_CVL_18,307,77,161
2020-06-01,0,0,0,1,FR_CVL_18,307,77,162
2020-06-02,2,0,1,1,FR_CVL_18,309,78,163
2020-06-03,0,0,0,0,FR_CVL_18,309,78,163
2020-06-04,0,0,0,2,FR_CVL_18,309,78,165
2020-06-05,0,0,0,1,FR_CVL_18,309,78,166
2020-06-06,0,0,0,1,FR_CVL_18,309,78,167
2020-06-07,0,0,0,0,FR_CVL_18,309,78,167
2020-06-08,0,0,1,1,FR_CVL_18,309,79,168
2020-06-09,0,0,0,0,FR_CVL_18,309,79,168
2020-06-10,0,0,0,0,FR_CVL_18,309,79,168
2020-06-11,0,0,0,1,FR_CVL_18,309,79,169
2020-06-12,0,0,0,1,FR_CVL_18,309,79,170
2020-06-13,0,0,0,0,FR_CVL_18,309,79,170
2020-06-14,0,0,0,1,FR_CVL_18,309,79,171
2020-06-15,0,0,0,0,FR_CVL_18,309,79,171
2020-06-16,0,0,0,0,FR_CVL_18,309,79,171
2020-06-17,0,0,1,0,FR_CVL_18,309,80,171
2020-06-18,5,0,4,1,FR_CVL_18,314,84,172
2020-06-19,0,0,0,1,FR_CVL_18,314,84,173
2020-06-20,0,0,0,0,FR_CVL_18,314,84,173
2020-06-21,0,0,0,0,FR_CVL_18,314,84,173
2020-06-22,0,0,0,5,FR_CVL_18,314,84,178
2020-06-23,0,0,0,3,FR_CVL_18,314,84,181
2020-06-24,0,0,0,1,FR_CVL_18,314,84,182
2020-03-19,1,0,0,0,FR_NAQ_19,1,0,0
2020-03-20,0,0,0,0,FR_NAQ_19,1,0,0
2020-03-21,3,0,0,0,FR_NAQ_19,4,0,0
2020-03-22,1,0,1,0,FR_NAQ_19,5,1,0
2020-03-23,3,1,1,0,FR_NAQ_19,8,2,0
2020-03-24,7,2,1,0,FR_NAQ_19,15,3,0
2020-03-25,4,1,0,0,FR_NAQ_19,19,3,0
2020-03-26,2,2,0,1,FR_NAQ_19,21,3,1
2020-03-27,0,0,0,0,FR_NAQ_19,21,3,1
2020-03-28,14,3,0,0,FR_NAQ_19,35,3,1
2020-03-29,5,2,0,1,FR_NAQ_19,40,3,2
2020-03-30,7,1,0,2,FR_NAQ_19,47,3,4
2020-03-31,2,0,0,1,FR_NAQ_19,49,3,5
2020-04-01,5,3,1,3,FR_NAQ_19,54,4,8
2020-04-02,2,0,0,3,FR_NAQ_19,56,4,11
2020-04-03,7,0,0,3,FR_NAQ_19,63,4,14
2020-04-04,6,0,3,1,FR_NAQ_19,69,7,15
2020-04-05,1,1,0,1,FR_NAQ_19,70,7,16
2020-04-06,5,1,2,1,FR_NAQ_19,75,9,17
2020-04-07,5,1,2,6,FR_NAQ_19,80,11,23
2020-04-08,5,1,0,3,FR_NAQ_19,85,11,26
2020-04-09,5,1,1,3,FR_NAQ_19,90,12,29
2020-04-10,4,2,0,5,FR_NAQ_19,94,12,34
2020-04-11,9,0,1,3,FR_NAQ_19,103,13,37
2020-04-12,3,0,1,1,FR_NAQ_19,106,14,38
2020-04-13,3,1,0,0,FR_NAQ_19,109,14,38
2020-04-14,5,0,2,1,FR_NAQ_19,114,16,39
2020-04-15,4,0,1,2,FR_NAQ_19,118,17,41
2020-04-16,6,0,1,3,FR_NAQ_19,124,18,44
2020-04-17,2,0,0,1,FR_NAQ_19,126,18,45
2020-04-18,8,0,2,2,FR_NAQ_19,134,20,47
2020-04-19,5,0,0,0,FR_NAQ_19,139,20,47
2020-04-20,8,2,1,3,FR_NAQ_19,147,21,50
2020-04-21,5,0,1,2,FR_NAQ_19,152,22,52
2020-04-22,1,0,0,1,FR_NAQ_19,153,22,53
2020-04-23,2,0,0,2,FR_NAQ_19,155,22,55
2020-04-24,5,1,0,1,FR_NAQ_19,160,22,56
2020-04-25,1,0,0,4,FR_NAQ_19,161,22,60
2020-04-26,1,0,0,0,FR_NAQ_19,162,22,60
2020-04-27,7,1,1,2,FR_NAQ_19,169,23,62
2020-04-28,1,0,1,1,FR_NAQ_19,170,24,63
2020-04-29,3,2,2,2,FR_NAQ_19,173,26,65
2020-04-30,7,1,2,0,FR_NAQ_19,180,28,65
2020-05-01,0,0,0,0,FR_NAQ_19,180,28,65
2020-05-02,0,0,0,0,FR_NAQ_19,180,28,65
2020-05-03,4,1,0,6,FR_NAQ_19,184,28,71
2020-05-04,2,0,0,1,FR_NAQ_19,186,28,72
2020-05-05,1,0,0,3,FR_NAQ_19,187,28,75
2020-05-06,1,0,2,2,FR_NAQ_19,188,30,77
2020-05-07,3,0,0,3,FR_NAQ_19,191,30,80
2020-05-08,1,0,0,6,FR_NAQ_19,192,30,86
2020-05-09,2,1,0,0,FR_NAQ_19,194,30,86
2020-05-10,1,0,0,0,FR_NAQ_19,195,30,86
2020-05-11,3,1,0,5,FR_NAQ_19,198,30,91
2020-05-12,0,0,1,2,FR_NAQ_19,198,31,93
2020-05-13,8,0,1,0,FR_NAQ_19,206,32,93
2020-05-14,0,0,0,2,FR_NAQ_19,206,32,95
2020-05-15,1,0,1,1,FR_NAQ_19,207,33,96
2020-05-16,0,0,0,2,FR_NAQ_19,207,33,98
2020-05-17,0,0,0,0,FR_NAQ_19,207,33,98
2020-05-18,1,0,0,0,FR_NAQ_19,208,33,98
2020-05-19,4,2,0,6,FR_NAQ_19,212,33,104
2020-05-20,0,0,0,0,FR_NAQ_19,212,33,104
2020-05-21,0,0,0,2,FR_NAQ_19,212,33,106
2020-05-22,0,0,1,1,FR_NAQ_19,212,34,107
2020-05-23,0,0,0,0,FR_NAQ_19,212,34,107
2020-05-24,0,0,0,0,FR_NAQ_19,212,34,107
2020-05-25,0,1,0,3,FR_NAQ_19,212,34,110
2020-05-26,1,0,0,5,FR_NAQ_19,213,34,115
2020-05-27,4,0,0,0,FR_NAQ_19,217,34,115
2020-05-28,0,0,0,1,FR_NAQ_19,217,34,116
2020-05-29,0,0,0,0,FR_NAQ_19,217,34,116
2020-05-30,1,0,0,2,FR_NAQ_19,218,34,118
2020-05-31,0,0,0,1,FR_NAQ_19,218,34,119
2020-06-01,0,0,0,0,FR_NAQ_19,218,34,119
2020-06-02,0,0,3,26,FR_NAQ_19,218,37,145
2020-06-03,1,0,0,5,FR_NAQ_19,219,37,150
2020-06-04,0,0,0,12,FR_NAQ_19,219,37,162
2020-06-05,0,0,0,0,FR_NAQ_19,219,37,162
2020-06-06,0,0,0,0,FR_NAQ_19,219,37,162
2020-06-07,0,0,0,0,FR_NAQ_19,219,37,162
2020-06-08,0,0,0,0,FR_NAQ_19,219,37,162
2020-06-09,0,0,0,0,FR_NAQ_19,219,37,162
2020-06-10,0,0,0,0,FR_NAQ_19,219,37,162
2020-06-11,0,0,0,0,FR_NAQ_19,219,37,162
2020-06-12,0,0,0,0,FR_NAQ_19,219,37,162
2020-06-13,0,0,0,0,FR_NAQ_19,219,37,162
2020-06-14,0,0,0,0,FR_NAQ_19,219,37,162
2020-06-15,0,0,0,0,FR_NAQ_19,219,37,162
2020-06-16,0,0,0,0,FR_NAQ_19,219,37,162
2020-06-17,0,0,0,0,FR_NAQ_19,219,37,162
2020-06-18,0,0,0,0,FR_NAQ_19,219,37,162
2020-06-19,0,0,0,0,FR_NAQ_19,219,37,162
2020-06-20,0,0,0,0,FR_NAQ_19,219,37,162
2020-06-21,0,0,0,0,FR_NAQ_19,219,37,162
2020-06-22,0,0,0,0,FR_NAQ_19,219,37,162
2020-06-23,0,0,0,0,FR_NAQ_19,219,37,162
2020-06-24,0,0,0,0,FR_NAQ_19,219,37,162
2020-03-19,26,11,2,24,FR_BFC_21,26,2,24
2020-03-20,39,4,1,9,FR_BFC_21,65,3,33
2020-03-21,2,0,1,10,FR_BFC_21,67,4,43
2020-03-22,42,11,3,27,FR_BFC_21,109,7,70
2020-03-23,21,2,6,12,FR_BFC_21,130,13,82
2020-03-24,42,0,9,22,FR_BFC_21,172,22,104
2020-03-25,76,10,5,22,FR_BFC_21,248,27,126
2020-03-26,27,0,5,12,FR_BFC_21,275,32,138
2020-03-27,9,3,2,0,FR_BFC_21,284,34,138
2020-03-28,52,8,1,17,FR_BFC_21,336,35,155
2020-03-29,44,8,2,26,FR_BFC_21,380,37,181
2020-03-30,14,0,0,33,FR_BFC_21,394,37,214
2020-03-31,32,2,5,8,FR_BFC_21,426,42,222
2020-04-01,55,8,3,24,FR_BFC_21,481,45,246
2020-04-02,67,8,18,31,FR_BFC_21,548,63,277
2020-04-03,28,6,5,17,FR_BFC_21,576,68,294
2020-04-04,53,6,3,7,FR_BFC_21,629,71,301
2020-04-05,22,2,4,10,FR_BFC_21,651,75,311
2020-04-06,31,14,3,4,FR_BFC_21,682,78,315
2020-04-07,46,6,7,14,FR_BFC_21,728,85,329
2020-04-08,25,2,11,12,FR_BFC_21,753,96,341
2020-04-09,9,0,1,29,FR_BFC_21,762,97,370
2020-04-10,73,7,7,9,FR_BFC_21,835,104,379
2020-04-11,12,0,4,32,FR_BFC_21,847,108,411
2020-04-12,34,1,10,6,FR_BFC_21,881,118,417
2020-04-13,13,3,3,12,FR_BFC_21,894,121,429
2020-04-14,21,0,14,1,FR_BFC_21,915,135,430
2020-04-15,41,7,8,23,FR_BFC_21,956,143,453
2020-04-16,35,5,8,6,FR_BFC_21,991,151,459
2020-04-17,27,0,5,23,FR_BFC_21,1018,156,482
2020-04-18,19,4,5,3,FR_BFC_21,1037,161,485
2020-04-19,15,6,6,31,FR_BFC_21,1052,167,516
2020-04-20,10,1,6,6,FR_BFC_21,1062,173,522
2020-04-21,17,5,7,12,FR_BFC_21,1079,180,534
2020-04-22,10,2,1,12,FR_BFC_21,1089,181,546
2020-04-23,9,2,10,20,FR_BFC_21,1098,191,566
2020-04-24,13,0,12,34,FR_BFC_21,1111,203,600
2020-04-25,14,5,3,24,FR_BFC_21,1125,206,624
2020-04-26,1,0,4,3,FR_BFC_21,1126,210,627
2020-04-27,17,3,6,9,FR_BFC_21,1143,216,636
2020-04-28,6,1,2,7,FR_BFC_21,1149,218,643
2020-04-29,13,1,2,13,FR_BFC_21,1162,220,656
2020-04-30,17,4,1,14,FR_BFC_21,1179,221,670
2020-05-01,10,0,0,22,FR_BFC_21,1189,221,692
2020-05-02,4,1,0,0,FR_BFC_21,1193,221,692
2020-05-03,0,0,2,0,FR_BFC_21,1193,223,692
2020-05-04,3,0,0,3,FR_BFC_21,1196,223,695
2020-05-05,6,5,1,7,FR_BFC_21,1202,224,702
2020-05-06,19,1,3,5,FR_BFC_21,1221,227,707
2020-05-07,10,2,3,34,FR_BFC_21,1231,230,741
2020-05-08,6,1,1,19,FR_BFC_21,1237,231,760
2020-05-09,5,0,2,2,FR_BFC_21,1242,233,762
2020-05-10,0,0,0,2,FR_BFC_21,1242,233,764
2020-05-11,1,0,0,4,FR_BFC_21,1243,233,768
2020-05-12,5,3,4,6,FR_BFC_21,1248,237,774
2020-05-13,12,1,1,16,FR_BFC_21,1260,238,790
2020-05-14,4,0,0,5,FR_BFC_21,1264,238,795
2020-05-15,3,0,0,13,FR_BFC_21,1267,238,808
2020-05-16,2,0,0,2,FR_BFC_21,1269,238,810
2020-05-17,0,0,0,2,FR_BFC_21,1269,238,812
2020-05-18,0,0,0,0,FR_BFC_21,1269,238,812
2020-05-19,1,1,2,6,FR_BFC_21,1270,240,818
2020-05-20,5,3,1,5,FR_BFC_21,1275,241,823
2020-05-21,0,0,0,2,FR_BFC_21,1275,241,825
2020-05-22,2,1,1,3,FR_BFC_21,1277,242,828
2020-05-23,2,0,0,1,FR_BFC_21,1279,242,829
2020-05-24,2,1,0,2,FR_BFC_21,1281,242,831
2020-05-25,7,0,0,18,FR_BFC_21,1288,242,849
2020-05-26,7,2,2,24,FR_BFC_21,1295,244,873
2020-05-27,3,0,0,10,FR_BFC_21,1298,244,883
2020-05-28,1,0,0,3,FR_BFC_21,1299,244,886
2020-05-29,3,0,1,6,FR_BFC_21,1302,245,892
2020-05-30,4,0,1,3,FR_BFC_21,1306,246,895
2020-05-31,0,0,0,0,FR_BFC_21,1306,246,895
2020-06-01,3,0,0,2,FR_BFC_21,1309,246,897
2020-06-02,2,1,0,1,FR_BFC_21,1311,246,898
2020-06-03,0,0,1,3,FR_BFC_21,1311,247,901
2020-06-04,9,0,2,6,FR_BFC_21,1320,249,907
2020-06-05,0,0,0,3,FR_BFC_21,1320,249,910
2020-06-06,0,0,1,1,FR_BFC_21,1320,250,911
2020-06-07,0,0,0,0,FR_BFC_21,1320,250,911
2020-06-08,3,0,0,3,FR_BFC_21,1323,250,914
2020-06-09,5,0,1,14,FR_BFC_21,1328,251,928
2020-06-10,1,0,0,0,FR_BFC_21,1329,251,928
2020-06-11,2,2,0,0,FR_BFC_21,1331,251,928
2020-06-12,3,0,0,3,FR_BFC_21,1334,251,931
2020-06-13,0,0,0,3,FR_BFC_21,1334,251,934
2020-06-14,0,0,0,0,FR_BFC_21,1334,251,934
2020-06-15,1,0,0,2,FR_BFC_21,1335,251,936
2020-06-16,0,0,0,0,FR_BFC_21,1335,251,936
2020-06-17,0,0,0,2,FR_BFC_21,1335,251,938
2020-06-18,0,1,0,2,FR_BFC_21,1335,251,940
2020-06-19,0,0,0,0,FR_BFC_21,1335,251,940
2020-06-20,0,0,0,0,FR_BFC_21,1335,251,940
2020-06-21,0,0,0,0,FR_BFC_21,1335,251,940
2020-06-22,0,0,0,0,FR_BFC_21,1335,251,940
2020-06-23,1,0,0,0,FR_BFC_21,1336,251,940
2020-06-24,0,0,0,1,FR_BFC_21,1336,251,941
2020-03-19,4,0,1,0,FR_BRE_22,4,1,0
2020-03-20,1,0,0,0,FR_BRE_22,5,1,0
2020-03-21,2,1,0,0,FR_BRE_22,7,1,0
2020-03-22,0,1,0,0,FR_BRE_22,7,1,0
2020-03-23,2,0,0,0,FR_BRE_22,9,1,0
2020-03-24,4,2,0,0,FR_BRE_22,13,1,0
2020-03-25,6,0,0,0,FR_BRE_22,19,1,0
2020-03-26,7,2,0,0,FR_BRE_22,26,1,0
2020-03-27,10,1,0,0,FR_BRE_22,36,1,0
2020-03-28,6,0,1,3,FR_BRE_22,42,2,3
2020-03-29,5,1,1,2,FR_BRE_22,47,3,5
2020-03-30,4,0,0,1,FR_BRE_22,51,3,6
2020-03-31,4,0,1,1,FR_BRE_22,55,4,7
2020-04-01,13,2,2,3,FR_BRE_22,68,6,10
2020-04-02,16,9,3,3,FR_BRE_22,84,9,13
2020-04-03,10,0,0,4,FR_BRE_22,94,9,17
2020-04-04,5,1,1,6,FR_BRE_22,99,10,23
2020-04-05,8,0,0,0,FR_BRE_22,107,10,23
2020-04-06,10,1,1,4,FR_BRE_22,117,11,27
2020-04-07,10,1,2,13,FR_BRE_22,127,13,40
2020-04-08,2,0,1,3,FR_BRE_22,129,14,43
2020-04-09,6,1,2,4,FR_BRE_22,135,16,47
2020-04-10,11,1,1,5,FR_BRE_22,146,17,52
2020-04-11,4,0,1,6,FR_BRE_22,150,18,58
2020-04-12,9,0,2,2,FR_BRE_22,159,20,60
2020-04-13,2,0,0,1,FR_BRE_22,161,20,61
2020-04-14,9,0,1,4,FR_BRE_22,170,21,65
2020-04-15,5,0,1,6,FR_BRE_22,175,22,71
2020-04-16,4,0,0,8,FR_BRE_22,179,22,79
2020-04-17,7,0,1,2,FR_BRE_22,186,23,81
2020-04-18,1,0,0,3,FR_BRE_22,187,23,84
2020-04-19,1,0,0,5,FR_BRE_22,188,23,89
2020-04-20,3,0,1,4,FR_BRE_22,191,24,93
2020-04-21,3,0,0,7,FR_BRE_22,194,24,100
2020-04-22,2,0,0,3,FR_BRE_22,196,24,103
2020-04-23,6,0,0,10,FR_BRE_22,202,24,113
2020-04-24,2,0,0,3,FR_BRE_22,204,24,116
2020-04-25,4,0,0,6,FR_BRE_22,208,24,122
2020-04-26,0,0,0,1,FR_BRE_22,208,24,123
2020-04-27,2,0,0,0,FR_BRE_22,210,24,123
2020-04-28,1,0,0,3,FR_BRE_22,211,24,126
2020-04-29,1,0,1,3,FR_BRE_22,212,25,129
2020-04-30,4,0,0,2,FR_BRE_22,216,25,131
2020-05-01,2,0,0,5,FR_BRE_22,218,25,136
2020-05-02,9,0,1,1,FR_BRE_22,227,26,137
2020-05-03,0,0,0,0,FR_BRE_22,227,26,137
2020-05-04,4,0,0,4,FR_BRE_22,231,26,141
2020-05-05,3,0,0,3,FR_BRE_22,234,26,144
2020-05-06,4,0,0,4,FR_BRE_22,238,26,148
2020-05-07,1,1,1,0,FR_BRE_22,239,27,148
2020-05-08,2,0,1,2,FR_BRE_22,241,28,150
2020-05-09,3,1,0,0,FR_BRE_22,244,28,150
2020-05-10,0,0,1,0,FR_BRE_22,244,29,150
2020-05-11,3,1,0,1,FR_BRE_22,247,29,151
2020-05-12,2,0,0,2,FR_BRE_22,249,29,153
2020-05-13,1,0,1,2,FR_BRE_22,250,30,155
2020-05-14,3,1,0,2,FR_BRE_22,253,30,157
2020-05-15,2,0,0,3,FR_BRE_22,255,30,160
2020-05-16,2,2,0,1,FR_BRE_22,257,30,161
2020-05-17,0,0,1,1,FR_BRE_22,257,31,162
2020-05-18,1,0,0,3,FR_BRE_22,258,31,165
2020-05-19,2,0,0,1,FR_BRE_22,260,31,166
2020-05-20,1,0,0,3,FR_BRE_22,261,31,169
2020-05-21,2,0,0,3,FR_BRE_22,263,31,172
2020-05-22,1,0,0,3,FR_BRE_22,264,31,175
2020-05-23,3,1,0,4,FR_BRE_22,267,31,179
2020-05-24,0,1,0,0,FR_BRE_22,267,31,179
2020-05-25,0,0,0,0,FR_BRE_22,267,31,179
2020-05-26,1,0,0,2,FR_BRE_22,268,31,181
2020-05-27,1,0,1,0,FR_BRE_22,269,32,181
2020-05-28,0,0,0,1,FR_BRE_22,269,32,182
2020-05-29,2,1,0,2,FR_BRE_22,271,32,184
2020-05-30,0,0,0,2,FR_BRE_22,271,32,186
2020-05-31,0,0,0,0,FR_BRE_22,271,32,186
2020-06-01,0,0,1,1,FR_BRE_22,271,33,187
2020-06-02,0,0,1,1,FR_BRE_22,271,34,188
2020-06-03,0,0,0,2,FR_BRE_22,271,34,190
2020-06-04,0,0,1,0,FR_BRE_22,271,35,190
2020-06-05,2,0,1,2,FR_BRE_22,273,36,192
2020-06-06,0,0,0,1,FR_BRE_22,273,36,193
2020-06-07,0,0,0,0,FR_BRE_22,273,36,193
2020-06-08,2,1,0,1,FR_BRE_22,275,36,194
2020-06-09,0,0,0,1,FR_BRE_22,275,36,195
2020-06-10,1,0,0,0,FR_BRE_22,276,36,195
2020-06-11,1,1,0,3,FR_BRE_22,277,36,198
2020-06-12,0,0,0,0,FR_BRE_22,277,36,198
2020-06-13,0,0,0,1,FR_BRE_22,277,36,199
2020-06-14,0,0,1,1,FR_BRE_22,277,37,200
2020-06-15,0,0,0,1,FR_BRE_22,277,37,201
2020-06-16,0,0,0,0,FR_BRE_22,277,37,201
2020-06-17,0,0,0,0,FR_BRE_22,277,37,201
2020-06-18,0,0,0,1,FR_BRE_22,277,37,202
2020-06-19,0,0,0,3,FR_BRE_22,277,37,205
2020-06-20,0,0,0,0,FR_BRE_22,277,37,205
2020-06-21,0,0,0,0,FR_BRE_22,277,37,205
2020-06-22,1,0,0,0,FR_BRE_22,278,37,205
2020-06-23,0,0,0,3,FR_BRE_22,278,37,208
2020-06-24,0,0,1,0,FR_BRE_22,278,38,208
2020-03-19,0,0,0,0,FR_NAQ_23,0,0,0
2020-03-20,0,0,0,0,FR_NAQ_23,0,0,0
2020-03-21,1,0,0,0,FR_NAQ_23,1,0,0
2020-03-22,1,0,0,0,FR_NAQ_23,2,0,0
2020-03-23,3,0,0,0,FR_NAQ_23,5,0,0
2020-03-24,0,0,0,0,FR_NAQ_23,5,0,0
2020-03-25,3,2,0,0,FR_NAQ_23,8,0,0
2020-03-26,2,2,0,0,FR_NAQ_23,10,0,0
2020-03-27,5,2,0,0,FR_NAQ_23,15,0,0
2020-03-28,0,2,0,0,FR_NAQ_23,15,0,0
2020-03-29,0,0,0,0,FR_NAQ_23,15,0,0
2020-03-30,2,3,0,0,FR_NAQ_23,17,0,0
2020-03-31,3,0,0,1,FR_NAQ_23,20,0,1
2020-04-01,2,0,0,0,FR_NAQ_23,22,0,1
2020-04-02,2,2,0,1,FR_NAQ_23,24,0,2
2020-04-03,0,0,0,0,FR_NAQ_23,24,0,2
2020-04-04,3,0,1,1,FR_NAQ_23,27,1,3
2020-04-05,0,0,0,0,FR_NAQ_23,27,1,3
2020-04-06,2,0,2,1,FR_NAQ_23,29,3,4
2020-04-07,5,3,0,1,FR_NAQ_23,34,3,5
2020-04-08,16,2,1,0,FR_NAQ_23,50,4,5
2020-04-09,2,0,0,1,FR_NAQ_23,52,4,6
2020-04-10,0,0,0,5,FR_NAQ_23,52,4,11
2020-04-11,2,2,0,0,FR_NAQ_23,54,4,11
2020-04-12,3,2,0,0,FR_NAQ_23,57,4,11
2020-04-13,1,0,0,0,FR_NAQ_23,58,4,11
2020-04-14,1,1,0,2,FR_NAQ_23,59,4,13
2020-04-15,0,0,0,3,FR_NAQ_23,59,4,16
2020-04-16,0,0,0,0,FR_NAQ_23,59,4,16
2020-04-17,0,0,0,0,FR_NAQ_23,59,4,16
2020-04-18,2,0,1,0,FR_NAQ_23,61,5,16
2020-04-19,0,0,0,0,FR_NAQ_23,61,5,16
2020-04-20,0,0,0,0,FR_NAQ_23,61,5,16
2020-04-21,1,0,0,2,FR_NAQ_23,62,5,18
2020-04-22,0,0,0,2,FR_NAQ_23,62,5,20
2020-04-23,0,0,0,0,FR_NAQ_23,62,5,20
2020-04-24,2,1,0,4,FR_NAQ_23,64,5,24
2020-04-25,0,0,0,0,FR_NAQ_23,64,5,24
2020-04-26,3,0,0,0,FR_NAQ_23,67,5,24
2020-04-27,0,0,0,0,FR_NAQ_23,67,5,24
2020-04-28,2,0,0,0,FR_NAQ_23,69,5,24
2020-04-29,3,0,0,2,FR_NAQ_23,72,5,26
2020-04-30,2,0,0,12,FR_NAQ_23,74,5,38
2020-05-01,0,1,0,2,FR_NAQ_23,74,5,40
2020-05-02,0,0,0,0,FR_NAQ_23,74,5,40
2020-05-03,2,0,0,1,FR_NAQ_23,76,5,41
2020-05-04,0,0,0,4,FR_NAQ_23,76,5,45
2020-05-05,1,1,0,1,FR_NAQ_23,77,5,46
2020-05-06,0,0,0,1,FR_NAQ_23,77,5,47
2020-05-07,1,0,0,0,FR_NAQ_23,78,5,47
2020-05-08,1,0,0,0,FR_NAQ_23,79,5,47
2020-05-09,3,0,0,0,FR_NAQ_23,82,5,47
2020-05-10,2,0,0,0,FR_NAQ_23,84,5,47
2020-05-11,1,0,0,0,FR_NAQ_23,85,5,47
2020-05-12,2,0,0,2,FR_NAQ_23,87,5,49
2020-05-13,2,1,0,0,FR_NAQ_23,89,5,49
2020-05-14,1,0,0,1,FR_NAQ_23,90,5,50
2020-05-15,0,0,1,0,FR_NAQ_23,90,6,50
2020-05-16,0,0,0,1,FR_NAQ_23,90,6,51
2020-05-17,0,0,0,0,FR_NAQ_23,90,6,51
2020-05-18,1,1,0,0,FR_NAQ_23,91,6,51
2020-05-19,5,0,0,2,FR_NAQ_23,96,6,53
2020-05-20,1,0,2,0,FR_NAQ_23,97,8,53
2020-05-21,0,0,0,1,FR_NAQ_23,97,8,54
2020-05-22,2,1,0,0,FR_NAQ_23,99,8,54
2020-05-23,2,2,0,2,FR_NAQ_23,101,8,56
2020-05-24,1,1,0,0,FR_NAQ_23,102,8,56
2020-05-25,1,1,1,3,FR_NAQ_23,103,9,59
2020-05-26,1,0,0,1,FR_NAQ_23,104,9,60
2020-05-27,3,0,1,0,FR_NAQ_23,107,10,60
2020-05-28,1,1,1,0,FR_NAQ_23,108,11,60
2020-05-29,1,0,0,2,FR_NAQ_23,109,11,62
2020-05-30,0,0,0,0,FR_NAQ_23,109,11,62
2020-05-31,0,0,0,0,FR_NAQ_23,109,11,62
2020-06-01,0,0,0,0,FR_NAQ_23,109,11,62
2020-06-02,0,0,0,0,FR_NAQ_23,109,11,62
2020-06-03,1,0,1,1,FR_NAQ_23,110,12,63
2020-06-04,0,0,0,1,FR_NAQ_23,110,12,64
2020-06-05,0,0,0,2,FR_NAQ_23,110,12,66
2020-06-06,1,0,1,0,FR_NAQ_23,111,13,66
2020-06-07,0,0,0,0,FR_NAQ_23,111,13,66
2020-06-08,0,0,0,2,FR_NAQ_23,111,13,68
2020-06-09,0,0,0,1,FR_NAQ_23,111,13,69
2020-06-10,0,0,0,4,FR_NAQ_23,111,13,73
2020-06-11,0,0,0,1,FR_NAQ_23,111,13,74
2020-06-12,0,0,0,1,FR_NAQ_23,111,13,75
2020-06-13,0,0,0,0,FR_NAQ_23,111,13,75
2020-06-14,0,0,0,0,FR_NAQ_23,111,13,75
2020-06-15,0,0,1,0,FR_NAQ_23,111,14,75
2020-06-16,0,0,0,0,FR_NAQ_23,111,14,75
2020-06-17,0,0,0,0,FR_NAQ_23,111,14,75
2020-06-18,0,0,0,0,FR_NAQ_23,111,14,75
2020-06-19,0,0,0,0,FR_NAQ_23,111,14,75
2020-06-20,0,0,0,0,FR_NAQ_23,111,14,75
2020-06-21,0,0,0,0,FR_NAQ_23,111,14,75
2020-06-22,0,0,0,3,FR_NAQ_23,111,14,78
2020-06-23,0,0,0,0,FR_NAQ_23,111,14,78
2020-06-24,0,0,0,0,FR_NAQ_23,111,14,78
2020-03-19,1,1,0,0,FR_NAQ_24,1,0,0
2020-03-20,1,1,0,1,FR_NAQ_24,2,0,1
2020-03-21,1,0,0,0,FR_NAQ_24,3,0,1
2020-03-22,2,0,0,0,FR_NAQ_24,5,0,1
2020-03-23,23,0,0,9,FR_NAQ_24,28,0,10
2020-03-24,9,1,0,4,FR_NAQ_24,37,0,14
2020-03-25,6,1,0,0,FR_NAQ_24,43,0,14
2020-03-26,6,0,0,1,FR_NAQ_24,49,0,15
2020-03-27,9,1,0,0,FR_NAQ_24,58,0,15
2020-03-28,0,0,0,2,FR_NAQ_24,58,0,17
2020-03-29,0,0,0,0,FR_NAQ_24,58,0,17
2020-03-30,1,0,0,0,FR_NAQ_24,59,0,17
2020-03-31,1,0,1,1,FR_NAQ_24,60,1,18
2020-04-01,6,1,0,2,FR_NAQ_24,66,1,20
2020-04-02,4,0,0,3,FR_NAQ_24,70,1,23
2020-04-03,5,1,0,0,FR_NAQ_24,75,1,23
2020-04-04,8,2,0,2,FR_NAQ_24,83,1,25
2020-04-05,2,0,0,1,FR_NAQ_24,85,1,26
2020-04-06,3,0,0,1,FR_NAQ_24,88,1,27
2020-04-07,4,0,0,5,FR_NAQ_24,92,1,32
2020-04-08,2,0,0,3,FR_NAQ_24,94,1,35
2020-04-09,2,0,0,3,FR_NAQ_24,96,1,38
2020-04-10,6,0,0,2,FR_NAQ_24,102,1,40
2020-04-11,2,0,0,5,FR_NAQ_24,104,1,45
2020-04-12,2,1,0,0,FR_NAQ_24,106,1,45
2020-04-13,5,2,0,0,FR_NAQ_24,111,1,45
2020-04-14,3,0,2,2,FR_NAQ_24,114,3,47
2020-04-15,7,0,1,1,FR_NAQ_24,121,4,48
2020-04-16,4,0,0,1,FR_NAQ_24,125,4,49
2020-04-17,22,1,1,3,FR_NAQ_24,147,5,52
2020-04-18,1,0,0,0,FR_NAQ_24,148,5,52
2020-04-19,1,1,1,1,FR_NAQ_24,149,6,53
2020-04-20,7,0,0,0,FR_NAQ_24,156,6,53
2020-04-21,2,0,0,0,FR_NAQ_24,158,6,53
2020-04-22,0,0,0,2,FR_NAQ_24,158,6,55
2020-04-23,0,0,3,6,FR_NAQ_24,158,9,61
2020-04-24,0,0,0,9,FR_NAQ_24,158,9,70
2020-04-25,0,0,0,4,FR_NAQ_24,158,9,74
2020-04-26,2,0,0,0,FR_NAQ_24,160,9,74
2020-04-27,1,0,0,0,FR_NAQ_24,161,9,74
2020-04-28,0,0,0,3,FR_NAQ_24,161,9,77
2020-04-29,2,0,0,5,FR_NAQ_24,163,9,82
2020-04-30,0,0,0,3,FR_NAQ_24,163,9,85
2020-05-01,0,0,0,0,FR_NAQ_24,163,9,85
2020-05-02,0,0,0,0,FR_NAQ_24,163,9,85
2020-05-03,0,0,0,0,FR_NAQ_24,163,9,85
2020-05-04,1,0,0,0,FR_NAQ_24,164,9,85
2020-05-05,2,0,0,3,FR_NAQ_24,166,9,88
2020-05-06,2,0,0,1,FR_NAQ_24,168,9,89
2020-05-07,1,0,0,0,FR_NAQ_24,169,9,89
2020-05-08,0,0,1,0,FR_NAQ_24,169,10,89
2020-05-09,0,0,0,0,FR_NAQ_24,169,10,89
2020-05-10,0,0,1,0,FR_NAQ_24,169,11,89
2020-05-11,0,0,0,1,FR_NAQ_24,169,11,90
2020-05-12,1,0,0,2,FR_NAQ_24,170,11,92
2020-05-13,1,0,0,0,FR_NAQ_24,171,11,92
2020-05-14,1,0,0,2,FR_NAQ_24,172,11,94
2020-05-15,0,0,0,3,FR_NAQ_24,172,11,97
2020-05-16,0,0,0,1,FR_NAQ_24,172,11,98
2020-05-17,0,0,0,0,FR_NAQ_24,172,11,98
2020-05-18,1,0,1,0,FR_NAQ_24,173,12,98
2020-05-19,0,0,0,0,FR_NAQ_24,173,12,98
2020-05-20,0,0,0,2,FR_NAQ_24,173,12,100
2020-05-21,0,0,0,0,FR_NAQ_24,173,12,100
2020-05-22,0,0,0,1,FR_NAQ_24,173,12,101
2020-05-23,0,0,0,0,FR_NAQ_24,173,12,101
2020-05-24,0,0,0,0,FR_NAQ_24,173,12,101
2020-05-25,1,0,0,0,FR_NAQ_24,174,12,101
2020-05-26,2,0,0,0,FR_NAQ_24,176,12,101
2020-05-27,1,0,0,2,FR_NAQ_24,177,12,103
2020-05-28,0,0,1,2,FR_NAQ_24,177,13,105
2020-05-29,1,0,0,1,FR_NAQ_24,178,13,106
2020-05-30,0,0,0,1,FR_NAQ_24,178,13,107
2020-05-31,0,0,0,0,FR_NAQ_24,178,13,107
2020-06-01,0,0,0,0,FR_NAQ_24,178,13,107
2020-06-02,0,0,0,2,FR_NAQ_24,178,13,109
2020-06-03,0,0,0,0,FR_NAQ_24,178,13,109
2020-06-04,0,0,0,1,FR_NAQ_24,178,13,110
2020-06-05,0,0,0,0,FR_NAQ_24,178,13,110
2020-06-06,0,0,0,0,FR_NAQ_24,178,13,110
2020-06-07,0,0,0,0,FR_NAQ_24,178,13,110
2020-06-08,0,0,0,0,FR_NAQ_24,178,13,110
2020-06-09,2,0,0,0,FR_NAQ_24,180,13,110
2020-06-10,0,0,0,0,FR_NAQ_24,180,13,110
2020-06-11,0,0,0,0,FR_NAQ_24,180,13,110
2020-06-12,0,0,0,1,FR_NAQ_24,180,13,111
2020-06-13,0,0,0,0,FR_NAQ_24,180,13,111
2020-06-14,0,0,0,0,FR_NAQ_24,180,13,111
2020-06-15,0,0,0,0,FR_NAQ_24,180,13,111
2020-06-16,0,0,0,0,FR_NAQ_24,180,13,111
2020-06-17,0,0,0,1,FR_NAQ_24,180,13,112
2020-06-18,0,0,0,0,FR_NAQ_24,180,13,112
2020-06-19,0,0,0,0,FR_NAQ_24,180,13,112
2020-06-20,1,0,0,0,FR_NAQ_24,181,13,112
2020-06-21,0,0,0,0,FR_NAQ_24,181,13,112
2020-06-22,0,0,0,0,FR_NAQ_24,181,13,112
2020-06-23,0,0,0,0,FR_NAQ_24,181,13,112
2020-06-24,0,0,0,0,FR_NAQ_24,181,13,112
2020-03-19,12,11,2,5,FR_BFC_25,12,2,5
2020-03-20,12,1,1,0,FR_BFC_25,24,3,5
2020-03-21,13,6,2,7,FR_BFC_25,37,5,12
2020-03-22,24,1,3,4,FR_BFC_25,61,8,16
2020-03-23,1,0,1,2,FR_BFC_25,62,9,18
2020-03-24,24,5,1,5,FR_BFC_25,86,10,23
2020-03-25,17,2,1,15,FR_BFC_25,103,11,38
2020-03-26,17,4,6,8,FR_BFC_25,120,17,46
2020-03-27,27,8,3,8,FR_BFC_25,147,20,54
2020-03-28,6,1,1,14,FR_BFC_25,153,21,68
2020-03-29,68,15,3,12,FR_BFC_25,221,24,80
2020-03-30,15,1,1,5,FR_BFC_25,236,25,85
2020-03-31,32,8,8,18,FR_BFC_25,268,33,103
2020-04-01,26,7,0,10,FR_BFC_25,294,33,113
2020-04-02,39,9,1,13,FR_BFC_25,333,34,126
2020-04-03,20,14,8,21,FR_BFC_25,353,42,147
2020-04-04,22,7,3,17,FR_BFC_25,375,45,164
2020-04-05,21,2,3,10,FR_BFC_25,396,48,174
2020-04-06,7,3,2,7,FR_BFC_25,403,50,181
2020-04-07,24,10,7,9,FR_BFC_25,427,57,190
2020-04-08,21,3,1,20,FR_BFC_25,448,58,210
2020-04-09,15,5,1,15,FR_BFC_25,463,59,225
2020-04-10,11,1,5,15,FR_BFC_25,474,64,240
2020-04-11,13,2,3,14,FR_BFC_25,487,67,254
2020-04-12,47,2,4,16,FR_BFC_25,534,71,270
2020-04-13,5,1,0,5,FR_BFC_25,539,71,275
2020-04-14,39,0,8,9,FR_BFC_25,578,79,284
2020-04-15,6,0,1,13,FR_BFC_25,584,80,297
2020-04-16,7,5,4,12,FR_BFC_25,591,84,309
2020-04-17,8,1,3,14,FR_BFC_25,599,87,323
2020-04-18,3,1,5,22,FR_BFC_25,602,92,345
2020-04-19,5,1,1,6,FR_BFC_25,607,93,351
2020-04-20,5,1,1,1,FR_BFC_25,612,94,352
2020-04-21,14,2,4,8,FR_BFC_25,626,98,360
2020-04-22,11,3,0,10,FR_BFC_25,637,98,370
2020-04-23,7,1,7,19,FR_BFC_25,644,105,389
2020-04-24,10,2,0,11,FR_BFC_25,654,105,400
2020-04-25,5,0,6,5,FR_BFC_25,659,111,405
2020-04-26,11,3,1,2,FR_BFC_25,670,112,407
2020-04-27,4,0,2,2,FR_BFC_25,674,114,409
2020-04-28,6,3,1,5,FR_BFC_25,680,115,414
2020-04-29,3,1,0,15,FR_BFC_25,683,115,429
2020-04-30,6,2,2,11,FR_BFC_25,689,117,440
2020-05-01,0,1,0,5,FR_BFC_25,689,117,445
2020-05-02,8,3,0,5,FR_BFC_25,697,117,450
2020-05-03,0,0,0,1,FR_BFC_25,697,117,451
2020-05-04,4,1,3,2,FR_BFC_25,701,120,453
2020-05-05,28,1,7,32,FR_BFC_25,729,127,485
2020-05-06,8,0,4,8,FR_BFC_25,737,131,493
2020-05-07,2,0,2,7,FR_BFC_25,739,133,500
2020-05-08,5,1,0,17,FR_BFC_25,744,133,517
2020-05-09,3,2,0,5,FR_BFC_25,747,133,522
2020-05-10,1,0,0,0,FR_BFC_25,748,133,522
2020-05-11,11,0,3,4,FR_BFC_25,759,136,526
2020-05-12,6,2,1,2,FR_BFC_25,765,137,528
2020-05-13,2,0,0,3,FR_BFC_25,767,137,531
2020-05-14,1,0,1,10,FR_BFC_25,768,138,541
2020-05-15,0,0,0,2,FR_BFC_25,768,138,543
2020-05-16,1,1,1,7,FR_BFC_25,769,139,550
2020-05-17,0,0,0,0,FR_BFC_25,769,139,550
2020-05-18,2,0,4,11,FR_BFC_25,771,143,561
2020-05-19,2,0,2,5,FR_BFC_25,773,145,566
2020-05-20,1,0,0,5,FR_BFC_25,774,145,571
2020-05-21,0,0,0,3,FR_BFC_25,774,145,574
2020-05-22,0,0,2,1,FR_BFC_25,774,147,575
2020-05-23,1,1,0,5,FR_BFC_25,775,147,580
2020-05-24,0,0,0,0,FR_BFC_25,775,147,580
2020-05-25,0,0,0,2,FR_BFC_25,775,147,582
2020-05-26,0,0,0,12,FR_BFC_25,775,147,594
2020-05-27,9,1,1,27,FR_BFC_25,784,148,621
2020-05-28,2,1,1,5,FR_BFC_25,786,149,626
2020-05-29,0,0,0,0,FR_BFC_25,786,149,626
2020-05-30,0,0,0,4,FR_BFC_25,786,149,630
2020-05-31,0,0,0,0,FR_BFC_25,786,149,630
2020-06-01,0,0,0,0,FR_BFC_25,786,149,630
2020-06-02,3,0,0,4,FR_BFC_25,789,149,634
2020-06-03,0,0,0,2,FR_BFC_25,789,149,636
2020-06-04,0,0,0,0,FR_BFC_25,789,149,636
2020-06-05,0,0,0,0,FR_BFC_25,789,149,636
2020-06-06,0,0,0,0,FR_BFC_25,789,149,636
2020-06-07,0,0,0,0,FR_BFC_25,789,149,636
2020-06-08,1,0,0,1,FR_BFC_25,790,149,637
2020-06-09,0,0,1,0,FR_BFC_25,790,150,637
2020-06-10,0,0,0,1,FR_BFC_25,790,150,638
2020-06-11,0,0,0,1,FR_BFC_25,790,150,639
2020-06-12,1,0,0,1,FR_BFC_25,791,150,640
2020-06-13,0,0,0,1,FR_BFC_25,791,150,641
2020-06-14,0,0,0,0,FR_BFC_25,791,150,641
2020-06-15,0,0,0,0,FR_BFC_25,791,150,641
2020-06-16,0,0,0,0,FR_BFC_25,791,150,641
2020-06-17,0,0,0,1,FR_BFC_25,791,150,642
2020-06-18,0,0,0,0,FR_BFC_25,791,150,642
2020-06-19,0,0,0,0,FR_BFC_25,791,150,642
2020-06-20,0,0,0,0,FR_BFC_25,791,150,642
2020-06-21,0,0,0,0,FR_BFC_25,791,150,642
2020-06-22,0,0,1,0,FR_BFC_25,791,151,642
2020-06-23,0,0,0,2,FR_BFC_25,791,151,644
2020-06-24,0,0,1,0,FR_BFC_25,791,152,644
2020-03-19,15,5,1,2,FR_ARA_26,15,1,2
2020-03-20,3,2,1,0,FR_ARA_26,18,2,2
2020-03-21,11,3,2,1,FR_ARA_26,29,4,3
2020-03-22,5,2,1,1,FR_ARA_26,34,5,4
2020-03-23,12,4,2,1,FR_ARA_26,46,7,5
2020-03-24,20,5,2,5,FR_ARA_26,66,9,10
2020-03-25,31,6,5,3,FR_ARA_26,97,14,13
2020-03-26,44,9,5,13,FR_ARA_26,141,19,26
2020-03-27,30,8,3,13,FR_ARA_26,171,22,39
2020-03-28,33,9,0,2,FR_ARA_26,204,22,41
2020-03-29,18,6,1,0,FR_ARA_26,222,23,41
2020-03-30,50,11,10,12,FR_ARA_26,272,33,53
2020-03-31,27,5,7,12,FR_ARA_26,299,40,65
2020-04-01,40,6,1,13,FR_ARA_26,339,41,78
2020-04-02,11,1,5,16,FR_ARA_26,350,46,94
2020-04-03,46,4,8,14,FR_ARA_26,396,54,108
2020-04-04,23,4,3,14,FR_ARA_26,419,57,122
2020-04-05,7,0,2,6,FR_ARA_26,426,59,128
2020-04-06,25,6,6,8,FR_ARA_26,451,65,136
2020-04-07,22,5,1,26,FR_ARA_26,473,66,162
2020-04-08,19,1,5,10,FR_ARA_26,492,71,172
2020-04-09,14,1,2,14,FR_ARA_26,506,73,186
2020-04-10,9,2,2,11,FR_ARA_26,515,75,197
2020-04-11,20,4,4,12,FR_ARA_26,535,79,209
2020-04-12,13,1,2,3,FR_ARA_26,548,81,212
2020-04-13,7,0,1,6,FR_ARA_26,555,82,218
2020-04-14,10,4,5,10,FR_ARA_26,565,87,228
2020-04-15,13,3,4,21,FR_ARA_26,578,91,249
2020-04-16,14,4,3,14,FR_ARA_26,592,94,263
2020-04-17,8,1,5,17,FR_ARA_26,600,99,280
2020-04-18,8,1,3,14,FR_ARA_26,608,102,294
2020-04-19,5,0,1,3,FR_ARA_26,613,103,297
2020-04-20,3,0,4,0,FR_ARA_26,616,107,297
2020-04-21,11,2,3,18,FR_ARA_26,627,110,315
2020-04-22,4,0,0,33,FR_ARA_26,631,110,348
2020-04-23,3,0,2,7,FR_ARA_26,634,112,355
2020-04-24,8,1,2,10,FR_ARA_26,642,114,365
2020-04-25,7,1,0,7,FR_ARA_26,649,114,372
2020-04-26,5,1,0,0,FR_ARA_26,654,114,372
2020-04-27,5,2,1,5,FR_ARA_26,659,115,377
2020-04-28,4,0,1,12,FR_ARA_26,663,116,389
2020-04-29,2,0,4,10,FR_ARA_26,665,120,399
2020-04-30,3,1,3,12,FR_ARA_26,668,123,411
2020-05-01,1,0,0,5,FR_ARA_26,669,123,416
2020-05-02,1,0,0,1,FR_ARA_26,670,123,417
2020-05-03,0,0,0,1,FR_ARA_26,670,123,418
2020-05-04,2,1,1,0,FR_ARA_26,672,124,418
2020-05-05,4,0,1,9,FR_ARA_26,676,125,427
2020-05-06,7,1,2,3,FR_ARA_26,683,127,430
2020-05-07,5,0,1,13,FR_ARA_26,688,128,443
2020-05-08,3,0,2,7,FR_ARA_26,691,130,450
2020-05-09,0,0,0,0,FR_ARA_26,691,130,450
2020-05-10,1,0,1,0,FR_ARA_26,692,131,450
2020-05-11,0,0,0,0,FR_ARA_26,692,131,450
2020-05-12,0,0,0,4,FR_ARA_26,692,131,454
2020-05-13,0,0,0,4,FR_ARA_26,692,131,458
2020-05-14,9,0,0,6,FR_ARA_26,701,131,464
2020-05-15,0,0,0,5,FR_ARA_26,701,131,469
2020-05-16,2,0,1,1,FR_ARA_26,703,132,470
2020-05-17,0,0,0,0,FR_ARA_26,703,132,470
2020-05-18,0,0,0,5,FR_ARA_26,703,132,475
2020-05-19,1,0,0,1,FR_ARA_26,704,132,476
2020-05-20,1,0,0,5,FR_ARA_26,705,132,481
2020-05-21,2,1,0,3,FR_ARA_26,707,132,484
2020-05-22,0,0,0,1,FR_ARA_26,707,132,485
2020-05-23,0,0,0,3,FR_ARA_26,707,132,488
2020-05-24,0,0,0,0,FR_ARA_26,707,132,488
2020-05-25,1,0,0,1,FR_ARA_26,708,132,489
2020-05-26,1,1,0,1,FR_ARA_26,709,132,490
2020-05-27,0,0,0,1,FR_ARA_26,709,132,491
2020-05-28,1,0,0,1,FR_ARA_26,710,132,492
2020-05-29,0,0,0,3,FR_ARA_26,710,132,495
2020-05-30,1,0,1,3,FR_ARA_26,711,133,498
2020-05-31,0,0,0,0,FR_ARA_26,711,133,498
2020-06-01,0,0,0,0,FR_ARA_26,711,133,498
2020-06-02,0,0,0,1,FR_ARA_26,711,133,499
2020-06-03,0,0,0,0,FR_ARA_26,711,133,499
2020-06-04,0,0,0,2,FR_ARA_26,711,133,501
2020-06-05,0,0,0,1,FR_ARA_26,711,133,502
2020-06-06,0,0,0,2,FR_ARA_26,711,133,504
2020-06-07,0,0,0,0,FR_ARA_26,711,133,504
2020-06-08,0,1,0,4,FR_ARA_26,711,133,508
2020-06-09,0,0,0,0,FR_ARA_26,711,133,508
2020-06-10,1,0,0,0,FR_ARA_26,712,133,508
2020-06-11,0,0,0,2,FR_ARA_26,712,133,510
2020-06-12,0,0,0,1,FR_ARA_26,712,133,511
2020-06-13,0,0,0,0,FR_ARA_26,712,133,511
2020-06-14,0,0,0,0,FR_ARA_26,712,133,511
2020-06-15,0,0,0,1,FR_ARA_26,712,133,512
2020-06-16,2,0,0,0,FR_ARA_26,714,133,512
2020-06-17,0,0,0,1,FR_ARA_26,714,133,513
2020-06-18,0,0,0,4,FR_ARA_26,714,133,517
2020-06-19,0,0,0,0,FR_ARA_26,714,133,517
2020-06-20,0,0,0,8,FR_ARA_26,714,133,525
2020-06-21,0,0,0,0,FR_ARA_26,714,133,525
2020-06-22,0,0,0,0,FR_ARA_26,714,133,525
2020-06-23,0,0,0,0,FR_ARA_26,714,133,525
2020-06-24,2,1,0,0,FR_ARA_26,716,133,525
2020-03-19,1,0,1,0,FR_NOR_27,1,1,0
2020-03-20,2,0,0,0,FR_NOR_27,3,1,0
2020-03-21,3,2,0,0,FR_NOR_27,6,1,0
2020-03-22,5,1,0,0,FR_NOR_27,11,1,0
2020-03-23,3,0,0,0,FR_NOR_27,14,1,0
2020-03-24,1,0,0,0,FR_NOR_27,15,1,0
2020-03-25,6,1,0,0,FR_NOR_27,21,1,0
2020-03-26,12,2,1,0,FR_NOR_27,33,2,0
2020-03-27,1,0,0,0,FR_NOR_27,34,2,0
2020-03-28,1,0,0,1,FR_NOR_27,35,2,1
2020-03-29,0,0,0,0,FR_NOR_27,35,2,1
2020-03-30,7,3,2,2,FR_NOR_27,42,4,3
2020-03-31,19,3,5,10,FR_NOR_27,61,9,13
2020-04-01,13,0,0,7,FR_NOR_27,74,9,20
2020-04-02,12,2,2,0,FR_NOR_27,86,11,20
2020-04-03,12,1,1,3,FR_NOR_27,98,12,23
2020-04-04,6,0,1,0,FR_NOR_27,104,13,23
2020-04-05,0,0,1,0,FR_NOR_27,104,14,23
2020-04-06,6,2,2,1,FR_NOR_27,110,16,24
2020-04-07,11,2,7,4,FR_NOR_27,121,23,28
2020-04-08,11,1,6,14,FR_NOR_27,132,29,42
2020-04-09,24,0,3,4,FR_NOR_27,156,32,46
2020-04-10,25,3,2,3,FR_NOR_27,181,34,49
2020-04-11,8,0,0,0,FR_NOR_27,189,34,49
2020-04-12,3,0,0,2,FR_NOR_27,192,34,51
2020-04-13,0,0,2,0,FR_NOR_27,192,36,51
2020-04-14,3,0,6,2,FR_NOR_27,195,42,53
2020-04-15,2,0,2,4,FR_NOR_27,197,44,57
2020-04-16,14,0,4,8,FR_NOR_27,211,48,65
2020-04-17,13,0,1,5,FR_NOR_27,224,49,70
2020-04-18,6,0,2,1,FR_NOR_27,230,51,71
2020-04-19,0,0,0,0,FR_NOR_27,230,51,71
2020-04-20,4,0,6,6,FR_NOR_27,234,57,77
2020-04-21,14,0,2,1,FR_NOR_27,248,59,78
2020-04-22,1,0,1,1,FR_NOR_27,249,60,79
2020-04-23,15,6,3,4,FR_NOR_27,264,63,83
2020-04-24,3,0,0,1,FR_NOR_27,267,63,84
2020-04-25,1,0,0,1,FR_NOR_27,268,63,85
2020-04-26,1,0,0,0,FR_NOR_27,269,63,85
2020-04-27,3,0,2,4,FR_NOR_27,272,65,89
2020-04-28,0,0,0,2,FR_NOR_27,272,65,91
2020-04-29,4,0,0,0,FR_NOR_27,276,65,91
2020-04-30,7,0,1,7,FR_NOR_27,283,66,98
2020-05-01,3,0,0,0,FR_NOR_27,286,66,98
2020-05-02,0,0,0,0,FR_NOR_27,286,66,98
2020-05-03,1,0,0,0,FR_NOR_27,287,66,98
2020-05-04,9,1,5,11,FR_NOR_27,296,71,109
2020-05-05,8,1,0,3,FR_NOR_27,304,71,112
2020-05-06,2,0,0,1,FR_NOR_27,306,71,113
2020-05-07,1,0,0,2,FR_NOR_27,307,71,115
2020-05-08,0,0,0,7,FR_NOR_27,307,71,122
2020-05-09,0,0,0,0,FR_NOR_27,307,71,122
2020-05-10,0,0,0,0,FR_NOR_27,307,71,122
2020-05-11,10,0,1,1,FR_NOR_27,317,72,123
2020-05-12,1,0,0,3,FR_NOR_27,318,72,126
2020-05-13,0,0,0,0,FR_NOR_27,318,72,126
2020-05-14,8,0,3,11,FR_NOR_27,326,75,137
2020-05-15,0,0,0,1,FR_NOR_27,326,75,138
2020-05-16,0,0,0,11,FR_NOR_27,326,75,149
2020-05-17,0,0,0,0,FR_NOR_27,326,75,149
2020-05-18,2,0,0,2,FR_NOR_27,328,75,151
2020-05-19,0,0,0,1,FR_NOR_27,328,75,152
2020-05-20,1,0,0,6,FR_NOR_27,329,75,158
2020-05-21,0,0,0,1,FR_NOR_27,329,75,159
2020-05-22,0,0,0,0,FR_NOR_27,329,75,159
2020-05-23,0,0,0,1,FR_NOR_27,329,75,160
2020-05-24,0,0,0,0,FR_NOR_27,329,75,160
2020-05-25,0,0,3,2,FR_NOR_27,329,78,162
2020-05-26,7,0,1,5,FR_NOR_27,336,79,167
2020-05-27,0,0,0,4,FR_NOR_27,336,79,171
2020-05-28,1,0,0,6,FR_NOR_27,337,79,177
2020-05-29,3,0,0,2,FR_NOR_27,340,79,179
2020-05-30,0,0,0,0,FR_NOR_27,340,79,179
2020-05-31,0,0,0,0,FR_NOR_27,340,79,179
2020-06-01,0,0,0,0,FR_NOR_27,340,79,179
2020-06-02,0,0,0,1,FR_NOR_27,340,79,180
2020-06-03,0,0,0,8,FR_NOR_27,340,79,188
2020-06-04,0,0,0,0,FR_NOR_27,340,79,188
2020-06-05,2,0,1,1,FR_NOR_27,342,80,189
2020-06-06,0,0,0,0,FR_NOR_27,342,80,189
2020-06-07,0,0,0,0,FR_NOR_27,342,80,189
2020-06-08,1,0,1,1,FR_NOR_27,343,81,190
2020-06-09,0,0,0,6,FR_NOR_27,343,81,196
2020-06-10,0,0,0,0,FR_NOR_27,343,81,196
2020-06-11,0,0,0,0,FR_NOR_27,343,81,196
2020-06-12,0,0,0,0,FR_NOR_27,343,81,196
2020-06-13,0,0,0,3,FR_NOR_27,343,81,199
2020-06-14,0,0,0,0,FR_NOR_27,343,81,199
2020-06-15,0,0,0,0,FR_NOR_27,343,81,199
2020-06-16,1,0,0,0,FR_NOR_27,344,81,199
2020-06-17,1,0,1,1,FR_NOR_27,345,82,200
2020-06-18,1,0,0,12,FR_NOR_27,346,82,212
2020-06-19,0,0,0,0,FR_NOR_27,346,82,212
2020-06-20,2,0,0,0,FR_NOR_27,348,82,212
2020-06-21,0,0,0,0,FR_NOR_27,348,82,212
2020-06-22,1,0,0,0,FR_NOR_27,349,82,212
2020-06-23,0,0,0,0,FR_NOR_27,349,82,212
2020-06-24,1,0,0,4,FR_NOR_27,350,82,216
2020-03-19,6,1,0,0,FR_CVL_28,6,0,0
2020-03-20,1,0,0,0,FR_CVL_28,7,0,0
2020-03-21,4,0,0,2,FR_CVL_28,11,0,2
2020-03-22,2,0,0,0,FR_CVL_28,13,0,2
2020-03-23,20,8,1,0,FR_CVL_28,33,1,2
2020-03-24,9,2,1,1,FR_CVL_28,42,2,3
2020-03-25,15,7,1,3,FR_CVL_28,57,3,6
2020-03-26,18,4,4,4,FR_CVL_28,75,7,10
2020-03-27,14,7,2,3,FR_CVL_28,89,9,13
2020-03-28,7,0,0,2,FR_CVL_28,96,9,15
2020-03-29,29,4,1,2,FR_CVL_28,125,10,17
2020-03-30,25,2,6,6,FR_CVL_28,150,16,23
2020-03-31,16,2,0,5,FR_CVL_28,166,16,28
2020-04-01,8,3,0,6,FR_CVL_28,174,16,34
2020-04-02,47,4,2,20,FR_CVL_28,221,18,54
2020-04-03,20,1,3,11,FR_CVL_28,241,21,65
2020-04-04,31,3,3,13,FR_CVL_28,272,24,78
2020-04-05,16,3,1,3,FR_CVL_28,288,25,81
2020-04-06,13,2,4,17,FR_CVL_28,301,29,98
2020-04-07,17,0,2,8,FR_CVL_28,318,31,106
2020-04-08,31,3,5,20,FR_CVL_28,349,36,126
2020-04-09,23,0,1,8,FR_CVL_28,372,37,134
2020-04-10,27,1,3,13,FR_CVL_28,399,40,147
2020-04-11,7,1,1,4,FR_CVL_28,406,41,151
2020-04-12,19,0,0,1,FR_CVL_28,425,41,152
2020-04-13,17,0,1,0,FR_CVL_28,442,42,152
2020-04-14,24,2,5,14,FR_CVL_28,466,47,166
2020-04-15,23,0,9,10,FR_CVL_28,489,56,176
2020-04-16,33,1,2,36,FR_CVL_28,522,58,212
2020-04-17,29,3,4,13,FR_CVL_28,551,62,225
2020-04-18,8,0,0,9,FR_CVL_28,559,62,234
2020-04-19,7,0,1,3,FR_CVL_28,566,63,237
2020-04-20,3,1,3,11,FR_CVL_28,569,66,248
2020-04-21,10,0,4,11,FR_CVL_28,579,70,259
2020-04-22,14,0,5,8,FR_CVL_28,593,75,267
2020-04-23,17,2,3,16,FR_CVL_28,610,78,283
2020-04-24,3,0,1,1,FR_CVL_28,613,79,284
2020-04-25,0,0,0,5,FR_CVL_28,613,79,289
2020-04-26,7,0,3,9,FR_CVL_28,620,82,298
2020-04-27,10,0,2,11,FR_CVL_28,630,84,309
2020-04-28,2,1,0,11,FR_CVL_28,632,84,320
2020-04-29,10,0,2,4,FR_CVL_28,642,86,324
2020-04-30,9,0,2,12,FR_CVL_28,651,88,336
2020-05-01,6,1,3,2,FR_CVL_28,657,91,338
2020-05-02,7,1,1,3,FR_CVL_28,664,92,341
2020-05-03,0,0,3,1,FR_CVL_28,664,95,342
2020-05-04,4,0,1,2,FR_CVL_28,668,96,344
2020-05-05,17,3,3,8,FR_CVL_28,685,99,352
2020-05-06,4,0,2,15,FR_CVL_28,689,101,367
2020-05-07,9,0,1,6,FR_CVL_28,698,102,373
2020-05-08,2,0,2,4,FR_CVL_28,700,104,377
2020-05-09,2,0,0,3,FR_CVL_28,702,104,380
2020-05-10,1,0,0,1,FR_CVL_28,703,104,381
2020-05-11,1,0,1,11,FR_CVL_28,704,105,392
2020-05-12,3,1,3,9,FR_CVL_28,707,108,401
2020-05-13,2,1,0,2,FR_CVL_28,709,108,403
2020-05-14,1,0,0,7,FR_CVL_28,710,108,410
2020-05-15,5,1,3,5,FR_CVL_28,715,111,415
2020-05-16,2,0,1,5,FR_CVL_28,717,112,420
2020-05-17,2,0,0,0,FR_CVL_28,719,112,420
2020-05-18,0,0,1,4,FR_CVL_28,719,113,424
2020-05-19,2,0,0,1,FR_CVL_28,721,113,425
2020-05-20,7,0,3,5,FR_CVL_28,728,116,430
2020-05-21,1,0,0,2,FR_CVL_28,729,116,432
2020-05-22,3,0,0,1,FR_CVL_28,732,116,433
2020-05-23,1,0,0,2,FR_CVL_28,733,116,435
2020-05-24,1,0,1,1,FR_CVL_28,734,117,436
2020-05-25,0,0,0,1,FR_CVL_28,734,117,437
2020-05-26,0,0,0,2,FR_CVL_28,734,117,439
2020-05-27,0,0,0,1,FR_CVL_28,734,117,440
2020-05-28,0,0,0,3,FR_CVL_28,734,117,443
2020-05-29,0,0,2,9,FR_CVL_28,734,119,452
2020-05-30,1,1,0,0,FR_CVL_28,735,119,452
2020-05-31,0,0,0,0,FR_CVL_28,735,119,452
2020-06-01,0,0,0,0,FR_CVL_28,735,119,452
2020-06-02,0,0,0,1,FR_CVL_28,735,119,453
2020-06-03,0,0,3,3,FR_CVL_28,735,122,456
2020-06-04,2,0,3,3,FR_CVL_28,737,125,459
2020-06-05,1,0,0,6,FR_CVL_28,738,125,465
2020-06-06,1,0,0,0,FR_CVL_28,739,125,465
2020-06-07,0,0,1,1,FR_CVL_28,739,126,466
2020-06-08,0,0,1,0,FR_CVL_28,739,127,466
2020-06-09,0,0,0,1,FR_CVL_28,739,127,467
2020-06-10,0,0,1,12,FR_CVL_28,739,128,479
2020-06-11,3,1,0,2,FR_CVL_28,742,128,481
2020-06-12,0,0,0,0,FR_CVL_28,742,128,481
2020-06-13,0,0,0,1,FR_CVL_28,742,128,482
2020-06-14,0,0,0,0,FR_CVL_28,742,128,482
2020-06-15,2,0,0,1,FR_CVL_28,744,128,483
2020-06-16,3,1,0,2,FR_CVL_28,747,128,485
2020-06-17,8,0,4,35,FR_CVL_28,755,132,520
2020-06-18,2,0,2,1,FR_CVL_28,757,134,521
2020-06-19,0,0,0,0,FR_CVL_28,757,134,521
2020-06-20,0,0,0,1,FR_CVL_28,757,134,522
2020-06-21,0,0,0,0,FR_CVL_28,757,134,522
2020-06-22,0,0,0,0,FR_CVL_28,757,134,522
2020-06-23,1,0,0,1,FR_CVL_28,758,134,523
2020-06-24,1,0,0,2,FR_CVL_28,759,134,525
2020-03-19,11,0,0,3,FR_BRE_29,11,0,3
2020-03-20,1,0,1,0,FR_BRE_29,12,1,3
2020-03-21,0,1,0,0,FR_BRE_29,12,1,3
2020-03-22,6,0,1,3,FR_BRE_29,18,2,6
2020-03-23,6,2,2,0,FR_BRE_29,24,4,6
2020-03-24,9,3,1,5,FR_BRE_29,33,5,11
2020-03-25,9,3,0,3,FR_BRE_29,42,5,14
2020-03-26,10,1,0,3,FR_BRE_29,52,5,17
2020-03-27,5,1,0,3,FR_BRE_29,57,5,20
2020-03-28,13,8,0,2,FR_BRE_29,70,5,22
2020-03-29,6,0,0,3,FR_BRE_29,76,5,25
2020-03-30,7,3,1,1,FR_BRE_29,83,6,26
2020-03-31,5,2,1,8,FR_BRE_29,88,7,34
2020-04-01,11,5,0,4,FR_BRE_29,99,7,38
2020-04-02,6,2,0,8,FR_BRE_29,105,7,46
2020-04-03,12,3,0,7,FR_BRE_29,117,7,53
2020-04-04,7,1,1,1,FR_BRE_29,124,8,54
2020-04-05,6,1,1,3,FR_BRE_29,130,9,57
2020-04-06,3,0,0,1,FR_BRE_29,133,9,58
2020-04-07,2,1,0,3,FR_BRE_29,135,9,61
2020-04-08,14,1,2,4,FR_BRE_29,149,11,65
2020-04-09,9,0,0,3,FR_BRE_29,158,11,68
2020-04-10,10,1,1,9,FR_BRE_29,168,12,77
2020-04-11,11,1,1,4,FR_BRE_29,179,13,81
2020-04-12,7,1,0,1,FR_BRE_29,186,13,82
2020-04-13,3,1,3,2,FR_BRE_29,189,16,84
2020-04-14,4,1,3,2,FR_BRE_29,193,19,86
2020-04-15,1,1,1,3,FR_BRE_29,194,20,89
2020-04-16,5,1,4,8,FR_BRE_29,199,24,97
2020-04-17,1,0,2,5,FR_BRE_29,200,26,102
2020-04-18,5,2,4,1,FR_BRE_29,205,30,103
2020-04-19,2,0,0,2,FR_BRE_29,207,30,105
2020-04-20,0,0,1,3,FR_BRE_29,207,31,108
2020-04-21,2,0,0,6,FR_BRE_29,209,31,114
2020-04-22,3,1,0,6,FR_BRE_29,212,31,120
2020-04-23,3,0,3,2,FR_BRE_29,215,34,122
2020-04-24,2,1,0,0,FR_BRE_29,217,34,122
2020-04-25,1,0,1,1,FR_BRE_29,218,35,123
2020-04-26,0,0,1,0,FR_BRE_29,218,36,123
2020-04-27,0,0,0,1,FR_BRE_29,218,36,124
2020-04-28,0,0,1,3,FR_BRE_29,218,37,127
2020-04-29,0,0,0,2,FR_BRE_29,218,37,129
2020-04-30,0,0,0,0,FR_BRE_29,218,37,129
2020-05-01,0,0,0,5,FR_BRE_29,218,37,134
2020-05-02,1,0,0,0,FR_BRE_29,219,37,134
2020-05-03,0,0,0,1,FR_BRE_29,219,37,135
2020-05-04,0,0,1,0,FR_BRE_29,219,38,135
2020-05-05,1,1,0,1,FR_BRE_29,220,38,136
2020-05-06,1,0,0,0,FR_BRE_29,221,38,136
2020-05-07,2,0,0,2,FR_BRE_29,223,38,138
2020-05-08,2,2,0,3,FR_BRE_29,225,38,141
2020-05-09,1,0,1,0,FR_BRE_29,226,39,141
2020-05-10,0,0,0,0,FR_BRE_29,226,39,141
2020-05-11,1,0,0,2,FR_BRE_29,227,39,143
2020-05-12,0,0,0,4,FR_BRE_29,227,39,147
2020-05-13,0,0,0,1,FR_BRE_29,227,39,148
2020-05-14,1,0,1,2,FR_BRE_29,228,40,150
2020-05-15,0,0,0,5,FR_BRE_29,228,40,155
2020-05-16,1,0,0,3,FR_BRE_29,229,40,158
2020-05-17,0,0,0,0,FR_BRE_29,229,40,158
2020-05-18,0,0,0,0,FR_BRE_29,229,40,158
2020-05-19,1,0,1,1,FR_BRE_29,230,41,159
2020-05-20,0,0,0,1,FR_BRE_29,230,41,160
2020-05-21,0,0,0,1,FR_BRE_29,230,41,161
2020-05-22,1,0,1,0,FR_BRE_29,231,42,161
2020-05-23,1,0,0,1,FR_BRE_29,232,42,162
2020-05-24,0,0,0,0,FR_BRE_29,232,42,162
2020-05-25,0,0,0,0,FR_BRE_29,232,42,162
2020-05-26,0,0,1,0,FR_BRE_29,232,43,162
2020-05-27,2,0,0,0,FR_BRE_29,234,43,162
2020-05-28,0,0,0,0,FR_BRE_29,234,43,162
2020-05-29,0,0,0,1,FR_BRE_29,234,43,163
2020-05-30,0,0,0,0,FR_BRE_29,234,43,163
2020-05-31,0,0,0,0,FR_BRE_29,234,43,163
2020-06-01,1,0,0,1,FR_BRE_29,235,43,164
2020-06-02,0,0,0,0,FR_BRE_29,235,43,164
2020-06-03,0,0,0,0,FR_BRE_29,235,43,164
2020-06-04,1,0,0,0,FR_BRE_29,236,43,164
2020-06-05,0,0,0,1,FR_BRE_29,236,43,165
2020-06-06,0,0,0,1,FR_BRE_29,236,43,166
2020-06-07,0,0,0,0,FR_BRE_29,236,43,166
2020-06-08,0,0,0,3,FR_BRE_29,236,43,169
2020-06-09,0,0,0,0,FR_BRE_29,236,43,169
2020-06-10,0,0,0,0,FR_BRE_29,236,43,169
2020-06-11,0,0,0,1,FR_BRE_29,236,43,170
2020-06-12,0,0,0,1,FR_BRE_29,236,43,171
2020-06-13,0,1,0,0,FR_BRE_29,236,43,171
2020-06-14,0,0,0,0,FR_BRE_29,236,43,171
2020-06-15,0,0,0,0,FR_BRE_29,236,43,171
2020-06-16,0,0,0,0,FR_BRE_29,236,43,171
2020-06-17,0,0,0,0,FR_BRE_29,236,43,171
2020-06-18,0,0,0,0,FR_BRE_29,236,43,171
2020-06-19,0,0,0,0,FR_BRE_29,236,43,171
2020-06-20,0,0,0,0,FR_BRE_29,236,43,171
2020-06-21,0,0,0,0,FR_BRE_29,236,43,171
2020-06-22,0,0,0,1,FR_BRE_29,236,43,172
2020-06-23,0,0,0,0,FR_BRE_29,236,43,172
2020-06-24,0,0,0,1,FR_BRE_29,236,43,173
2020-03-19,1,1,1,1,FR_OCC_30,1,1,1
2020-03-20,4,0,0,0,FR_OCC_30,5,1,1
2020-03-21,4,0,0,4,FR_OCC_30,9,1,5
2020-03-22,5,0,1,0,FR_OCC_30,14,2,5
2020-03-23,3,4,0,1,FR_OCC_30,17,2,6
2020-03-24,4,4,2,3,FR_OCC_30,21,4,9
2020-03-25,7,2,1,1,FR_OCC_30,28,5,10
2020-03-26,0,2,0,2,FR_OCC_30,28,5,12
2020-03-27,11,0,1,2,FR_OCC_30,39,6,14
2020-03-28,12,4,0,0,FR_OCC_30,51,6,14
2020-03-29,6,2,3,0,FR_OCC_30,57,9,14
2020-03-30,5,4,0,0,FR_OCC_30,62,9,14
2020-03-31,18,5,1,5,FR_OCC_30,80,10,19
2020-04-01,20,5,0,1,FR_OCC_30,100,10,20
2020-04-02,10,6,1,9,FR_OCC_30,110,11,29
2020-04-03,2,2,2,5,FR_OCC_30,112,13,34
2020-04-04,0,0,1,3,FR_OCC_30,112,14,37
2020-04-05,24,7,0,1,FR_OCC_30,136,14,38
2020-04-06,20,5,3,3,FR_OCC_30,156,17,41
2020-04-07,13,2,0,12,FR_OCC_30,169,17,53
2020-04-08,8,2,4,10,FR_OCC_30,177,21,63
2020-04-09,8,1,0,6,FR_OCC_30,185,21,69
2020-04-10,14,3,1,12,FR_OCC_30,199,22,81
2020-04-11,3,3,1,13,FR_OCC_30,202,23,94
2020-04-12,3,0,3,1,FR_OCC_30,205,26,95
2020-04-13,0,0,1,2,FR_OCC_30,205,27,97
2020-04-14,12,0,1,6,FR_OCC_30,217,28,103
2020-04-15,13,2,0,5,FR_OCC_30,230,28,108
2020-04-16,14,1,1,15,FR_OCC_30,244,29,123
2020-04-17,24,4,3,2,FR_OCC_30,268,32,125
2020-04-18,2,0,0,9,FR_OCC_30,270,32,134
2020-04-19,4,1,0,0,FR_OCC_30,274,32,134
2020-04-20,27,5,3,6,FR_OCC_30,301,35,140
2020-04-21,14,0,2,1,FR_OCC_30,315,37,141
2020-04-22,5,1,1,0,FR_OCC_30,320,38,141
2020-04-23,5,0,6,19,FR_OCC_30,325,44,160
2020-04-24,8,3,3,11,FR_OCC_30,333,47,171
2020-04-25,0,0,3,0,FR_OCC_30,333,50,171
2020-04-26,3,0,0,1,FR_OCC_30,336,50,172
2020-04-27,12,2,6,4,FR_OCC_30,348,56,176
2020-04-28,4,3,1,7,FR_OCC_30,352,57,183
2020-04-29,8,2,1,2,FR_OCC_30,360,58,185
2020-04-30,7,2,4,3,FR_OCC_30,367,62,188
2020-05-01,0,0,0,0,FR_OCC_30,367,62,188
2020-05-02,1,0,0,0,FR_OCC_30,368,62,188
2020-05-03,0,0,0,0,FR_OCC_30,368,62,188
2020-05-04,2,1,9,14,FR_OCC_30,370,71,202
2020-05-05,18,3,2,7,FR_OCC_30,388,73,209
2020-05-06,2,0,0,3,FR_OCC_30,390,73,212
2020-05-07,6,2,4,17,FR_OCC_30,396,77,229
2020-05-08,0,0,1,2,FR_OCC_30,396,78,231
2020-05-09,0,0,0,1,FR_OCC_30,396,78,232
2020-05-10,0,0,0,0,FR_OCC_30,396,78,232
2020-05-11,2,0,0,0,FR_OCC_30,398,78,232
2020-05-12,12,5,4,17,FR_OCC_30,410,82,249
2020-05-13,1,0,0,2,FR_OCC_30,411,82,251
2020-05-14,5,1,1,8,FR_OCC_30,416,83,259
2020-05-15,0,0,0,0,FR_OCC_30,416,83,259
2020-05-16,1,1,1,0,FR_OCC_30,417,84,259
2020-05-17,0,0,0,0,FR_OCC_30,417,84,259
2020-05-18,5,1,1,14,FR_OCC_30,422,85,273
2020-05-19,0,0,1,0,FR_OCC_30,422,86,273
2020-05-20,9,0,3,8,FR_OCC_30,431,89,281
2020-05-21,2,0,0,0,FR_OCC_30,433,89,281
2020-05-22,0,0,0,0,FR_OCC_30,433,89,281
2020-05-23,0,0,0,2,FR_OCC_30,433,89,283
2020-05-24,0,0,0,0,FR_OCC_30,433,89,283
2020-05-25,0,0,3,5,FR_OCC_30,433,92,288
2020-05-26,12,2,1,0,FR_OCC_30,445,93,288
2020-05-27,0,0,0,1,FR_OCC_30,445,93,289
2020-05-28,1,2,0,4,FR_OCC_30,446,93,293
2020-05-29,0,0,0,0,FR_OCC_30,446,93,293
2020-05-30,0,0,0,0,FR_OCC_30,446,93,293
2020-05-31,0,0,0,0,FR_OCC_30,446,93,293
2020-06-01,0,0,0,0,FR_OCC_30,446,93,293
2020-06-02,6,2,0,2,FR_OCC_30,452,93,295
2020-06-03,1,0,1,11,FR_OCC_30,453,94,306
2020-06-04,1,0,0,0,FR_OCC_30,454,94,306
2020-06-05,0,0,0,0,FR_OCC_30,454,94,306
2020-06-06,2,0,1,6,FR_OCC_30,456,95,312
2020-06-07,0,0,0,0,FR_OCC_30,456,95,312
2020-06-08,0,0,0,0,FR_OCC_30,456,95,312
2020-06-09,0,0,0,3,FR_OCC_30,456,95,315
2020-06-10,0,0,0,2,FR_OCC_30,456,95,317
2020-06-11,0,0,0,0,FR_OCC_30,456,95,317
2020-06-12,1,1,2,10,FR_OCC_30,457,97,327
2020-06-13,0,0,0,0,FR_OCC_30,457,97,327
2020-06-14,0,0,0,0,FR_OCC_30,457,97,327
2020-06-15,0,0,0,0,FR_OCC_30,457,97,327
2020-06-16,0,0,0,13,FR_OCC_30,457,97,340
2020-06-17,0,0,0,0,FR_OCC_30,457,97,340
2020-06-18,0,0,0,0,FR_OCC_30,457,97,340
2020-06-19,1,0,0,0,FR_OCC_30,458,97,340
2020-06-20,0,0,0,5,FR_OCC_30,458,97,345
2020-06-21,0,0,0,0,FR_OCC_30,458,97,345
2020-06-22,0,0,0,0,FR_OCC_30,458,97,345
2020-06-23,0,0,0,0,FR_OCC_30,458,97,345
2020-06-24,0,0,0,0,FR_OCC_30,458,97,345
2020-03-19,8,3,1,4,FR_OCC_31,8,1,4
2020-03-20,13,5,1,0,FR_OCC_31,21,2,4
2020-03-21,19,4,0,6,FR_OCC_31,40,2,10
2020-03-22,14,3,0,2,FR_OCC_31,54,2,12
2020-03-23,16,6,0,3,FR_OCC_31,70,2,15
2020-03-24,28,9,1,13,FR_OCC_31,98,3,28
2020-03-25,28,11,0,6,FR_OCC_31,126,3,34
2020-03-26,35,18,0,5,FR_OCC_31,161,3,39
2020-03-27,23,8,2,3,FR_OCC_31,184,5,42
2020-03-28,17,6,1,10,FR_OCC_31,201,6,52
2020-03-29,25,8,1,3,FR_OCC_31,226,7,55
2020-03-30,34,15,0,5,FR_OCC_31,260,7,60
2020-03-31,27,8,0,20,FR_OCC_31,287,7,80
2020-04-01,21,11,4,18,FR_OCC_31,308,11,98
2020-04-02,19,9,2,17,FR_OCC_31,327,13,115
2020-04-03,15,2,0,11,FR_OCC_31,342,13,126
2020-04-04,13,7,1,14,FR_OCC_31,355,14,140
2020-04-05,4,2,1,6,FR_OCC_31,359,15,146
2020-04-06,13,8,2,5,FR_OCC_31,372,17,151
2020-04-07,16,2,3,17,FR_OCC_31,388,20,168
2020-04-08,10,9,2,13,FR_OCC_31,398,22,181
2020-04-09,42,4,2,22,FR_OCC_31,440,24,203
2020-04-10,25,4,3,15,FR_OCC_31,465,27,218
2020-04-11,14,3,2,21,FR_OCC_31,479,29,239
2020-04-12,11,1,0,9,FR_OCC_31,490,29,248
2020-04-13,4,0,0,5,FR_OCC_31,494,29,253
2020-04-14,18,4,2,15,FR_OCC_31,512,31,268
2020-04-15,13,5,1,30,FR_OCC_31,525,32,298
2020-04-16,5,2,0,15,FR_OCC_31,530,32,313
2020-04-17,12,4,3,14,FR_OCC_31,542,35,327
2020-04-18,4,0,0,15,FR_OCC_31,546,35,342
2020-04-19,8,3,2,6,FR_OCC_31,554,37,348
2020-04-20,8,0,1,2,FR_OCC_31,562,38,350
2020-04-21,13,0,0,18,FR_OCC_31,575,38,368
2020-04-22,9,2,2,17,FR_OCC_31,584,40,385
2020-04-23,5,1,1,11,FR_OCC_31,589,41,396
2020-04-24,7,1,4,17,FR_OCC_31,596,45,413
2020-04-25,9,0,1,13,FR_OCC_31,605,46,426
2020-04-26,1,0,0,4,FR_OCC_31,606,46,430
2020-04-27,5,1,0,0,FR_OCC_31,611,46,430
2020-04-28,5,0,2,17,FR_OCC_31,616,48,447
2020-04-29,7,1,1,13,FR_OCC_31,623,49,460
2020-04-30,2,1,2,6,FR_OCC_31,625,51,466
2020-05-01,7,0,0,9,FR_OCC_31,632,51,475
2020-05-02,4,2,2,2,FR_OCC_31,636,53,477
2020-05-03,3,0,0,0,FR_OCC_31,639,53,477
2020-05-04,4,0,1,3,FR_OCC_31,643,54,480
2020-05-05,7,2,1,15,FR_OCC_31,650,55,495
2020-05-06,2,1,0,7,FR_OCC_31,652,55,502
2020-05-07,7,0,2,4,FR_OCC_31,659,57,506
2020-05-08,12,3,0,11,FR_OCC_31,671,57,517
2020-05-09,1,1,1,2,FR_OCC_31,672,58,519
2020-05-10,8,1,0,4,FR_OCC_31,680,58,523
2020-05-11,1,0,0,8,FR_OCC_31,681,58,531
2020-05-12,0,0,0,4,FR_OCC_31,681,58,535
2020-05-13,6,2,1,7,FR_OCC_31,687,59,542
2020-05-14,3,0,2,4,FR_OCC_31,690,61,546
2020-05-15,1,1,1,8,FR_OCC_31,691,62,554
2020-05-16,2,1,0,5,FR_OCC_31,693,62,559
2020-05-17,7,1,1,5,FR_OCC_31,700,63,564
2020-05-18,1,0,0,0,FR_OCC_31,701,63,564
2020-05-19,5,0,0,6,FR_OCC_31,706,63,570
2020-05-20,0,0,2,1,FR_OCC_31,706,65,571
2020-05-21,2,0,0,4,FR_OCC_31,708,65,575
2020-05-22,0,0,0,2,FR_OCC_31,708,65,577
2020-05-23,0,0,1,0,FR_OCC_31,708,66,577
2020-05-24,0,0,1,1,FR_OCC_31,708,67,578
2020-05-25,4,1,0,4,FR_OCC_31,712,67,582
2020-05-26,2,1,0,8,FR_OCC_31,714,67,590
2020-05-27,4,0,0,0,FR_OCC_31,718,67,590
2020-05-28,0,0,2,2,FR_OCC_31,718,69,592
2020-05-29,2,0,0,3,FR_OCC_31,720,69,595
2020-05-30,1,0,0,0,FR_OCC_31,721,69,595
2020-05-31,0,0,2,3,FR_OCC_31,721,71,598
2020-06-01,1,0,0,0,FR_OCC_31,722,71,598
2020-06-02,1,0,0,1,FR_OCC_31,723,71,599
2020-06-03,0,0,1,4,FR_OCC_31,723,72,603
2020-06-04,0,0,0,3,FR_OCC_31,723,72,606
2020-06-05,0,0,0,3,FR_OCC_31,723,72,609
2020-06-06,2,0,0,1,FR_OCC_31,725,72,610
2020-06-07,0,0,0,0,FR_OCC_31,725,72,610
2020-06-08,0,0,0,0,FR_OCC_31,725,72,610
2020-06-09,1,0,0,1,FR_OCC_31,726,72,611
2020-06-10,1,0,0,1,FR_OCC_31,727,72,612
2020-06-11,1,1,0,1,FR_OCC_31,728,72,613
2020-06-12,0,0,0,0,FR_OCC_31,728,72,613
2020-06-13,2,0,0,2,FR_OCC_31,730,72,615
2020-06-14,2,0,0,1,FR_OCC_31,732,72,616
2020-06-15,1,0,0,0,FR_OCC_31,733,72,616
2020-06-16,1,0,0,3,FR_OCC_31,734,72,619
2020-06-17,0,0,0,1,FR_OCC_31,734,72,620
2020-06-18,0,0,0,1,FR_OCC_31,734,72,621
2020-06-19,1,0,0,0,FR_OCC_31,735,72,621
2020-06-20,0,0,0,1,FR_OCC_31,735,72,622
2020-06-21,2,0,0,4,FR_OCC_31,737,72,626
2020-06-22,2,0,0,1,FR_OCC_31,739,72,627
2020-06-23,0,1,0,4,FR_OCC_31,739,72,631
2020-06-24,0,0,2,2,FR_OCC_31,739,74,633
2020-03-19,2,2,0,0,FR_OCC_32,2,0,0
2020-03-20,0,0,0,0,FR_OCC_32,2,0,0
2020-03-21,1,0,0,0,FR_OCC_32,3,0,0
2020-03-22,0,0,0,0,FR_OCC_32,3,0,0
2020-03-23,1,0,0,0,FR_OCC_32,4,0,0
2020-03-24,3,0,0,0,FR_OCC_32,7,0,0
2020-03-25,3,0,0,0,FR_OCC_32,10,0,0
2020-03-26,0,0,0,1,FR_OCC_32,10,0,1
2020-03-27,5,1,0,0,FR_OCC_32,15,0,1
2020-03-28,1,0,0,0,FR_OCC_32,16,0,1
2020-03-29,4,0,0,0,FR_OCC_32,20,0,1
2020-03-30,1,0,1,0,FR_OCC_32,21,1,1
2020-03-31,3,0,1,2,FR_OCC_32,24,2,3
2020-04-01,8,0,1,1,FR_OCC_32,32,3,4
2020-04-02,4,1,0,2,FR_OCC_32,36,3,6
2020-04-03,2,0,2,0,FR_OCC_32,38,5,6
2020-04-04,4,0,2,1,FR_OCC_32,42,7,7
2020-04-05,2,1,0,0,FR_OCC_32,44,7,7
2020-04-06,1,0,0,1,FR_OCC_32,45,7,8
2020-04-07,4,0,1,5,FR_OCC_32,49,8,13
2020-04-08,4,0,0,1,FR_OCC_32,53,8,14
2020-04-09,1,1,0,2,FR_OCC_32,54,8,16
2020-04-10,1,0,0,4,FR_OCC_32,55,8,20
2020-04-11,0,0,1,1,FR_OCC_32,55,9,21
2020-04-12,5,0,0,0,FR_OCC_32,60,9,21
2020-04-13,3,0,0,0,FR_OCC_32,63,9,21
2020-04-14,3,0,1,1,FR_OCC_32,66,10,22
2020-04-15,3,0,0,5,FR_OCC_32,69,10,27
2020-04-16,4,0,0,2,FR_OCC_32,73,10,29
2020-04-17,4,1,0,0,FR_OCC_32,77,10,29
2020-04-18,2,0,1,0,FR_OCC_32,79,11,29
2020-04-19,2,0,0,0,FR_OCC_32,81,11,29
2020-04-20,8,2,0,1,FR_OCC_32,89,11,30
2020-04-21,3,0,2,3,FR_OCC_32,92,13,33
2020-04-22,2,1,0,0,FR_OCC_32,94,13,33
2020-04-23,4,0,3,3,FR_OCC_32,98,16,36
2020-04-24,2,1,0,13,FR_OCC_32,100,16,49
2020-04-25,0,0,0,3,FR_OCC_32,100,16,52
2020-04-26,8,0,0,0,FR_OCC_32,108,16,52
2020-04-27,4,0,1,1,FR_OCC_32,112,17,53
2020-04-28,0,0,1,0,FR_OCC_32,112,18,53
2020-04-29,0,0,0,1,FR_OCC_32,112,18,54
2020-04-30,0,0,0,1,FR_OCC_32,112,18,55
2020-05-01,0,0,0,3,FR_OCC_32,112,18,58
2020-05-02,0,0,0,0,FR_OCC_32,112,18,58
2020-05-03,1,0,0,0,FR_OCC_32,113,18,58
2020-05-04,8,0,2,1,FR_OCC_32,121,20,59
2020-05-05,10,0,0,8,FR_OCC_32,131,20,67
2020-05-06,1,0,1,2,FR_OCC_32,132,21,69
2020-05-07,0,0,1,0,FR_OCC_32,132,22,69
2020-05-08,1,1,1,2,FR_OCC_32,133,23,71
2020-05-09,0,0,0,0,FR_OCC_32,133,23,71
2020-05-10,1,0,0,0,FR_OCC_32,134,23,71
2020-05-11,2,0,0,2,FR_OCC_32,136,23,73
2020-05-12,1,0,0,0,FR_OCC_32,137,23,73
2020-05-13,0,0,0,3,FR_OCC_32,137,23,76
2020-05-14,0,0,0,5,FR_OCC_32,137,23,81
2020-05-15,1,0,1,1,FR_OCC_32,138,24,82
2020-05-16,2,0,0,0,FR_OCC_32,140,24,82
2020-05-17,0,0,0,0,FR_OCC_32,140,24,82
2020-05-18,0,0,0,1,FR_OCC_32,140,24,83
2020-05-19,0,0,0,3,FR_OCC_32,140,24,86
2020-05-20,0,0,0,0,FR_OCC_32,140,24,86
2020-05-21,1,0,0,0,FR_OCC_32,141,24,86
2020-05-22,0,0,0,0,FR_OCC_32,141,24,86
2020-05-23,0,0,0,0,FR_OCC_32,141,24,86
2020-05-24,0,0,0,0,FR_OCC_32,141,24,86
2020-05-25,1,0,0,0,FR_OCC_32,142,24,86
2020-05-26,1,0,0,0,FR_OCC_32,143,24,86
2020-05-27,1,0,0,4,FR_OCC_32,144,24,90
2020-05-28,0,0,0,0,FR_OCC_32,144,24,90
2020-05-29,0,0,0,0,FR_OCC_32,144,24,90
2020-05-30,0,0,0,0,FR_OCC_32,144,24,90
2020-05-31,0,0,0,0,FR_OCC_32,144,24,90
2020-06-01,0,0,0,0,FR_OCC_32,144,24,90
2020-06-02,0,0,0,0,FR_OCC_32,144,24,90
2020-06-03,0,0,0,0,FR_OCC_32,144,24,90
2020-06-04,0,0,0,1,FR_OCC_32,144,24,91
2020-06-05,0,0,0,0,FR_OCC_32,144,24,91
2020-06-06,0,0,0,0,FR_OCC_32,144,24,91
2020-06-07,0,0,0,0,FR_OCC_32,144,24,91
2020-06-08,0,0,0,0,FR_OCC_32,144,24,91
2020-06-09,0,0,0,0,FR_OCC_32,144,24,91
2020-06-10,0,0,0,2,FR_OCC_32,144,24,93
2020-06-11,0,0,0,0,FR_OCC_32,144,24,93
2020-06-12,0,0,0,0,FR_OCC_32,144,24,93
2020-06-13,0,0,0,0,FR_OCC_32,144,24,93
2020-06-14,0,0,0,0,FR_OCC_32,144,24,93
2020-06-15,0,0,0,0,FR_OCC_32,144,24,93
2020-06-16,0,0,0,0,FR_OCC_32,144,24,93
2020-06-17,0,0,0,1,FR_OCC_32,144,24,94
2020-06-18,0,0,0,0,FR_OCC_32,144,24,94
2020-06-19,0,0,0,0,FR_OCC_32,144,24,94
2020-06-20,0,0,0,0,FR_OCC_32,144,24,94
2020-06-21,0,0,0,0,FR_OCC_32,144,24,94
2020-06-22,0,0,0,0,FR_OCC_32,144,24,94
2020-06-23,0,0,0,0,FR_OCC_32,144,24,94
2020-06-24,0,0,0,0,FR_OCC_32,144,24,94
2020-03-19,14,3,1,6,FR_NAQ_33,14,1,6
2020-03-20,5,3,0,3,FR_NAQ_33,19,1,9
2020-03-21,34,12,0,1,FR_NAQ_33,53,1,10
2020-03-22,9,1,0,0,FR_NAQ_33,62,1,10
2020-03-23,22,5,1,6,FR_NAQ_33,84,2,16
2020-03-24,40,21,0,8,FR_NAQ_33,124,2,24
2020-03-25,87,7,3,28,FR_NAQ_33,211,5,52
2020-03-26,44,7,5,17,FR_NAQ_33,255,10,69
2020-03-27,64,12,4,19,FR_NAQ_33,319,14,88
2020-03-28,30,5,4,7,FR_NAQ_33,349,18,95
2020-03-29,29,8,4,9,FR_NAQ_33,378,22,104
2020-03-30,89,13,4,37,FR_NAQ_33,467,26,141
2020-03-31,66,15,5,47,FR_NAQ_33,533,31,188
2020-04-01,49,12,2,38,FR_NAQ_33,582,33,226
2020-04-02,54,8,1,39,FR_NAQ_33,636,34,265
2020-04-03,37,5,3,17,FR_NAQ_33,673,37,282
2020-04-04,15,4,4,23,FR_NAQ_33,688,41,305
2020-04-05,15,2,2,13,FR_NAQ_33,703,43,318
2020-04-06,32,5,5,17,FR_NAQ_33,735,48,335
2020-04-07,28,6,3,19,FR_NAQ_33,763,51,354
2020-04-08,32,7,8,42,FR_NAQ_33,795,59,396
2020-04-09,32,6,4,31,FR_NAQ_33,827,63,427
2020-04-10,25,3,1,21,FR_NAQ_33,852,64,448
2020-04-11,31,2,4,24,FR_NAQ_33,883,68,472
2020-04-12,10,1,4,16,FR_NAQ_33,893,72,488
2020-04-13,22,5,1,8,FR_NAQ_33,915,73,496
2020-04-14,25,1,3,16,FR_NAQ_33,940,76,512
2020-04-15,16,2,2,26,FR_NAQ_33,956,78,538
2020-04-16,15,2,1,19,FR_NAQ_33,971,79,557
2020-04-17,24,4,7,17,FR_NAQ_33,995,86,574
2020-04-18,15,3,5,24,FR_NAQ_33,1010,91,598
2020-04-19,23,4,2,10,FR_NAQ_33,1033,93,608
2020-04-20,22,1,4,9,FR_NAQ_33,1055,97,617
2020-04-21,14,0,4,22,FR_NAQ_33,1069,101,639
2020-04-22,12,3,1,18,FR_NAQ_33,1081,102,657
2020-04-23,24,3,4,31,FR_NAQ_33,1105,106,688
2020-04-24,5,0,3,13,FR_NAQ_33,1110,109,701
2020-04-25,13,0,2,14,FR_NAQ_33,1123,111,715
2020-04-26,8,1,1,5,FR_NAQ_33,1131,112,720
2020-04-27,15,0,2,8,FR_NAQ_33,1146,114,728
2020-04-28,14,1,2,21,FR_NAQ_33,1160,116,749
2020-04-29,7,0,2,14,FR_NAQ_33,1167,118,763
2020-04-30,8,0,4,18,FR_NAQ_33,1175,122,781
2020-05-01,5,1,0,14,FR_NAQ_33,1180,122,795
2020-05-02,3,0,1,3,FR_NAQ_33,1183,123,798
2020-05-03,10,2,1,3,FR_NAQ_33,1193,124,801
2020-05-04,8,1,4,3,FR_NAQ_33,1201,128,804
2020-05-05,14,1,0,17,FR_NAQ_33,1215,128,821
2020-05-06,3,0,3,13,FR_NAQ_33,1218,131,834
2020-05-07,11,1,2,5,FR_NAQ_33,1229,133,839
2020-05-08,3,1,0,5,FR_NAQ_33,1232,133,844
2020-05-09,7,0,4,7,FR_NAQ_33,1239,137,851
2020-05-10,7,0,1,16,FR_NAQ_33,1246,138,867
2020-05-11,2,1,1,1,FR_NAQ_33,1248,139,868
2020-05-12,7,0,3,12,FR_NAQ_33,1255,142,880
2020-05-13,11,1,1,10,FR_NAQ_33,1266,143,890
2020-05-14,9,0,1,5,FR_NAQ_33,1275,144,895
2020-05-15,3,0,0,4,FR_NAQ_33,1278,144,899
2020-05-16,5,0,0,4,FR_NAQ_33,1283,144,903
2020-05-17,0,0,1,0,FR_NAQ_33,1283,145,903
2020-05-18,2,0,2,2,FR_NAQ_33,1285,147,905
2020-05-19,6,2,1,9,FR_NAQ_33,1291,148,914
2020-05-20,2,0,0,7,FR_NAQ_33,1293,148,921
2020-05-21,1,0,0,6,FR_NAQ_33,1294,148,927
2020-05-22,2,1,0,2,FR_NAQ_33,1296,148,929
2020-05-23,4,0,1,5,FR_NAQ_33,1300,149,934
2020-05-24,2,0,0,0,FR_NAQ_33,1302,149,934
2020-05-25,2,0,1,8,FR_NAQ_33,1304,150,942
2020-05-26,1,1,1,4,FR_NAQ_33,1305,151,946
2020-05-27,4,1,0,4,FR_NAQ_33,1309,151,950
2020-05-28,2,0,1,13,FR_NAQ_33,1311,152,963
2020-05-29,1,1,1,3,FR_NAQ_33,1312,153,966
2020-05-30,1,0,0,4,FR_NAQ_33,1313,153,970
2020-05-31,1,1,0,0,FR_NAQ_33,1314,153,970
2020-06-01,1,0,0,0,FR_NAQ_33,1315,153,970
2020-06-02,0,1,0,9,FR_NAQ_33,1315,153,979
2020-06-03,6,0,0,9,FR_NAQ_33,1321,153,988
2020-06-04,6,1,0,5,FR_NAQ_33,1327,153,993
2020-06-05,2,0,1,2,FR_NAQ_33,1329,154,995
2020-06-06,1,0,1,3,FR_NAQ_33,1330,155,998
2020-06-07,0,0,0,0,FR_NAQ_33,1330,155,998
2020-06-08,2,0,0,11,FR_NAQ_33,1332,155,1009
2020-06-09,3,0,1,2,FR_NAQ_33,1335,156,1011
2020-06-10,1,2,0,4,FR_NAQ_33,1336,156,1015
2020-06-11,2,0,0,4,FR_NAQ_33,1338,156,1019
2020-06-12,2,0,0,0,FR_NAQ_33,1340,156,1019
2020-06-13,0,0,0,1,FR_NAQ_33,1340,156,1020
2020-06-14,0,0,0,3,FR_NAQ_33,1340,156,1023
2020-06-15,2,0,1,2,FR_NAQ_33,1342,157,1025
2020-06-16,1,0,1,4,FR_NAQ_33,1343,158,1029
2020-06-17,0,0,0,3,FR_NAQ_33,1343,158,1032
2020-06-18,0,0,0,2,FR_NAQ_33,1343,158,1034
2020-06-19,1,0,0,2,FR_NAQ_33,1344,158,1036
2020-06-20,0,0,0,0,FR_NAQ_33,1344,158,1036
2020-06-21,0,0,0,0,FR_NAQ_33,1344,158,1036
2020-06-22,1,0,0,1,FR_NAQ_33,1345,158,1037
2020-06-23,0,0,0,0,FR_NAQ_33,1345,158,1037
2020-06-24,0,0,0,2,FR_NAQ_33,1345,158,1039
2020-03-19,24,7,2,5,FR_OCC_34,24,2,5
2020-03-20,15,6,1,1,FR_OCC_34,39,3,6
2020-03-21,19,4,0,9,FR_OCC_34,58,3,15
2020-03-22,11,4,2,7,FR_OCC_34,69,5,22
2020-03-23,23,8,3,2,FR_OCC_34,92,8,24
2020-03-24,26,9,1,7,FR_OCC_34,118,9,31
2020-03-25,45,9,3,5,FR_OCC_34,163,12,36
2020-03-26,37,8,3,16,FR_OCC_34,200,15,52
2020-03-27,38,9,2,11,FR_OCC_34,238,17,63
2020-03-28,47,11,3,12,FR_OCC_34,285,20,75
2020-03-29,38,7,2,2,FR_OCC_34,323,22,77
2020-03-30,24,14,1,14,FR_OCC_34,347,23,91
2020-03-31,38,7,5,36,FR_OCC_34,385,28,127
2020-04-01,33,10,6,25,FR_OCC_34,418,34,152
2020-04-02,30,6,4,17,FR_OCC_34,448,38,169
2020-04-03,41,10,4,16,FR_OCC_34,489,42,185
2020-04-04,11,3,8,16,FR_OCC_34,500,50,201
2020-04-05,20,0,1,13,FR_OCC_34,520,51,214
2020-04-06,21,6,2,12,FR_OCC_34,541,53,226
2020-04-07,25,5,3,31,FR_OCC_34,566,56,257
2020-04-08,14,4,3,27,FR_OCC_34,580,59,284
2020-04-09,12,0,2,25,FR_OCC_34,592,61,309
2020-04-10,20,7,8,26,FR_OCC_34,612,69,335
2020-04-11,10,2,4,26,FR_OCC_34,622,73,361
2020-04-12,5,1,0,7,FR_OCC_34,627,73,368
2020-04-13,21,7,2,5,FR_OCC_34,648,75,373
2020-04-14,8,5,7,7,FR_OCC_34,656,82,380
2020-04-15,9,5,5,17,FR_OCC_34,665,87,397
2020-04-16,6,4,1,19,FR_OCC_34,671,88,416
2020-04-17,8,0,0,14,FR_OCC_34,679,88,430
2020-04-18,35,4,1,21,FR_OCC_34,714,89,451
2020-04-19,7,3,0,0,FR_OCC_34,721,89,451
2020-04-20,9,7,4,13,FR_OCC_34,730,93,464
2020-04-21,5,0,2,10,FR_OCC_34,735,95,474
2020-04-22,3,1,0,8,FR_OCC_34,738,95,482
2020-04-23,4,5,1,9,FR_OCC_34,742,96,491
2020-04-24,4,1,1,12,FR_OCC_34,746,97,503
2020-04-25,5,0,0,8,FR_OCC_34,751,97,511
2020-04-26,2,0,0,0,FR_OCC_34,753,97,511
2020-04-27,5,1,1,2,FR_OCC_34,758,98,513
2020-04-28,7,0,2,8,FR_OCC_34,765,100,521
2020-04-29,2,0,2,9,FR_OCC_34,767,102,530
2020-04-30,8,1,1,4,FR_OCC_34,775,103,534
2020-05-01,1,0,0,7,FR_OCC_34,776,103,541
2020-05-02,1,0,3,0,FR_OCC_34,777,106,541
2020-05-03,0,0,0,0,FR_OCC_34,777,106,541
2020-05-04,4,1,0,6,FR_OCC_34,781,106,547
2020-05-05,5,0,6,6,FR_OCC_34,786,112,553
2020-05-06,4,0,1,8,FR_OCC_34,790,113,561
2020-05-07,2,0,0,5,FR_OCC_34,792,113,566
2020-05-08,3,0,0,17,FR_OCC_34,795,113,583
2020-05-09,2,0,0,2,FR_OCC_34,797,113,585
2020-05-10,1,0,0,1,FR_OCC_34,798,113,586
2020-05-11,6,2,1,3,FR_OCC_34,804,114,589
2020-05-12,0,1,0,8,FR_OCC_34,804,114,597
2020-05-13,8,2,0,8,FR_OCC_34,812,114,605
2020-05-14,1,2,1,8,FR_OCC_34,813,115,613
2020-05-15,3,1,0,4,FR_OCC_34,816,115,617
2020-05-16,0,0,0,4,FR_OCC_34,816,115,621
2020-05-17,0,0,0,1,FR_OCC_34,816,115,622
2020-05-18,4,1,1,4,FR_OCC_34,820,116,626
2020-05-19,0,0,0,4,FR_OCC_34,820,116,630
2020-05-20,5,0,1,3,FR_OCC_34,825,117,633
2020-05-21,0,0,0,1,FR_OCC_34,825,117,634
2020-05-22,10,1,1,0,FR_OCC_34,835,118,634
2020-05-23,0,0,0,1,FR_OCC_34,835,118,635
2020-05-24,1,0,0,0,FR_OCC_34,836,118,635
2020-05-25,5,0,0,7,FR_OCC_34,841,118,642
2020-05-26,1,1,1,3,FR_OCC_34,842,119,645
2020-05-27,5,0,0,2,FR_OCC_34,847,119,647
2020-05-28,1,1,0,3,FR_OCC_34,848,119,650
2020-05-29,2,0,0,2,FR_OCC_34,850,119,652
2020-05-30,9,0,0,12,FR_OCC_34,859,119,664
2020-05-31,0,0,0,0,FR_OCC_34,859,119,664
2020-06-01,0,0,0,0,FR_OCC_34,859,119,664
2020-06-02,1,0,0,1,FR_OCC_34,860,119,665
2020-06-03,1,0,0,0,FR_OCC_34,861,119,665
2020-06-04,0,0,0,0,FR_OCC_34,861,119,665
2020-06-05,1,1,1,9,FR_OCC_34,862,120,674
2020-06-06,0,0,0,0,FR_OCC_34,862,120,674
2020-06-07,0,0,0,0,FR_OCC_34,862,120,674
2020-06-08,2,0,0,6,FR_OCC_34,864,120,680
2020-06-09,3,0,0,3,FR_OCC_34,867,120,683
2020-06-10,0,0,0,7,FR_OCC_34,867,120,690
2020-06-11,1,0,1,0,FR_OCC_34,868,121,690
2020-06-12,1,0,0,2,FR_OCC_34,869,121,692
2020-06-13,0,0,0,0,FR_OCC_34,869,121,692
2020-06-14,0,0,0,2,FR_OCC_34,869,121,694
2020-06-15,0,0,1,1,FR_OCC_34,869,122,695
2020-06-16,0,0,0,0,FR_OCC_34,869,122,695
2020-06-17,0,0,0,0,FR_OCC_34,869,122,695
2020-06-18,0,0,0,1,FR_OCC_34,869,122,696
2020-06-19,0,0,0,1,FR_OCC_34,869,122,697
2020-06-20,0,0,0,0,FR_OCC_34,869,122,697
2020-06-21,0,0,0,0,FR_OCC_34,869,122,697
2020-06-22,1,0,0,1,FR_OCC_34,870,122,698
2020-06-23,0,0,0,0,FR_OCC_34,870,122,698
2020-06-24,0,0,0,0,FR_OCC_34,870,122,698
2020-03-19,25,7,0,16,FR_BRE_35,25,0,16
2020-03-20,8,2,1,1,FR_BRE_35,33,1,17
2020-03-21,8,3,0,1,FR_BRE_35,41,1,18
2020-03-22,4,2,0,0,FR_BRE_35,45,1,18
2020-03-23,12,4,0,2,FR_BRE_35,57,1,20
2020-03-24,9,2,1,6,FR_BRE_35,66,2,26
2020-03-25,12,2,0,4,FR_BRE_35,78,2,30
2020-03-26,15,2,0,5,FR_BRE_35,93,2,35
2020-03-27,10,4,1,5,FR_BRE_35,103,3,40
2020-03-28,19,5,2,3,FR_BRE_35,122,5,43
2020-03-29,30,2,0,11,FR_BRE_35,152,5,54
2020-03-30,15,4,2,2,FR_BRE_35,167,7,56
2020-03-31,19,7,2,8,FR_BRE_35,186,9,64
2020-04-01,18,7,1,3,FR_BRE_35,204,10,67
2020-04-02,20,5,2,7,FR_BRE_35,224,12,74
2020-04-03,10,1,4,5,FR_BRE_35,234,16,79
2020-04-04,13,3,1,10,FR_BRE_35,247,17,89
2020-04-05,6,4,0,3,FR_BRE_35,253,17,92
2020-04-06,16,2,3,5,FR_BRE_35,269,20,97
2020-04-07,19,1,3,18,FR_BRE_35,288,23,115
2020-04-08,21,4,4,11,FR_BRE_35,309,27,126
2020-04-09,13,2,0,4,FR_BRE_35,322,27,130
2020-04-10,15,1,9,8,FR_BRE_35,337,36,138
2020-04-11,15,2,3,11,FR_BRE_35,352,39,149
2020-04-12,16,0,0,6,FR_BRE_35,368,39,155
2020-04-13,6,1,1,4,FR_BRE_35,374,40,159
2020-04-14,18,1,4,8,FR_BRE_35,392,44,167
2020-04-15,23,0,4,12,FR_BRE_35,415,48,179
2020-04-16,12,1,1,14,FR_BRE_35,427,49,193
2020-04-17,11,3,2,9,FR_BRE_35,438,51,202
2020-04-18,9,2,5,17,FR_BRE_35,447,56,219
2020-04-19,6,1,4,6,FR_BRE_35,453,60,225
2020-04-20,3,1,1,2,FR_BRE_35,456,61,227
2020-04-21,10,2,3,11,FR_BRE_35,466,64,238
2020-04-22,9,1,0,10,FR_BRE_35,475,64,248
2020-04-23,8,0,3,6,FR_BRE_35,483,67,254
2020-04-24,5,0,0,11,FR_BRE_35,488,67,265
2020-04-25,6,1,1,13,FR_BRE_35,494,68,278
2020-04-26,2,0,0,3,FR_BRE_35,496,68,281
2020-04-27,0,0,1,0,FR_BRE_35,496,69,281
2020-04-28,6,0,3,9,FR_BRE_35,502,72,290
2020-04-29,4,0,0,5,FR_BRE_35,506,72,295
2020-04-30,3,0,0,3,FR_BRE_35,509,72,298
2020-05-01,2,0,0,10,FR_BRE_35,511,72,308
2020-05-02,2,1,2,5,FR_BRE_35,513,74,313
2020-05-03,3,0,2,3,FR_BRE_35,516,76,316
2020-05-04,3,0,1,2,FR_BRE_35,519,77,318
2020-05-05,1,0,0,5,FR_BRE_35,520,77,323
2020-05-06,2,0,1,3,FR_BRE_35,522,78,326
2020-05-07,1,0,0,13,FR_BRE_35,523,78,339
2020-05-08,4,0,0,8,FR_BRE_35,527,78,347
2020-05-09,0,0,0,2,FR_BRE_35,527,78,349
2020-05-10,2,0,0,2,FR_BRE_35,529,78,351
2020-05-11,1,0,2,1,FR_BRE_35,530,80,352
2020-05-12,3,0,1,9,FR_BRE_35,533,81,361
2020-05-13,2,0,0,13,FR_BRE_35,535,81,374
2020-05-14,1,0,0,1,FR_BRE_35,536,81,375
2020-05-15,5,0,1,12,FR_BRE_35,541,82,387
2020-05-16,9,0,2,8,FR_BRE_35,550,84,395
2020-05-17,4,0,0,2,FR_BRE_35,554,84,397
2020-05-18,2,1,0,0,FR_BRE_35,556,84,397
2020-05-19,3,0,0,2,FR_BRE_35,559,84,399
2020-05-20,6,0,0,3,FR_BRE_35,565,84,402
2020-05-21,2,0,1,2,FR_BRE_35,567,85,404
2020-05-22,6,0,0,0,FR_BRE_35,573,85,404
2020-05-23,0,0,0,1,FR_BRE_35,573,85,405
2020-05-24,1,0,0,0,FR_BRE_35,574,85,405
2020-05-25,2,1,1,6,FR_BRE_35,576,86,411
2020-05-26,2,1,0,8,FR_BRE_35,578,86,419
2020-05-27,1,0,1,3,FR_BRE_35,579,87,422
2020-05-28,0,0,0,5,FR_BRE_35,579,87,427
2020-05-29,2,0,0,0,FR_BRE_35,581,87,427
2020-05-30,1,0,0,9,FR_BRE_35,582,87,436
2020-05-31,0,0,0,0,FR_BRE_35,582,87,436
2020-06-01,1,0,1,0,FR_BRE_35,583,88,436
2020-06-02,0,0,0,0,FR_BRE_35,583,88,436
2020-06-03,5,0,1,12,FR_BRE_35,588,89,448
2020-06-04,1,0,0,1,FR_BRE_35,589,89,449
2020-06-05,3,0,0,5,FR_BRE_35,592,89,454
2020-06-06,1,0,0,0,FR_BRE_35,593,89,454
2020-06-07,1,0,0,1,FR_BRE_35,594,89,455
2020-06-08,0,0,0,1,FR_BRE_35,594,89,456
2020-06-09,0,0,0,0,FR_BRE_35,594,89,456
2020-06-10,2,0,0,0,FR_BRE_35,596,89,456
2020-06-11,2,0,0,5,FR_BRE_35,598,89,461
2020-06-12,1,0,0,2,FR_BRE_35,599,89,463
2020-06-13,0,0,0,2,FR_BRE_35,599,89,465
2020-06-14,0,0,0,0,FR_BRE_35,599,89,465
2020-06-15,3,0,0,0,FR_BRE_35,602,89,465
2020-06-16,2,0,0,1,FR_BRE_35,604,89,466
2020-06-17,0,0,0,1,FR_BRE_35,604,89,467
2020-06-18,0,0,0,1,FR_BRE_35,604,89,468
2020-06-19,3,0,0,4,FR_BRE_35,607,89,472
2020-06-20,0,0,0,2,FR_BRE_35,607,89,474
2020-06-21,0,0,0,0,FR_BRE_35,607,89,474
2020-06-22,0,0,0,1,FR_BRE_35,607,89,475
2020-06-23,0,0,0,1,FR_BRE_35,607,89,476
2020-06-24,0,0,0,1,FR_BRE_35,607,89,477
2020-03-19,3,0,0,0,FR_CVL_36,3,0,0
2020-03-20,1,1,0,0,FR_CVL_36,4,0,0
2020-03-21,1,1,0,0,FR_CVL_36,5,0,0
2020-03-22,0,0,0,0,FR_CVL_36,5,0,0
2020-03-23,13,3,2,0,FR_CVL_36,18,2,0
2020-03-24,3,2,0,0,FR_CVL_36,21,2,0
2020-03-25,7,0,3,0,FR_CVL_36,28,5,0
2020-03-26,1,0,0,1,FR_CVL_36,29,5,1
2020-03-27,11,3,2,1,FR_CVL_36,40,7,2
2020-03-28,13,3,1,0,FR_CVL_36,53,8,2
2020-03-29,1,1,1,0,FR_CVL_36,54,9,2
2020-03-30,5,0,2,1,FR_CVL_36,59,11,3
2020-03-31,2,0,2,0,FR_CVL_36,61,13,3
2020-04-01,6,1,4,1,FR_CVL_36,67,17,4
2020-04-02,5,1,0,3,FR_CVL_36,72,17,7
2020-04-03,2,3,0,0,FR_CVL_36,74,17,7
2020-04-04,11,2,0,2,FR_CVL_36,85,17,9
2020-04-05,11,0,1,0,FR_CVL_36,96,18,9
2020-04-06,2,0,3,0,FR_CVL_36,98,21,9
2020-04-07,8,0,2,5,FR_CVL_36,106,23,14
2020-04-08,4,2,2,2,FR_CVL_36,110,25,16
2020-04-09,6,0,0,3,FR_CVL_36,116,25,19
2020-04-10,17,0,4,1,FR_CVL_36,133,29,20
2020-04-11,8,0,1,3,FR_CVL_36,141,30,23
2020-04-12,1,0,2,1,FR_CVL_36,142,32,24
2020-04-13,17,0,6,0,FR_CVL_36,159,38,24
2020-04-14,5,0,0,2,FR_CVL_36,164,38,26
2020-04-15,9,0,0,1,FR_CVL_36,173,38,27
2020-04-16,3,0,0,3,FR_CVL_36,176,38,30
2020-04-17,5,0,1,8,FR_CVL_36,181,39,38
2020-04-18,4,0,2,0,FR_CVL_36,185,41,38
2020-04-19,4,0,3,0,FR_CVL_36,189,44,38
2020-04-20,5,0,2,1,FR_CVL_36,194,46,39
2020-04-21,22,0,4,6,FR_CVL_36,216,50,45
2020-04-22,11,1,6,5,FR_CVL_36,227,56,50
2020-04-23,5,0,1,5,FR_CVL_36,232,57,55
2020-04-24,4,1,1,0,FR_CVL_36,236,58,55
2020-04-25,8,1,2,2,FR_CVL_36,244,60,57
2020-04-26,1,0,1,0,FR_CVL_36,245,61,57
2020-04-27,3,1,2,0,FR_CVL_36,248,63,57
2020-04-28,2,1,1,0,FR_CVL_36,250,64,57
2020-04-29,6,0,0,5,FR_CVL_36,256,64,62
2020-04-30,4,0,0,0,FR_CVL_36,260,64,62
2020-05-01,3,0,1,1,FR_CVL_36,263,65,63
2020-05-02,2,0,0,0,FR_CVL_36,265,65,63
2020-05-03,2,0,0,1,FR_CVL_36,267,65,64
2020-05-04,1,0,3,2,FR_CVL_36,268,68,66
2020-05-05,0,0,1,8,FR_CVL_36,268,69,74
2020-05-06,0,0,0,4,FR_CVL_36,268,69,78
2020-05-07,1,0,0,5,FR_CVL_36,269,69,83
2020-05-08,2,0,0,4,FR_CVL_36,271,69,87
2020-05-09,0,0,1,0,FR_CVL_36,271,70,87
2020-05-10,0,0,0,0,FR_CVL_36,271,70,87
2020-05-11,0,0,1,0,FR_CVL_36,271,71,87
2020-05-12,1,0,0,2,FR_CVL_36,272,71,89
2020-05-13,0,0,0,3,FR_CVL_36,272,71,92
2020-05-14,2,1,1,1,FR_CVL_36,274,72,93
2020-05-15,1,0,0,2,FR_CVL_36,275,72,95
2020-05-16,0,0,0,0,FR_CVL_36,275,72,95
2020-05-17,0,0,1,0,FR_CVL_36,275,73,95
2020-05-18,2,0,0,2,FR_CVL_36,277,73,97
2020-05-19,0,0,1,1,FR_CVL_36,277,74,98
2020-05-20,1,0,0,0,FR_CVL_36,278,74,98
2020-05-21,0,0,1,0,FR_CVL_36,278,75,98
2020-05-22,1,0,0,4,FR_CVL_36,279,75,102
2020-05-23,0,0,0,0,FR_CVL_36,279,75,102
2020-05-24,0,0,0,0,FR_CVL_36,279,75,102
2020-05-25,0,0,1,0,FR_CVL_36,279,76,102
2020-05-26,0,0,0,1,FR_CVL_36,279,76,103
2020-05-27,0,0,0,0,FR_CVL_36,279,76,103
2020-05-28,0,0,0,0,FR_CVL_36,279,76,103
2020-05-29,0,0,0,2,FR_CVL_36,279,76,105
2020-05-30,0,0,0,0,FR_CVL_36,279,76,105
2020-05-31,0,0,0,0,FR_CVL_36,279,76,105
2020-06-01,0,0,0,0,FR_CVL_36,279,76,105
2020-06-02,0,0,0,0,FR_CVL_36,279,76,105
2020-06-03,0,0,0,2,FR_CVL_36,279,76,107
2020-06-04,0,0,0,0,FR_CVL_36,279,76,107
2020-06-05,0,0,0,0,FR_CVL_36,279,76,107
2020-06-06,0,0,0,0,FR_CVL_36,279,76,107
2020-06-07,0,0,0,0,FR_CVL_36,279,76,107
2020-06-08,0,0,0,0,FR_CVL_36,279,76,107
2020-06-09,0,0,1,3,FR_CVL_36,279,77,110
2020-06-10,0,0,0,0,FR_CVL_36,279,77,110
2020-06-11,0,0,0,0,FR_CVL_36,279,77,110
2020-06-12,0,0,0,0,FR_CVL_36,279,77,110
2020-06-13,1,0,1,2,FR_CVL_36,280,78,112
2020-06-14,0,0,0,0,FR_CVL_36,280,78,112
2020-06-15,0,0,0,0,FR_CVL_36,280,78,112
2020-06-16,0,0,0,0,FR_CVL_36,280,78,112
2020-06-17,0,0,1,0,FR_CVL_36,280,79,112
2020-06-18,0,0,0,0,FR_CVL_36,280,79,112
2020-06-19,0,0,0,0,FR_CVL_36,280,79,112
2020-06-20,0,0,0,0,FR_CVL_36,280,79,112
2020-06-21,0,0,0,0,FR_CVL_36,280,79,112
2020-06-22,0,0,0,0,FR_CVL_36,280,79,112
2020-06-23,0,0,0,0,FR_CVL_36,280,79,112
2020-06-24,0,0,0,0,FR_CVL_36,280,79,112
2020-03-19,2,2,0,0,FR_CVL_37,2,0,0
2020-03-20,6,1,1,0,FR_CVL_37,8,1,0
2020-03-21,1,0,0,1,FR_CVL_37,9,1,1
2020-03-22,1,1,0,0,FR_CVL_37,10,1,1
2020-03-23,5,1,1,0,FR_CVL_37,15,2,1
2020-03-24,7,1,0,3,FR_CVL_37,22,2,4
2020-03-25,9,3,1,5,FR_CVL_37,31,3,9
2020-03-26,11,1,0,5,FR_CVL_37,42,3,14
2020-03-27,26,7,0,6,FR_CVL_37,68,3,20
2020-03-28,5,2,1,4,FR_CVL_37,73,4,24
2020-03-29,5,2,0,1,FR_CVL_37,78,4,25
2020-03-30,27,2,0,3,FR_CVL_37,105,4,28
2020-03-31,15,3,1,2,FR_CVL_37,120,5,30
2020-04-01,31,4,6,11,FR_CVL_37,151,11,41
2020-04-02,19,3,1,3,FR_CVL_37,170,12,44
2020-04-03,18,6,4,6,FR_CVL_37,188,16,50
2020-04-04,24,4,1,8,FR_CVL_37,212,17,58
2020-04-05,6,0,1,9,FR_CVL_37,218,18,67
2020-04-06,20,6,4,4,FR_CVL_37,238,22,71
2020-04-07,9,0,1,10,FR_CVL_37,247,23,81
2020-04-08,24,3,2,9,FR_CVL_37,271,25,90
2020-04-09,14,3,5,7,FR_CVL_37,285,30,97
2020-04-10,12,3,2,6,FR_CVL_37,297,32,103
2020-04-11,20,5,3,8,FR_CVL_37,317,35,111
2020-04-12,5,0,3,4,FR_CVL_37,322,38,115
2020-04-13,4,0,0,2,FR_CVL_37,326,38,117
2020-04-14,5,0,2,7,FR_CVL_37,331,40,124
2020-04-15,18,0,2,15,FR_CVL_37,349,42,139
2020-04-16,5,0,2,9,FR_CVL_37,354,44,148
2020-04-17,5,0,3,6,FR_CVL_37,359,47,154
2020-04-18,5,0,3,6,FR_CVL_37,364,50,160
2020-04-19,1,0,1,5,FR_CVL_37,365,51,165
2020-04-20,5,0,2,6,FR_CVL_37,370,53,171
2020-04-21,8,2,0,6,FR_CVL_37,378,53,177
2020-04-22,5,0,2,1,FR_CVL_37,383,55,178
2020-04-23,3,0,1,7,FR_CVL_37,386,56,185
2020-04-24,7,1,1,7,FR_CVL_37,393,57,192
2020-04-25,6,2,1,3,FR_CVL_37,399,58,195
2020-04-26,6,0,0,3,FR_CVL_37,405,58,198
2020-04-27,2,1,1,1,FR_CVL_37,407,59,199
2020-04-28,13,0,1,7,FR_CVL_37,420,60,206
2020-04-29,6,0,0,8,FR_CVL_37,426,60,214
2020-04-30,7,0,0,4,FR_CVL_37,433,60,218
2020-05-01,5,2,1,3,FR_CVL_37,438,61,221
2020-05-02,3,0,0,3,FR_CVL_37,441,61,224
2020-05-03,3,0,0,0,FR_CVL_37,444,61,224
2020-05-04,4,1,4,0,FR_CVL_37,448,65,224
2020-05-05,7,0,2,12,FR_CVL_37,455,67,236
2020-05-06,3,0,0,6,FR_CVL_37,458,67,242
2020-05-07,3,1,1,3,FR_CVL_37,461,68,245
2020-05-08,3,0,0,4,FR_CVL_37,464,68,249
2020-05-09,1,0,1,1,FR_CVL_37,465,69,250
2020-05-10,1,0,1,0,FR_CVL_37,466,70,250
2020-05-11,2,0,1,5,FR_CVL_37,468,71,255
2020-05-12,5,0,2,9,FR_CVL_37,473,73,264
2020-05-13,3,0,0,4,FR_CVL_37,476,73,268
2020-05-14,4,0,2,4,FR_CVL_37,480,75,272
2020-05-15,4,0,0,5,FR_CVL_37,484,75,277
2020-05-16,0,0,0,1,FR_CVL_37,484,75,278
2020-05-17,0,0,0,1,FR_CVL_37,484,75,279
2020-05-18,1,0,1,4,FR_CVL_37,485,76,283
2020-05-19,2,0,2,2,FR_CVL_37,487,78,285
2020-05-20,2,0,1,3,FR_CVL_37,489,79,288
2020-05-21,0,0,0,5,FR_CVL_37,489,79,293
2020-05-22,1,0,0,0,FR_CVL_37,490,79,293
2020-05-23,0,0,0,2,FR_CVL_37,490,79,295
2020-05-24,0,0,0,0,FR_CVL_37,490,79,295
2020-05-25,0,0,0,1,FR_CVL_37,490,79,296
2020-05-26,0,1,1,3,FR_CVL_37,490,80,299
2020-05-27,2,0,1,8,FR_CVL_37,492,81,307
2020-05-28,1,0,0,2,FR_CVL_37,493,81,309
2020-05-29,1,0,0,4,FR_CVL_37,494,81,313
2020-05-30,2,0,0,1,FR_CVL_37,496,81,314
2020-05-31,0,0,0,0,FR_CVL_37,496,81,314
2020-06-01,0,0,1,0,FR_CVL_37,496,82,314
2020-06-02,0,0,0,0,FR_CVL_37,496,82,314
2020-06-03,1,0,0,1,FR_CVL_37,497,82,315
2020-06-04,0,0,0,1,FR_CVL_37,497,82,316
2020-06-05,0,0,0,1,FR_CVL_37,497,82,317
2020-06-06,0,0,0,0,FR_CVL_37,497,82,317
2020-06-07,0,0,0,0,FR_CVL_37,497,82,317
2020-06-08,1,0,1,2,FR_CVL_37,498,83,319
2020-06-09,0,0,0,1,FR_CVL_37,498,83,320
2020-06-10,1,1,0,2,FR_CVL_37,499,83,322
2020-06-11,0,0,1,3,FR_CVL_37,499,84,325
2020-06-12,0,0,0,2,FR_CVL_37,499,84,327
2020-06-13,0,0,0,0,FR_CVL_37,499,84,327
2020-06-14,0,0,0,0,FR_CVL_37,499,84,327
2020-06-15,1,0,0,0,FR_CVL_37,500,84,327
2020-06-16,0,0,0,4,FR_CVL_37,500,84,331
2020-06-17,0,0,0,0,FR_CVL_37,500,84,331
2020-06-18,0,0,0,0,FR_CVL_37,500,84,331
2020-06-19,1,0,2,2,FR_CVL_37,501,86,333
2020-06-20,0,0,0,0,FR_CVL_37,501,86,333
2020-06-21,0,0,0,0,FR_CVL_37,501,86,333
2020-06-22,0,0,0,0,FR_CVL_37,501,86,333
2020-06-23,0,0,0,0,FR_CVL_37,501,86,333
2020-06-24,0,0,0,0,FR_CVL_37,501,86,333
2020-03-19,11,0,0,5,FR_ARA_38,11,0,5
2020-03-20,8,0,0,5,FR_ARA_38,19,0,10
2020-03-21,13,1,0,4,FR_ARA_38,32,0,14
2020-03-22,8,2,1,1,FR_ARA_38,40,1,15
2020-03-23,16,4,1,4,FR_ARA_38,56,2,19
2020-03-24,21,0,0,12,FR_ARA_38,77,2,31
2020-03-25,29,10,0,7,FR_ARA_38,106,2,38
2020-03-26,19,5,1,8,FR_ARA_38,125,3,46
2020-03-27,35,14,0,6,FR_ARA_38,160,3,52
2020-03-28,14,2,2,5,FR_ARA_38,174,5,57
2020-03-29,28,12,2,4,FR_ARA_38,202,7,61
2020-03-30,30,6,3,4,FR_ARA_38,232,10,65
2020-03-31,18,3,2,10,FR_ARA_38,250,12,75
2020-04-01,32,5,2,17,FR_ARA_38,282,14,92
2020-04-02,21,3,1,5,FR_ARA_38,303,15,97
2020-04-03,24,5,5,12,FR_ARA_38,327,20,109
2020-04-04,22,4,2,16,FR_ARA_38,349,22,125
2020-04-05,25,5,2,4,FR_ARA_38,374,24,129
2020-04-06,30,5,2,10,FR_ARA_38,404,26,139
2020-04-07,19,5,3,9,FR_ARA_38,423,29,148
2020-04-08,13,2,5,28,FR_ARA_38,436,34,176
2020-04-09,28,8,3,18,FR_ARA_38,464,37,194
2020-04-10,27,3,3,11,FR_ARA_38,491,40,205
2020-04-11,8,2,4,7,FR_ARA_38,499,44,212
2020-04-12,12,2,3,8,FR_ARA_38,511,47,220
2020-04-13,11,1,1,3,FR_ARA_38,522,48,223
2020-04-14,5,2,4,7,FR_ARA_38,527,52,230
2020-04-15,32,8,7,18,FR_ARA_38,559,59,248
2020-04-16,15,0,3,18,FR_ARA_38,574,62,266
2020-04-17,20,3,1,9,FR_ARA_38,594,63,275
2020-04-18,16,1,2,20,FR_ARA_38,610,65,295
2020-04-19,7,1,3,5,FR_ARA_38,617,68,300
2020-04-20,11,3,6,12,FR_ARA_38,628,74,312
2020-04-21,26,3,7,32,FR_ARA_38,654,81,344
2020-04-22,18,2,3,12,FR_ARA_38,672,84,356
2020-04-23,20,3,5,15,FR_ARA_38,692,89,371
2020-04-24,22,3,6,17,FR_ARA_38,714,95,388
2020-04-25,3,1,0,5,FR_ARA_38,717,95,393
2020-04-26,0,0,1,1,FR_ARA_38,717,96,394
2020-04-27,7,0,2,2,FR_ARA_38,724,98,396
2020-04-28,12,1,4,22,FR_ARA_38,736,102,418
2020-04-29,7,1,1,18,FR_ARA_38,743,103,436
2020-04-30,6,0,4,29,FR_ARA_38,749,107,465
2020-05-01,7,0,0,8,FR_ARA_38,756,107,473
2020-05-02,1,0,0,1,FR_ARA_38,757,107,474
2020-05-03,5,0,1,0,FR_ARA_38,762,108,474
2020-05-04,10,0,2,5,FR_ARA_38,772,110,479
2020-05-05,9,0,3,7,FR_ARA_38,781,113,486
2020-05-06,7,1,1,15,FR_ARA_38,788,114,501
2020-05-07,7,1,2,9,FR_ARA_38,795,116,510
2020-05-08,2,1,0,4,FR_ARA_38,797,116,514
2020-05-09,0,0,2,1,FR_ARA_38,797,118,515
2020-05-10,0,0,0,0,FR_ARA_38,797,118,515
2020-05-11,21,1,3,13,FR_ARA_38,818,121,528
2020-05-12,7,1,2,10,FR_ARA_38,825,123,538
2020-05-13,5,0,0,2,FR_ARA_38,830,123,540
2020-05-14,10,0,1,15,FR_ARA_38,840,124,555
2020-05-15,3,2,3,7,FR_ARA_38,843,127,562
2020-05-16,0,0,0,10,FR_ARA_38,843,127,572
2020-05-17,0,0,0,1,FR_ARA_38,843,127,573
2020-05-18,2,1,0,1,FR_ARA_38,845,127,574
2020-05-19,5,0,6,10,FR_ARA_38,850,133,584
2020-05-20,3,0,0,9,FR_ARA_38,853,133,593
2020-05-21,25,0,2,22,FR_ARA_38,878,135,615
2020-05-22,2,0,0,3,FR_ARA_38,880,135,618
2020-05-23,0,1,2,4,FR_ARA_38,880,137,622
2020-05-24,0,0,0,0,FR_ARA_38,880,137,622
2020-05-25,5,1,4,8,FR_ARA_38,885,141,630
2020-05-26,2,0,1,4,FR_ARA_38,887,142,634
2020-05-27,5,2,1,2,FR_ARA_38,892,143,636
2020-05-28,1,0,0,7,FR_ARA_38,893,143,643
2020-05-29,1,0,1,7,FR_ARA_38,894,144,650
2020-05-30,3,0,0,0,FR_ARA_38,897,144,650
2020-05-31,0,0,2,4,FR_ARA_38,897,146,654
2020-06-01,0,0,0,0,FR_ARA_38,897,146,654
2020-06-02,1,1,2,3,FR_ARA_38,898,148,657
2020-06-03,5,1,1,3,FR_ARA_38,903,149,660
2020-06-04,0,0,0,4,FR_ARA_38,903,149,664
2020-06-05,0,0,0,4,FR_ARA_38,903,149,668
2020-06-06,2,0,0,1,FR_ARA_38,905,149,669
2020-06-07,0,0,0,0,FR_ARA_38,905,149,669
2020-06-08,2,0,2,1,FR_ARA_38,907,151,670
2020-06-09,0,0,0,7,FR_ARA_38,907,151,677
2020-06-10,3,2,2,4,FR_ARA_38,910,153,681
2020-06-11,1,0,0,1,FR_ARA_38,911,153,682
2020-06-12,0,0,0,0,FR_ARA_38,911,153,682
2020-06-13,0,0,0,1,FR_ARA_38,911,153,683
2020-06-14,0,0,0,0,FR_ARA_38,911,153,683
2020-06-15,2,0,0,2,FR_ARA_38,913,153,685
2020-06-16,2,0,0,4,FR_ARA_38,915,153,689
2020-06-17,11,1,0,8,FR_ARA_38,926,153,697
2020-06-18,3,1,1,2,FR_ARA_38,929,154,699
2020-06-19,5,0,0,3,FR_ARA_38,934,154,702
2020-06-20,0,0,0,3,FR_ARA_38,934,154,705
2020-06-21,0,0,0,0,FR_ARA_38,934,154,705
2020-06-22,0,0,1,3,FR_ARA_38,934,155,708
2020-06-23,0,0,0,6,FR_ARA_38,934,155,714
2020-06-24,0,0,0,3,FR_ARA_38,934,155,717
2020-03-19,1,0,0,0,FR_BFC_39,1,0,0
2020-03-20,5,0,0,1,FR_BFC_39,6,0,1
2020-03-21,1,0,0,0,FR_BFC_39,7,0,1
2020-03-22,2,0,0,0,FR_BFC_39,9,0,1
2020-03-23,2,0,0,0,FR_BFC_39,11,0,1
2020-03-24,14,1,0,2,FR_BFC_39,25,0,3
2020-03-25,5,2,0,0,FR_BFC_39,30,0,3
2020-03-26,16,5,0,0,FR_BFC_39,46,0,3
2020-03-27,6,3,0,1,FR_BFC_39,52,0,4
2020-03-28,4,0,1,9,FR_BFC_39,56,1,13
2020-03-29,2,2,0,0,FR_BFC_39,58,1,13
2020-03-30,13,0,1,0,FR_BFC_39,71,2,13
2020-03-31,11,1,1,6,FR_BFC_39,82,3,19
2020-04-01,11,1,1,5,FR_BFC_39,93,4,24
2020-04-02,5,2,0,4,FR_BFC_39,98,4,28
2020-04-03,16,1,6,7,FR_BFC_39,114,10,35
2020-04-04,16,2,3,3,FR_BFC_39,130,13,38
2020-04-05,11,0,1,3,FR_BFC_39,141,14,41
2020-04-06,3,2,3,0,FR_BFC_39,144,17,41
2020-04-07,20,3,1,7,FR_BFC_39,164,18,48
2020-04-08,14,1,1,4,FR_BFC_39,178,19,52
2020-04-09,18,2,4,8,FR_BFC_39,196,23,60
2020-04-10,8,4,1,2,FR_BFC_39,204,24,62
2020-04-11,8,0,2,6,FR_BFC_39,212,26,68
2020-04-12,6,1,1,0,FR_BFC_39,218,27,68
2020-04-13,7,2,1,0,FR_BFC_39,225,28,68
2020-04-14,9,1,2,0,FR_BFC_39,234,30,68
2020-04-15,14,1,2,10,FR_BFC_39,248,32,78
2020-04-16,11,1,2,8,FR_BFC_39,259,34,86
2020-04-17,16,2,0,2,FR_BFC_39,275,34,88
2020-04-18,9,2,3,11,FR_BFC_39,284,37,99
2020-04-19,0,0,0,4,FR_BFC_39,284,37,103
2020-04-20,1,0,0,1,FR_BFC_39,285,37,104
2020-04-21,1,0,2,15,FR_BFC_39,286,39,119
2020-04-22,8,4,1,12,FR_BFC_39,294,40,131
2020-04-23,5,1,3,11,FR_BFC_39,299,43,142
2020-04-24,3,0,0,2,FR_BFC_39,302,43,144
2020-04-25,5,2,0,8,FR_BFC_39,307,43,152
2020-04-26,0,0,0,0,FR_BFC_39,307,43,152
2020-04-27,2,2,1,2,FR_BFC_39,309,44,154
2020-04-28,3,2,0,13,FR_BFC_39,312,44,167
2020-04-29,2,0,0,3,FR_BFC_39,314,44,170
2020-04-30,10,0,2,4,FR_BFC_39,324,46,174
2020-05-01,0,0,0,2,FR_BFC_39,324,46,176
2020-05-02,0,0,0,0,FR_BFC_39,324,46,176
2020-05-03,0,0,0,0,FR_BFC_39,324,46,176
2020-05-04,6,1,2,4,FR_BFC_39,330,48,180
2020-05-05,2,1,0,10,FR_BFC_39,332,48,190
2020-05-06,1,1,0,1,FR_BFC_39,333,48,191
2020-05-07,3,0,1,3,FR_BFC_39,336,49,194
2020-05-08,6,0,0,3,FR_BFC_39,342,49,197
2020-05-09,1,0,3,10,FR_BFC_39,343,52,207
2020-05-10,0,0,0,0,FR_BFC_39,343,52,207
2020-05-11,5,2,3,1,FR_BFC_39,348,55,208
2020-05-12,0,0,1,3,FR_BFC_39,348,56,211
2020-05-13,1,0,0,1,FR_BFC_39,349,56,212
2020-05-14,0,0,0,2,FR_BFC_39,349,56,214
2020-05-15,1,0,1,4,FR_BFC_39,350,57,218
2020-05-16,4,0,1,5,FR_BFC_39,354,58,223
2020-05-17,0,0,0,0,FR_BFC_39,354,58,223
2020-05-18,0,0,0,1,FR_BFC_39,354,58,224
2020-05-19,1,0,0,5,FR_BFC_39,355,58,229
2020-05-20,5,0,0,6,FR_BFC_39,360,58,235
2020-05-21,1,0,0,1,FR_BFC_39,361,58,236
2020-05-22,3,0,1,3,FR_BFC_39,364,59,239
2020-05-23,1,0,0,1,FR_BFC_39,365,59,240
2020-05-24,0,0,0,0,FR_BFC_39,365,59,240
2020-05-25,1,0,0,0,FR_BFC_39,366,59,240
2020-05-26,1,0,1,33,FR_BFC_39,367,60,273
2020-05-27,0,0,0,3,FR_BFC_39,367,60,276
2020-05-28,1,0,1,1,FR_BFC_39,368,61,277
2020-05-29,23,0,0,16,FR_BFC_39,391,61,293
2020-05-30,0,0,0,2,FR_BFC_39,391,61,295
2020-05-31,0,0,0,0,FR_BFC_39,391,61,295
2020-06-01,0,0,0,0,FR_BFC_39,391,61,295
2020-06-02,0,0,0,3,FR_BFC_39,391,61,298
2020-06-03,0,0,0,1,FR_BFC_39,391,61,299
2020-06-04,0,0,0,1,FR_BFC_39,391,61,300
2020-06-05,0,1,0,2,FR_BFC_39,391,61,302
2020-06-06,0,0,0,0,FR_BFC_39,391,61,302
2020-06-07,0,0,0,0,FR_BFC_39,391,61,302
2020-06-08,0,0,0,1,FR_BFC_39,391,61,303
2020-06-09,0,0,0,0,FR_BFC_39,391,61,303
2020-06-10,0,0,0,1,FR_BFC_39,391,61,304
2020-06-11,0,0,0,0,FR_BFC_39,391,61,304
2020-06-12,0,0,0,0,FR_BFC_39,391,61,304
2020-06-13,0,0,0,1,FR_BFC_39,391,61,305
2020-06-14,0,0,0,0,FR_BFC_39,391,61,305
2020-06-15,1,0,0,0,FR_BFC_39,392,61,305
2020-06-16,0,0,0,2,FR_BFC_39,392,61,307
2020-06-17,0,0,0,6,FR_BFC_39,392,61,313
2020-06-18,0,0,0,0,FR_BFC_39,392,61,313
2020-06-19,1,0,0,2,FR_BFC_39,393,61,315
2020-06-20,0,0,0,0,FR_BFC_39,393,61,315
2020-06-21,0,0,0,0,FR_BFC_39,393,61,315
2020-06-22,0,0,0,1,FR_BFC_39,393,61,316
2020-06-23,1,0,0,0,FR_BFC_39,394,61,316
2020-06-24,1,0,0,0,FR_BFC_39,395,61,316
2020-03-19,0,0,0,0,FR_NAQ_40,0,0,0
2020-03-20,0,0,0,0,FR_NAQ_40,0,0,0
2020-03-21,0,0,0,0,FR_NAQ_40,0,0,0
2020-03-22,0,0,0,0,FR_NAQ_40,0,0,0
2020-03-23,4,0,0,0,FR_NAQ_40,4,0,0
2020-03-24,0,0,0,0,FR_NAQ_40,4,0,0
2020-03-25,7,3,0,1,FR_NAQ_40,11,0,1
2020-03-26,0,1,0,1,FR_NAQ_40,11,0,2
2020-03-27,2,0,0,0,FR_NAQ_40,13,0,2
2020-03-28,2,0,0,3,FR_NAQ_40,15,0,5
2020-03-29,2,0,0,0,FR_NAQ_40,17,0,5
2020-03-30,6,1,1,1,FR_NAQ_40,23,1,6
2020-03-31,1,1,0,1,FR_NAQ_40,24,1,7
2020-04-01,1,1,0,0,FR_NAQ_40,25,1,7
2020-04-02,4,0,0,3,FR_NAQ_40,29,1,10
2020-04-03,2,1,0,2,FR_NAQ_40,31,1,12
2020-04-04,1,1,0,0,FR_NAQ_40,32,1,12
2020-04-05,1,0,0,1,FR_NAQ_40,33,1,13
2020-04-06,9,3,3,7,FR_NAQ_40,42,4,20
2020-04-07,11,0,2,4,FR_NAQ_40,53,6,24
2020-04-08,4,1,0,1,FR_NAQ_40,57,6,25
2020-04-09,7,0,2,4,FR_NAQ_40,64,8,29
2020-04-10,1,0,2,2,FR_NAQ_40,65,10,31
2020-04-11,0,0,0,0,FR_NAQ_40,65,10,31
2020-04-12,0,0,1,0,FR_NAQ_40,65,11,31
2020-04-13,0,0,0,0,FR_NAQ_40,65,11,31
2020-04-14,4,1,0,1,FR_NAQ_40,69,11,32
2020-04-15,2,0,0,0,FR_NAQ_40,71,11,32
2020-04-16,3,0,0,1,FR_NAQ_40,74,11,33
2020-04-17,3,0,0,1,FR_NAQ_40,77,11,34
2020-04-18,0,0,0,1,FR_NAQ_40,77,11,35
2020-04-19,0,0,0,0,FR_NAQ_40,77,11,35
2020-04-20,1,1,0,3,FR_NAQ_40,78,11,38
2020-04-21,1,0,0,0,FR_NAQ_40,79,11,38
2020-04-22,0,0,0,1,FR_NAQ_40,79,11,39
2020-04-23,1,1,0,2,FR_NAQ_40,80,11,41
2020-04-24,2,0,0,2,FR_NAQ_40,82,11,43
2020-04-25,0,0,0,1,FR_NAQ_40,82,11,44
2020-04-26,0,0,0,0,FR_NAQ_40,82,11,44
2020-04-27,0,0,0,1,FR_NAQ_40,82,11,45
2020-04-28,0,0,0,3,FR_NAQ_40,82,11,48
2020-04-29,0,0,0,3,FR_NAQ_40,82,11,51
2020-04-30,8,0,0,4,FR_NAQ_40,90,11,55
2020-05-01,0,0,0,0,FR_NAQ_40,90,11,55
2020-05-02,0,0,0,0,FR_NAQ_40,90,11,55
2020-05-03,0,0,0,0,FR_NAQ_40,90,11,55
2020-05-04,0,0,0,3,FR_NAQ_40,90,11,58
2020-05-05,0,0,0,1,FR_NAQ_40,90,11,59
2020-05-06,0,0,0,0,FR_NAQ_40,90,11,59
2020-05-07,0,0,0,0,FR_NAQ_40,90,11,59
2020-05-08,0,0,0,0,FR_NAQ_40,90,11,59
2020-05-09,0,0,0,0,FR_NAQ_40,90,11,59
2020-05-10,0,0,0,0,FR_NAQ_40,90,11,59
2020-05-11,0,0,2,0,FR_NAQ_40,90,13,59
2020-05-12,0,0,0,1,FR_NAQ_40,90,13,60
2020-05-13,0,0,0,1,FR_NAQ_40,90,13,61
2020-05-14,0,0,0,0,FR_NAQ_40,90,13,61
2020-05-15,0,0,0,0,FR_NAQ_40,90,13,61
2020-05-16,0,0,0,0,FR_NAQ_40,90,13,61
2020-05-17,0,0,0,0,FR_NAQ_40,90,13,61
2020-05-18,1,0,0,0,FR_NAQ_40,91,13,61
2020-05-19,0,0,0,0,FR_NAQ_40,91,13,61
2020-05-20,0,0,0,3,FR_NAQ_40,91,13,64
2020-05-21,0,0,0,0,FR_NAQ_40,91,13,64
2020-05-22,0,0,0,0,FR_NAQ_40,91,13,64
2020-05-23,0,0,0,0,FR_NAQ_40,91,13,64
2020-05-24,0,0,0,0,FR_NAQ_40,91,13,64
2020-05-25,1,1,0,0,FR_NAQ_40,92,13,64
2020-05-26,0,0,0,0,FR_NAQ_40,92,13,64
2020-05-27,0,0,0,0,FR_NAQ_40,92,13,64
2020-05-28,0,0,0,1,FR_NAQ_40,92,13,65
2020-05-29,0,0,0,1,FR_NAQ_40,92,13,66
2020-05-30,0,0,0,0,FR_NAQ_40,92,13,66
2020-05-31,0,0,0,0,FR_NAQ_40,92,13,66
2020-06-01,0,0,0,0,FR_NAQ_40,92,13,66
2020-06-02,0,0,0,0,FR_NAQ_40,92,13,66
2020-06-03,0,0,0,1,FR_NAQ_40,92,13,67
2020-06-04,0,0,0,1,FR_NAQ_40,92,13,68
2020-06-05,3,0,0,3,FR_NAQ_40,95,13,71
2020-06-06,0,0,0,0,FR_NAQ_40,95,13,71
2020-06-07,0,0,0,0,FR_NAQ_40,95,13,71
2020-06-08,0,0,0,1,FR_NAQ_40,95,13,72
2020-06-09,0,0,1,0,FR_NAQ_40,95,14,72
2020-06-10,0,0,0,0,FR_NAQ_40,95,14,72
2020-06-11,0,0,0,0,FR_NAQ_40,95,14,72
2020-06-12,0,0,0,0,FR_NAQ_40,95,14,72
2020-06-13,0,0,0,0,FR_NAQ_40,95,14,72
2020-06-14,0,0,0,0,FR_NAQ_40,95,14,72
2020-06-15,0,0,0,0,FR_NAQ_40,95,14,72
2020-06-16,0,0,0,0,FR_NAQ_40,95,14,72
2020-06-17,0,0,0,0,FR_NAQ_40,95,14,72
2020-06-18,0,0,0,0,FR_NAQ_40,95,14,72
2020-06-19,0,0,0,0,FR_NAQ_40,95,14,72
2020-06-20,0,0,0,0,FR_NAQ_40,95,14,72
2020-06-21,0,0,0,0,FR_NAQ_40,95,14,72
2020-06-22,0,0,0,0,FR_NAQ_40,95,14,72
2020-06-23,0,0,0,0,FR_NAQ_40,95,14,72
2020-06-24,0,0,0,0,FR_NAQ_40,95,14,72
2020-03-19,3,0,0,1,FR_CVL_41,3,0,1
2020-03-20,3,1,0,0,FR_CVL_41,6,0,1
2020-03-21,0,0,0,0,FR_CVL_41,6,0,1
2020-03-22,1,0,0,0,FR_CVL_41,7,0,1
2020-03-23,4,1,0,1,FR_CVL_41,11,0,2
2020-03-24,9,0,0,5,FR_CVL_41,20,0,7
2020-03-25,2,1,0,1,FR_CVL_41,22,0,8
2020-03-26,6,1,0,1,FR_CVL_41,28,0,9
2020-03-27,8,2,0,0,FR_CVL_41,36,0,9
2020-03-28,12,0,3,4,FR_CVL_41,48,3,13
2020-03-29,2,1,0,0,FR_CVL_41,50,3,13
2020-03-30,23,1,1,3,FR_CVL_41,73,4,16
2020-03-31,5,5,0,3,FR_CVL_41,78,4,19
2020-04-01,17,3,3,1,FR_CVL_41,95,7,20
2020-04-02,17,5,0,1,FR_CVL_41,112,7,21
2020-04-03,11,0,3,15,FR_CVL_41,123,10,36
2020-04-04,4,1,2,2,FR_CVL_41,127,12,38
2020-04-05,1,0,0,2,FR_CVL_41,128,12,40
2020-04-06,18,2,1,1,FR_CVL_41,146,13,41
2020-04-07,11,0,1,6,FR_CVL_41,157,14,47
2020-04-08,10,1,2,4,FR_CVL_41,167,16,51
2020-04-09,13,5,0,2,FR_CVL_41,180,16,53
2020-04-10,4,1,2,10,FR_CVL_41,184,18,63
2020-04-11,6,1,3,3,FR_CVL_41,190,21,66
2020-04-12,3,0,0,0,FR_CVL_41,193,21,66
2020-04-13,4,0,1,1,FR_CVL_41,197,22,67
2020-04-14,12,1,3,2,FR_CVL_41,209,25,69
2020-04-15,3,2,2,6,FR_CVL_41,212,27,75
2020-04-16,7,0,1,4,FR_CVL_41,219,28,79
2020-04-17,10,6,1,4,FR_CVL_41,229,29,83
2020-04-18,5,0,2,1,FR_CVL_41,234,31,84
2020-04-19,1,1,0,0,FR_CVL_41,235,31,84
2020-04-20,17,4,4,7,FR_CVL_41,252,35,91
2020-04-21,5,0,1,5,FR_CVL_41,257,36,96
2020-04-22,7,0,0,7,FR_CVL_41,264,36,103
2020-04-23,6,0,0,4,FR_CVL_41,270,36,107
2020-04-24,9,2,2,2,FR_CVL_41,279,38,109
2020-04-25,7,1,0,3,FR_CVL_41,286,38,112
2020-04-26,2,0,0,0,FR_CVL_41,288,38,112
2020-04-27,8,0,2,2,FR_CVL_41,296,40,114
2020-04-28,2,0,4,9,FR_CVL_41,298,44,123
2020-04-29,15,2,0,6,FR_CVL_41,313,44,129
2020-04-30,23,2,3,10,FR_CVL_41,336,47,139
2020-05-01,4,2,1,2,FR_CVL_41,340,48,141
2020-05-02,4,0,1,1,FR_CVL_41,344,49,142
2020-05-03,4,1,0,0,FR_CVL_41,348,49,142
2020-05-04,1,0,1,6,FR_CVL_41,349,50,148
2020-05-05,10,1,1,4,FR_CVL_41,359,51,152
2020-05-06,2,0,1,8,FR_CVL_41,361,52,160
2020-05-07,9,0,1,4,FR_CVL_41,370,53,164
2020-05-08,0,0,1,3,FR_CVL_41,370,54,167
2020-05-09,2,0,0,1,FR_CVL_41,372,54,168
2020-05-10,4,0,1,0,FR_CVL_41,376,55,168
2020-05-11,6,0,0,0,FR_CVL_41,382,55,168
2020-05-12,2,0,0,5,FR_CVL_41,384,55,173
2020-05-13,4,0,1,9,FR_CVL_41,388,56,182
2020-05-14,4,1,0,8,FR_CVL_41,392,56,190
2020-05-15,7,2,2,7,FR_CVL_41,399,58,197
2020-05-16,0,0,1,1,FR_CVL_41,399,59,198
2020-05-17,0,0,0,0,FR_CVL_41,399,59,198
2020-05-18,5,1,1,5,FR_CVL_41,404,60,203
2020-05-19,1,0,2,5,FR_CVL_41,405,62,208
2020-05-20,2,0,0,6,FR_CVL_41,407,62,214
2020-05-21,0,0,0,0,FR_CVL_41,407,62,214
2020-05-22,0,0,0,0,FR_CVL_41,407,62,214
2020-05-23,1,0,1,3,FR_CVL_41,408,63,217
2020-05-24,0,0,0,0,FR_CVL_41,408,63,217
2020-05-25,2,0,2,1,FR_CVL_41,410,65,218
2020-05-26,0,0,0,5,FR_CVL_41,410,65,223
2020-05-27,0,0,0,1,FR_CVL_41,410,65,224
2020-05-28,1,0,0,10,FR_CVL_41,411,65,234
2020-05-29,0,0,0,3,FR_CVL_41,411,65,237
2020-05-30,0,0,0,2,FR_CVL_41,411,65,239
2020-05-31,0,0,0,0,FR_CVL_41,411,65,239
2020-06-01,0,0,0,0,FR_CVL_41,411,65,239
2020-06-02,2,0,0,2,FR_CVL_41,413,65,241
2020-06-03,0,0,0,3,FR_CVL_41,413,65,244
2020-06-04,0,0,0,1,FR_CVL_41,413,65,245
2020-06-05,0,0,0,2,FR_CVL_41,413,65,247
2020-06-06,0,0,0,0,FR_CVL_41,413,65,247
2020-06-07,0,0,0,0,FR_CVL_41,413,65,247
2020-06-08,0,0,0,0,FR_CVL_41,413,65,247
2020-06-09,0,0,0,0,FR_CVL_41,413,65,247
2020-06-10,0,0,0,3,FR_CVL_41,413,65,250
2020-06-11,0,0,0,0,FR_CVL_41,413,65,250
2020-06-12,0,0,0,0,FR_CVL_41,413,65,250
2020-06-13,0,0,0,0,FR_CVL_41,413,65,250
2020-06-14,0,0,0,0,FR_CVL_41,413,65,250
2020-06-15,0,0,0,0,FR_CVL_41,413,65,250
2020-06-16,0,0,0,0,FR_CVL_41,413,65,250
2020-06-17,0,0,0,2,FR_CVL_41,413,65,252
2020-06-18,0,0,0,0,FR_CVL_41,413,65,252
2020-06-19,0,0,0,0,FR_CVL_41,413,65,252
2020-06-20,1,0,0,0,FR_CVL_41,414,65,252
2020-06-21,0,0,0,0,FR_CVL_41,414,65,252
2020-06-22,0,0,0,0,FR_CVL_41,414,65,252
2020-06-23,0,0,0,0,FR_CVL_41,414,65,252
2020-06-24,0,0,0,0,FR_CVL_41,414,65,252
2020-03-19,32,4,2,5,FR_ARA_42,32,2,5
2020-03-20,13,4,1,1,FR_ARA_42,45,3,6
2020-03-21,22,2,2,5,FR_ARA_42,67,5,11
2020-03-22,30,4,2,2,FR_ARA_42,97,7,13
2020-03-23,24,3,2,4,FR_ARA_42,121,9,17
2020-03-24,46,3,3,6,FR_ARA_42,167,12,23
2020-03-25,59,12,2,3,FR_ARA_42,226,14,26
2020-03-26,40,8,3,3,FR_ARA_42,266,17,29
2020-03-27,28,3,1,13,FR_ARA_42,294,18,42
2020-03-28,69,16,8,3,FR_ARA_42,363,26,45
2020-03-29,77,9,6,14,FR_ARA_42,440,32,59
2020-03-30,32,11,3,11,FR_ARA_42,472,35,70
2020-03-31,40,4,8,7,FR_ARA_42,512,43,77
2020-04-01,44,5,13,29,FR_ARA_42,556,56,106
2020-04-02,42,9,5,14,FR_ARA_42,598,61,120
2020-04-03,57,5,7,32,FR_ARA_42,655,68,152
2020-04-04,29,7,1,12,FR_ARA_42,684,69,164
2020-04-05,19,1,5,13,FR_ARA_42,703,74,177
2020-04-06,40,5,3,13,FR_ARA_42,743,77,190
2020-04-07,33,3,11,31,FR_ARA_42,776,88,221
2020-04-08,26,5,2,28,FR_ARA_42,802,90,249
2020-04-09,30,2,5,25,FR_ARA_42,832,95,274
2020-04-10,31,7,6,33,FR_ARA_42,863,101,307
2020-04-11,27,1,3,17,FR_ARA_42,890,104,324
2020-04-12,43,6,5,16,FR_ARA_42,933,109,340
2020-04-13,4,2,1,4,FR_ARA_42,937,110,344
2020-04-14,23,2,6,17,FR_ARA_42,960,116,361
2020-04-15,41,2,10,31,FR_ARA_42,1001,126,392
2020-04-16,18,3,6,18,FR_ARA_42,1019,132,410
2020-04-17,35,0,2,26,FR_ARA_42,1054,134,436
2020-04-18,12,3,5,24,FR_ARA_42,1066,139,460
2020-04-19,18,4,1,8,FR_ARA_42,1084,140,468
2020-04-20,11,4,5,5,FR_ARA_42,1095,145,473
2020-04-21,22,0,6,26,FR_ARA_42,1117,151,499
2020-04-22,17,3,10,18,FR_ARA_42,1134,161,517
2020-04-23,23,1,5,16,FR_ARA_42,1157,166,533
2020-04-24,10,0,2,13,FR_ARA_42,1167,168,546
2020-04-25,20,3,5,33,FR_ARA_42,1187,173,579
2020-04-26,9,1,3,4,FR_ARA_42,1196,176,583
2020-04-27,11,0,2,5,FR_ARA_42,1207,178,588
2020-04-28,8,0,7,15,FR_ARA_42,1215,185,603
2020-04-29,7,1,1,11,FR_ARA_42,1222,186,614
2020-04-30,14,2,1,18,FR_ARA_42,1236,187,632
2020-05-01,12,2,2,14,FR_ARA_42,1248,189,646
2020-05-02,3,1,2,1,FR_ARA_42,1251,191,647
2020-05-03,4,0,1,1,FR_ARA_42,1255,192,648
2020-05-04,6,2,3,12,FR_ARA_42,1261,195,660
2020-05-05,8,0,3,13,FR_ARA_42,1269,198,673
2020-05-06,5,1,2,16,FR_ARA_42,1274,200,689
2020-05-07,0,2,1,8,FR_ARA_42,1274,201,697
2020-05-08,4,0,0,9,FR_ARA_42,1278,201,706
2020-05-09,2,0,0,4,FR_ARA_42,1280,201,710
2020-05-10,1,0,1,1,FR_ARA_42,1281,202,711
2020-05-11,9,0,6,8,FR_ARA_42,1290,208,719
2020-05-12,20,2,7,10,FR_ARA_42,1310,215,729
2020-05-13,3,1,0,45,FR_ARA_42,1313,215,774
2020-05-14,8,1,1,10,FR_ARA_42,1321,216,784
2020-05-15,2,1,1,5,FR_ARA_42,1323,217,789
2020-05-16,1,0,1,6,FR_ARA_42,1324,218,795
2020-05-17,0,0,0,0,FR_ARA_42,1324,218,795
2020-05-18,0,0,2,3,FR_ARA_42,1324,220,798
2020-05-19,1,0,5,10,FR_ARA_42,1325,225,808
2020-05-20,12,0,3,28,FR_ARA_42,1337,228,836
2020-05-21,1,0,1,2,FR_ARA_42,1338,229,838
2020-05-22,4,1,3,5,FR_ARA_42,1342,232,843
2020-05-23,2,0,0,3,FR_ARA_42,1344,232,846
2020-05-24,2,0,0,0,FR_ARA_42,1346,232,846
2020-05-25,1,0,1,1,FR_ARA_42,1347,233,847
2020-05-26,3,0,3,13,FR_ARA_42,1350,236,860
2020-05-27,2,3,1,6,FR_ARA_42,1352,237,866
2020-05-28,3,0,0,3,FR_ARA_42,1355,237,869
2020-05-29,1,0,1,7,FR_ARA_42,1356,238,876
2020-05-30,0,0,0,0,FR_ARA_42,1356,238,876
2020-05-31,2,0,0,1,FR_ARA_42,1358,238,877
2020-06-01,0,0,1,2,FR_ARA_42,1358,239,879
2020-06-02,1,0,3,15,FR_ARA_42,1359,242,894
2020-06-03,1,0,1,15,FR_ARA_42,1360,243,909
2020-06-04,1,0,0,11,FR_ARA_42,1361,243,920
2020-06-05,2,0,0,7,FR_ARA_42,1363,243,927
2020-06-06,0,0,0,1,FR_ARA_42,1363,243,928
2020-06-07,0,0,0,1,FR_ARA_42,1363,243,929
2020-06-08,0,0,0,2,FR_ARA_42,1363,243,931
2020-06-09,0,0,0,3,FR_ARA_42,1363,243,934
2020-06-10,1,0,0,3,FR_ARA_42,1364,243,937
2020-06-11,0,0,1,1,FR_ARA_42,1364,244,938
2020-06-12,0,0,0,23,FR_ARA_42,1364,244,961
2020-06-13,0,0,0,3,FR_ARA_42,1364,244,964
2020-06-14,0,0,0,0,FR_ARA_42,1364,244,964
2020-06-15,0,0,1,1,FR_ARA_42,1364,245,965
2020-06-16,3,0,1,6,FR_ARA_42,1367,246,971
2020-06-17,0,0,0,2,FR_ARA_42,1367,246,973
2020-06-18,0,0,0,3,FR_ARA_42,1367,246,976
2020-06-19,1,0,0,2,FR_ARA_42,1368,246,978
2020-06-20,0,0,0,1,FR_ARA_42,1368,246,979
2020-06-21,0,0,0,0,FR_ARA_42,1368,246,979
2020-06-22,0,0,0,3,FR_ARA_42,1368,246,982
2020-06-23,0,0,0,4,FR_ARA_42,1368,246,986
2020-06-24,0,0,1,3,FR_ARA_42,1368,247,989
2020-03-19,1,1,0,0,FR_ARA_43,1,0,0
2020-03-20,2,1,0,1,FR_ARA_43,3,0,1
2020-03-21,2,0,0,0,FR_ARA_43,5,0,1
2020-03-22,2,0,0,1,FR_ARA_43,7,0,2
2020-03-23,2,1,0,0,FR_ARA_43,9,0,2
2020-03-24,2,0,0,1,FR_ARA_43,11,0,3
2020-03-25,6,1,0,3,FR_ARA_43,17,0,6
2020-03-26,2,2,0,0,FR_ARA_43,19,0,6
2020-03-27,3,0,1,1,FR_ARA_43,22,1,7
2020-03-28,2,0,1,1,FR_ARA_43,24,2,8
2020-03-29,1,0,1,0,FR_ARA_43,25,3,8
2020-03-30,3,0,0,1,FR_ARA_43,28,3,9
2020-03-31,2,0,0,2,FR_ARA_43,30,3,11
2020-04-01,3,0,0,2,FR_ARA_43,33,3,13
2020-04-02,2,0,0,2,FR_ARA_43,35,3,15
2020-04-03,6,0,0,3,FR_ARA_43,41,3,18
2020-04-04,5,1,0,2,FR_ARA_43,46,3,20
2020-04-05,4,0,0,2,FR_ARA_43,50,3,22
2020-04-06,7,0,0,2,FR_ARA_43,57,3,24
2020-04-07,2,1,1,4,FR_ARA_43,59,4,28
2020-04-08,5,0,0,6,FR_ARA_43,64,4,34
2020-04-09,6,0,0,3,FR_ARA_43,70,4,37
2020-04-10,5,0,1,3,FR_ARA_43,75,5,40
2020-04-11,6,0,0,0,FR_ARA_43,81,5,40
2020-04-12,2,0,0,0,FR_ARA_43,83,5,40
2020-04-13,1,0,1,1,FR_ARA_43,84,6,41
2020-04-14,2,0,0,5,FR_ARA_43,86,6,46
2020-04-15,2,0,0,2,FR_ARA_43,88,6,48
2020-04-16,1,0,0,4,FR_ARA_43,89,6,52
2020-04-17,7,0,0,2,FR_ARA_43,96,6,54
2020-04-18,14,0,0,4,FR_ARA_43,110,6,58
2020-04-19,14,0,0,0,FR_ARA_43,124,6,58
2020-04-20,0,0,0,0,FR_ARA_43,124,6,58
2020-04-21,2,1,1,0,FR_ARA_43,126,7,58
2020-04-22,2,0,0,1,FR_ARA_43,128,7,59
2020-04-23,4,0,2,3,FR_ARA_43,132,9,62
2020-04-24,3,0,0,0,FR_ARA_43,135,9,62
2020-04-25,0,0,0,0,FR_ARA_43,135,9,62
2020-04-26,0,0,0,0,FR_ARA_43,135,9,62
2020-04-27,0,0,0,0,FR_ARA_43,135,9,62
2020-04-28,4,0,0,4,FR_ARA_43,139,9,66
2020-04-29,1,0,1,3,FR_ARA_43,140,10,69
2020-04-30,1,0,1,1,FR_ARA_43,141,11,70
2020-05-01,0,0,0,0,FR_ARA_43,141,11,70
2020-05-02,0,0,0,0,FR_ARA_43,141,11,70
2020-05-03,0,0,0,0,FR_ARA_43,141,11,70
2020-05-04,1,0,0,0,FR_ARA_43,142,11,70
2020-05-05,2,0,0,1,FR_ARA_43,144,11,71
2020-05-06,0,1,0,1,FR_ARA_43,144,11,72
2020-05-07,2,1,1,9,FR_ARA_43,146,12,81
2020-05-08,1,0,0,0,FR_ARA_43,147,12,81
2020-05-09,0,0,0,0,FR_ARA_43,147,12,81
2020-05-10,0,0,1,0,FR_ARA_43,147,13,81
2020-05-11,0,0,0,0,FR_ARA_43,147,13,81
2020-05-12,2,0,0,0,FR_ARA_43,149,13,81
2020-05-13,1,0,1,1,FR_ARA_43,150,14,82
2020-05-14,1,0,0,4,FR_ARA_43,151,14,86
2020-05-15,0,1,0,0,FR_ARA_43,151,14,86
2020-05-16,0,0,0,2,FR_ARA_43,151,14,88
2020-05-17,0,0,0,0,FR_ARA_43,151,14,88
2020-05-18,0,0,0,0,FR_ARA_43,151,14,88
2020-05-19,0,0,0,0,FR_ARA_43,151,14,88
2020-05-20,0,0,0,1,FR_ARA_43,151,14,89
2020-05-21,0,0,0,0,FR_ARA_43,151,14,89
2020-05-22,0,0,0,0,FR_ARA_43,151,14,89
2020-05-23,0,0,0,0,FR_ARA_43,151,14,89
2020-05-24,0,0,0,0,FR_ARA_43,151,14,89
2020-05-25,0,0,1,2,FR_ARA_43,151,15,91
2020-05-26,0,0,0,0,FR_ARA_43,151,15,91
2020-05-27,0,0,0,0,FR_ARA_43,151,15,91
2020-05-28,0,0,0,1,FR_ARA_43,151,15,92
2020-05-29,1,0,0,1,FR_ARA_43,152,15,93
2020-05-30,2,0,0,0,FR_ARA_43,154,15,93
2020-05-31,0,0,0,0,FR_ARA_43,154,15,93
2020-06-01,0,0,1,0,FR_ARA_43,154,16,93
2020-06-02,1,0,1,0,FR_ARA_43,155,17,93
2020-06-03,0,0,0,0,FR_ARA_43,155,17,93
2020-06-04,0,0,0,0,FR_ARA_43,155,17,93
2020-06-05,0,0,0,3,FR_ARA_43,155,17,96
2020-06-06,0,0,0,1,FR_ARA_43,155,17,97
2020-06-07,0,0,0,0,FR_ARA_43,155,17,97
2020-06-08,1,0,0,0,FR_ARA_43,156,17,97
2020-06-09,0,0,0,0,FR_ARA_43,156,17,97
2020-06-10,0,0,0,0,FR_ARA_43,156,17,97
2020-06-11,1,0,0,0,FR_ARA_43,157,17,97
2020-06-12,0,0,0,7,FR_ARA_43,157,17,104
2020-06-13,0,0,0,2,FR_ARA_43,157,17,106
2020-06-14,0,0,0,0,FR_ARA_43,157,17,106
2020-06-15,0,0,0,0,FR_ARA_43,157,17,106
2020-06-16,0,0,1,1,FR_ARA_43,157,18,107
2020-06-17,0,0,0,0,FR_ARA_43,157,18,107
2020-06-18,0,0,0,0,FR_ARA_43,157,18,107
2020-06-19,0,0,0,0,FR_ARA_43,157,18,107
2020-06-20,0,0,0,0,FR_ARA_43,157,18,107
2020-06-21,0,0,0,0,FR_ARA_43,157,18,107
2020-06-22,0,0,0,0,FR_ARA_43,157,18,107
2020-06-23,0,0,0,0,FR_ARA_43,157,18,107
2020-06-24,0,0,0,0,FR_ARA_43,157,18,107
2020-03-19,12,4,0,3,FR_PDL_44,12,0,3
2020-03-20,5,3,0,1,FR_PDL_44,17,0,4
2020-03-21,16,3,0,2,FR_PDL_44,33,0,6
2020-03-22,15,4,1,1,FR_PDL_44,48,1,7
2020-03-23,4,2,1,0,FR_PDL_44,52,2,7
2020-03-24,36,4,3,9,FR_PDL_44,88,5,16
2020-03-25,18,4,1,4,FR_PDL_44,106,6,20
2020-03-26,7,6,2,2,FR_PDL_44,113,8,22
2020-03-27,38,7,3,4,FR_PDL_44,151,11,26
2020-03-28,33,8,7,8,FR_PDL_44,184,18,34
2020-03-29,18,2,4,0,FR_PDL_44,202,22,34
2020-03-30,16,3,5,12,FR_PDL_44,218,27,46
2020-03-31,22,9,3,18,FR_PDL_44,240,30,64
2020-04-01,45,2,5,10,FR_PDL_44,285,35,74
2020-04-02,27,7,2,11,FR_PDL_44,312,37,85
2020-04-03,30,5,5,19,FR_PDL_44,342,42,104
2020-04-04,42,3,2,14,FR_PDL_44,384,44,118
2020-04-05,17,3,0,12,FR_PDL_44,401,44,130
2020-04-06,16,3,2,5,FR_PDL_44,417,46,135
2020-04-07,30,2,4,22,FR_PDL_44,447,50,157
2020-04-08,21,4,3,19,FR_PDL_44,468,53,176
2020-04-09,36,3,3,20,FR_PDL_44,504,56,196
2020-04-10,35,6,4,19,FR_PDL_44,539,60,215
2020-04-11,19,0,2,20,FR_PDL_44,558,62,235
2020-04-12,18,3,2,6,FR_PDL_44,576,64,241
2020-04-13,13,1,7,3,FR_PDL_44,589,71,244
2020-04-14,10,0,6,8,FR_PDL_44,599,77,252
2020-04-15,18,1,6,15,FR_PDL_44,617,83,267
2020-04-16,12,1,3,14,FR_PDL_44,629,86,281
2020-04-17,16,1,2,9,FR_PDL_44,645,88,290
2020-04-18,10,0,4,14,FR_PDL_44,655,92,304
2020-04-19,7,0,3,2,FR_PDL_44,662,95,306
2020-04-20,4,0,3,5,FR_PDL_44,666,98,311
2020-04-21,14,1,3,11,FR_PDL_44,680,101,322
2020-04-22,12,1,4,20,FR_PDL_44,692,105,342
2020-04-23,11,0,1,7,FR_PDL_44,703,106,349
2020-04-24,7,0,4,14,FR_PDL_44,710,110,363
2020-04-25,12,0,1,8,FR_PDL_44,722,111,371
2020-04-26,4,0,4,5,FR_PDL_44,726,115,376
2020-04-27,12,0,3,15,FR_PDL_44,738,118,391
2020-04-28,6,0,2,11,FR_PDL_44,744,120,402
2020-04-29,9,2,3,13,FR_PDL_44,753,123,415
2020-04-30,5,0,1,12,FR_PDL_44,758,124,427
2020-05-01,8,0,1,11,FR_PDL_44,766,125,438
2020-05-02,3,1,2,2,FR_PDL_44,769,127,440
2020-05-03,5,1,1,3,FR_PDL_44,774,128,443
2020-05-04,3,0,0,3,FR_PDL_44,777,128,446
2020-05-05,8,2,2,13,FR_PDL_44,785,130,459
2020-05-06,6,0,1,9,FR_PDL_44,791,131,468
2020-05-07,2,1,2,5,FR_PDL_44,793,133,473
2020-05-08,5,1,3,5,FR_PDL_44,798,136,478
2020-05-09,1,0,0,9,FR_PDL_44,799,136,487
2020-05-10,1,0,0,2,FR_PDL_44,800,136,489
2020-05-11,3,0,0,5,FR_PDL_44,803,136,494
2020-05-12,1,0,1,7,FR_PDL_44,804,137,501
2020-05-13,1,0,0,7,FR_PDL_44,805,137,508
2020-05-14,6,0,2,16,FR_PDL_44,811,139,524
2020-05-15,2,0,2,8,FR_PDL_44,813,141,532
2020-05-16,1,0,0,4,FR_PDL_44,814,141,536
2020-05-17,1,0,0,0,FR_PDL_44,815,141,536
2020-05-18,0,0,1,5,FR_PDL_44,815,142,541
2020-05-19,4,0,0,6,FR_PDL_44,819,142,547
2020-05-20,0,0,1,5,FR_PDL_44,819,143,552
2020-05-21,2,0,0,1,FR_PDL_44,821,143,553
2020-05-22,1,1,0,1,FR_PDL_44,822,143,554
2020-05-23,2,0,0,1,FR_PDL_44,824,143,555
2020-05-24,6,1,1,0,FR_PDL_44,830,144,555
2020-05-25,4,2,0,3,FR_PDL_44,834,144,558
2020-05-26,5,1,0,10,FR_PDL_44,839,144,568
2020-05-27,1,0,0,6,FR_PDL_44,840,144,574
2020-05-28,2,1,0,6,FR_PDL_44,842,144,580
2020-05-29,2,0,0,1,FR_PDL_44,844,144,581
2020-05-30,6,0,0,3,FR_PDL_44,850,144,584
2020-05-31,5,0,2,5,FR_PDL_44,855,146,589
2020-06-01,1,0,0,2,FR_PDL_44,856,146,591
2020-06-02,2,1,1,8,FR_PDL_44,858,147,599
2020-06-03,0,0,0,5,FR_PDL_44,858,147,604
2020-06-04,5,0,0,9,FR_PDL_44,863,147,613
2020-06-05,7,0,4,6,FR_PDL_44,870,151,619
2020-06-06,2,0,1,6,FR_PDL_44,872,152,625
2020-06-07,2,1,1,0,FR_PDL_44,874,153,625
2020-06-08,5,0,1,6,FR_PDL_44,879,154,631
2020-06-09,2,0,0,3,FR_PDL_44,881,154,634
2020-06-10,2,0,0,3,FR_PDL_44,883,154,637
2020-06-11,12,1,3,17,FR_PDL_44,895,157,654
2020-06-12,1,0,0,9,FR_PDL_44,896,157,663
2020-06-13,2,0,0,2,FR_PDL_44,898,157,665
2020-06-14,0,0,0,0,FR_PDL_44,898,157,665
2020-06-15,0,0,0,1,FR_PDL_44,898,157,666
2020-06-16,3,0,0,5,FR_PDL_44,901,157,671
2020-06-17,7,2,0,5,FR_PDL_44,908,157,676
2020-06-18,1,0,1,1,FR_PDL_44,909,158,677
2020-06-19,1,0,0,7,FR_PDL_44,910,158,684
2020-06-20,0,0,0,2,FR_PDL_44,910,158,686
2020-06-21,0,0,0,0,FR_PDL_44,910,158,686
2020-06-22,6,1,0,11,FR_PDL_44,916,158,697
2020-06-23,3,1,0,3,FR_PDL_44,919,158,700
2020-06-24,1,0,1,8,FR_PDL_44,920,159,708
2020-03-19,12,3,0,2,FR_CVL_45,12,0,2
2020-03-20,11,1,0,0,FR_CVL_45,23,0,2
2020-03-21,6,2,1,1,FR_CVL_45,29,1,3
2020-03-22,10,6,0,4,FR_CVL_45,39,1,7
2020-03-23,11,4,1,4,FR_CVL_45,50,2,11
2020-03-24,0,0,0,0,FR_CVL_45,50,2,11
2020-03-25,20,5,0,5,FR_CVL_45,70,2,16
2020-03-26,18,8,2,5,FR_CVL_45,88,4,21
2020-03-27,8,1,1,2,FR_CVL_45,96,5,23
2020-03-28,26,5,2,3,FR_CVL_45,122,7,26
2020-03-29,34,9,2,3,FR_CVL_45,156,9,29
2020-03-30,34,4,3,6,FR_CVL_45,190,12,35
2020-03-31,18,7,2,3,FR_CVL_45,208,14,38
2020-04-01,33,12,1,8,FR_CVL_45,241,15,46
2020-04-02,32,8,2,12,FR_CVL_45,273,17,58
2020-04-03,38,14,4,11,FR_CVL_45,311,21,69
2020-04-04,32,3,1,21,FR_CVL_45,343,22,90
2020-04-05,18,2,2,12,FR_CVL_45,361,24,102
2020-04-06,26,7,2,10,FR_CVL_45,387,26,112
2020-04-07,24,5,2,18,FR_CVL_45,411,28,130
2020-04-08,32,10,1,16,FR_CVL_45,443,29,146
2020-04-09,28,5,4,18,FR_CVL_45,471,33,164
2020-04-10,30,6,2,22,FR_CVL_45,501,35,186
2020-04-11,33,1,5,17,FR_CVL_45,534,40,203
2020-04-12,18,1,1,8,FR_CVL_45,552,41,211
2020-04-13,21,8,1,12,FR_CVL_45,573,42,223
2020-04-14,16,5,3,8,FR_CVL_45,589,45,231
2020-04-15,22,5,4,24,FR_CVL_45,611,49,255
2020-04-16,23,1,1,28,FR_CVL_45,634,50,283
2020-04-17,12,6,0,14,FR_CVL_45,646,50,297
2020-04-18,13,4,4,16,FR_CVL_45,659,54,313
2020-04-19,12,4,2,5,FR_CVL_45,671,56,318
2020-04-20,5,0,2,4,FR_CVL_45,676,58,322
2020-04-21,10,0,1,15,FR_CVL_45,686,59,337
2020-04-22,16,4,3,8,FR_CVL_45,702,62,345
2020-04-23,12,3,0,12,FR_CVL_45,714,62,357
2020-04-24,6,3,2,4,FR_CVL_45,720,64,361
2020-04-25,5,2,1,8,FR_CVL_45,725,65,369
2020-04-26,1,1,2,1,FR_CVL_45,726,67,370
2020-04-27,10,3,1,3,FR_CVL_45,736,68,373
2020-04-28,12,4,2,17,FR_CVL_45,748,70,390
2020-04-29,3,1,3,12,FR_CVL_45,751,73,402
2020-04-30,14,4,0,8,FR_CVL_45,765,73,410
2020-05-01,14,1,1,5,FR_CVL_45,779,74,415
2020-05-02,2,0,0,1,FR_CVL_45,781,74,416
2020-05-03,4,2,1,1,FR_CVL_45,785,75,417
2020-05-04,5,0,1,5,FR_CVL_45,790,76,422
2020-05-05,15,2,0,18,FR_CVL_45,805,76,440
2020-05-06,3,0,3,16,FR_CVL_45,808,79,456
2020-05-07,3,1,1,10,FR_CVL_45,811,80,466
2020-05-08,4,0,2,14,FR_CVL_45,815,82,480
2020-05-09,1,0,0,1,FR_CVL_45,816,82,481
2020-05-10,0,0,0,0,FR_CVL_45,816,82,481
2020-05-11,4,2,1,3,FR_CVL_45,820,83,484
2020-05-12,3,2,1,9,FR_CVL_45,823,84,493
2020-05-13,1,1,1,6,FR_CVL_45,824,85,499
2020-05-14,2,2,2,8,FR_CVL_45,826,87,507
2020-05-15,4,0,1,8,FR_CVL_45,830,88,515
2020-05-16,0,0,2,7,FR_CVL_45,830,90,522
2020-05-17,0,0,0,2,FR_CVL_45,830,90,524
2020-05-18,0,0,0,3,FR_CVL_45,830,90,527
2020-05-19,2,1,1,6,FR_CVL_45,832,91,533
2020-05-20,2,1,1,4,FR_CVL_45,834,92,537
2020-05-21,0,0,1,6,FR_CVL_45,834,93,543
2020-05-22,0,0,0,2,FR_CVL_45,834,93,545
2020-05-23,1,1,1,2,FR_CVL_45,835,94,547
2020-05-24,0,0,0,0,FR_CVL_45,835,94,547
2020-05-25,4,0,0,0,FR_CVL_45,839,94,547
2020-05-26,0,0,1,10,FR_CVL_45,839,95,557
2020-05-27,0,0,0,1,FR_CVL_45,839,95,558
2020-05-28,1,0,0,7,FR_CVL_45,840,95,565
2020-05-29,1,0,3,3,FR_CVL_45,841,98,568
2020-05-30,0,0,0,0,FR_CVL_45,841,98,568
2020-05-31,0,0,0,1,FR_CVL_45,841,98,569
2020-06-01,0,0,0,0,FR_CVL_45,841,98,569
2020-06-02,0,0,0,2,FR_CVL_45,841,98,571
2020-06-03,2,2,2,2,FR_CVL_45,843,100,573
2020-06-04,1,0,0,1,FR_CVL_45,844,100,574
2020-06-05,1,0,0,8,FR_CVL_45,845,100,582
2020-06-06,1,0,0,3,FR_CVL_45,846,100,585
2020-06-07,1,0,0,2,FR_CVL_45,847,100,587
2020-06-08,1,0,0,0,FR_CVL_45,848,100,587
2020-06-09,0,0,0,6,FR_CVL_45,848,100,593
2020-06-10,0,0,0,6,FR_CVL_45,848,100,599
2020-06-11,0,0,0,0,FR_CVL_45,848,100,599
2020-06-12,0,0,2,2,FR_CVL_45,848,102,601
2020-06-13,1,0,0,0,FR_CVL_45,849,102,601
2020-06-14,0,0,0,0,FR_CVL_45,849,102,601
2020-06-15,0,0,0,0,FR_CVL_45,849,102,601
2020-06-16,0,0,0,3,FR_CVL_45,849,102,604
2020-06-17,1,0,0,1,FR_CVL_45,850,102,605
2020-06-18,0,0,1,1,FR_CVL_45,850,103,606
2020-06-19,0,0,0,1,FR_CVL_45,850,103,607
2020-06-20,0,0,0,0,FR_CVL_45,850,103,607
2020-06-21,0,0,0,0,FR_CVL_45,850,103,607
2020-06-22,0,3,0,9,FR_CVL_45,850,103,616
2020-06-23,1,0,0,3,FR_CVL_45,851,103,619
2020-06-24,0,0,0,2,FR_CVL_45,851,103,621
2020-03-19,1,0,0,1,FR_OCC_46,1,0,1
2020-03-20,0,0,0,0,FR_OCC_46,1,0,1
2020-03-21,4,0,0,3,FR_OCC_46,5,0,4
2020-03-22,0,0,0,0,FR_OCC_46,5,0,4
2020-03-23,0,0,0,0,FR_OCC_46,5,0,4
2020-03-24,0,0,0,0,FR_OCC_46,5,0,4
2020-03-25,1,1,0,0,FR_OCC_46,6,0,4
2020-03-26,1,0,0,1,FR_OCC_46,7,0,5
2020-03-27,0,0,0,0,FR_OCC_46,7,0,5
2020-03-28,1,1,0,0,FR_OCC_46,8,0,5
2020-03-29,4,1,0,2,FR_OCC_46,12,0,7
2020-03-30,0,0,0,0,FR_OCC_46,12,0,7
2020-03-31,0,0,0,0,FR_OCC_46,12,0,7
2020-04-01,12,1,0,6,FR_OCC_46,24,0,13
2020-04-02,5,3,0,1,FR_OCC_46,29,0,14
2020-04-03,9,0,0,3,FR_OCC_46,38,0,17
2020-04-04,0,0,0,2,FR_OCC_46,38,0,19
2020-04-05,0,0,0,3,FR_OCC_46,38,0,22
2020-04-06,9,1,0,8,FR_OCC_46,47,0,30
2020-04-07,7,0,0,7,FR_OCC_46,54,0,37
2020-04-08,5,1,1,6,FR_OCC_46,59,1,43
2020-04-09,7,0,0,4,FR_OCC_46,66,1,47
2020-04-10,5,0,1,6,FR_OCC_46,71,2,53
2020-04-11,6,2,0,4,FR_OCC_46,77,2,57
2020-04-12,0,0,0,0,FR_OCC_46,77,2,57
2020-04-13,0,0,0,0,FR_OCC_46,77,2,57
2020-04-14,7,0,2,0,FR_OCC_46,84,4,57
2020-04-15,3,0,2,3,FR_OCC_46,87,6,60
2020-04-16,2,0,0,1,FR_OCC_46,89,6,61
2020-04-17,9,0,1,8,FR_OCC_46,98,7,69
2020-04-18,26,0,0,26,FR_OCC_46,124,7,95
2020-04-19,4,0,1,2,FR_OCC_46,128,8,97
2020-04-20,17,1,3,13,FR_OCC_46,145,11,110
2020-04-21,10,2,2,5,FR_OCC_46,155,13,115
2020-04-22,3,0,1,3,FR_OCC_46,158,14,118
2020-04-23,1,0,0,3,FR_OCC_46,159,14,121
2020-04-24,10,0,1,10,FR_OCC_46,169,15,131
2020-04-25,0,0,0,0,FR_OCC_46,169,15,131
2020-04-26,0,0,0,0,FR_OCC_46,169,15,131
2020-04-27,1,0,1,2,FR_OCC_46,170,16,133
2020-04-28,3,0,1,5,FR_OCC_46,173,17,138
2020-04-29,0,0,0,3,FR_OCC_46,173,17,141
2020-04-30,1,0,0,4,FR_OCC_46,174,17,145
2020-05-01,3,0,0,0,FR_OCC_46,177,17,145
2020-05-02,8,0,9,0,FR_OCC_46,185,26,145
2020-05-03,0,0,0,0,FR_OCC_46,185,26,145
2020-05-04,0,0,0,0,FR_OCC_46,185,26,145
2020-05-05,0,0,0,3,FR_OCC_46,185,26,148
2020-05-06,2,0,1,1,FR_OCC_46,187,27,149
2020-05-07,1,0,0,0,FR_OCC_46,188,27,149
2020-05-08,1,0,0,0,FR_OCC_46,189,27,149
2020-05-09,0,0,0,0,FR_OCC_46,189,27,149
2020-05-10,0,0,0,0,FR_OCC_46,189,27,149
2020-05-11,1,0,0,1,FR_OCC_46,190,27,150
2020-05-12,0,0,0,0,FR_OCC_46,190,27,150
2020-05-13,2,0,0,3,FR_OCC_46,192,27,153
2020-05-14,0,0,0,0,FR_OCC_46,192,27,153
2020-05-15,0,0,0,2,FR_OCC_46,192,27,155
2020-05-16,0,0,0,0,FR_OCC_46,192,27,155
2020-05-17,0,0,0,0,FR_OCC_46,192,27,155
2020-05-18,2,1,0,0,FR_OCC_46,194,27,155
2020-05-19,0,0,0,0,FR_OCC_46,194,27,155
2020-05-20,0,0,0,0,FR_OCC_46,194,27,155
2020-05-21,0,0,1,2,FR_OCC_46,194,28,157
2020-05-22,0,0,1,0,FR_OCC_46,194,29,157
2020-05-23,0,0,0,1,FR_OCC_46,194,29,158
2020-05-24,2,0,0,0,FR_OCC_46,196,29,158
2020-05-25,0,0,0,0,FR_OCC_46,196,29,158
2020-05-26,0,0,0,0,FR_OCC_46,196,29,158
2020-05-27,0,0,0,0,FR_OCC_46,196,29,158
2020-05-28,2,0,0,1,FR_OCC_46,198,29,159
2020-05-29,0,0,0,0,FR_OCC_46,198,29,159
2020-05-30,0,0,0,0,FR_OCC_46,198,29,159
2020-05-31,1,0,0,1,FR_OCC_46,199,29,160
2020-06-01,1,0,0,0,FR_OCC_46,200,29,160
2020-06-02,0,0,0,1,FR_OCC_46,200,29,161
2020-06-03,0,0,0,0,FR_OCC_46,200,29,161
2020-06-04,2,1,0,1,FR_OCC_46,202,29,162
2020-06-05,0,0,0,2,FR_OCC_46,202,29,164
2020-06-06,0,0,0,0,FR_OCC_46,202,29,164
2020-06-07,0,0,0,0,FR_OCC_46,202,29,164
2020-06-08,0,0,0,0,FR_OCC_46,202,29,164
2020-06-09,0,0,0,0,FR_OCC_46,202,29,164
2020-06-10,0,0,0,0,FR_OCC_46,202,29,164
2020-06-11,0,0,0,0,FR_OCC_46,202,29,164
2020-06-12,0,0,0,0,FR_OCC_46,202,29,164
2020-06-13,0,0,0,0,FR_OCC_46,202,29,164
2020-06-14,0,0,0,0,FR_OCC_46,202,29,164
2020-06-15,0,0,0,0,FR_OCC_46,202,29,164
2020-06-16,0,0,0,0,FR_OCC_46,202,29,164
2020-06-17,0,0,0,0,FR_OCC_46,202,29,164
2020-06-18,0,0,0,0,FR_OCC_46,202,29,164
2020-06-19,0,0,0,0,FR_OCC_46,202,29,164
2020-06-20,0,0,0,0,FR_OCC_46,202,29,164
2020-06-21,0,0,0,0,FR_OCC_46,202,29,164
2020-06-22,0,0,0,0,FR_OCC_46,202,29,164
2020-06-23,0,0,0,0,FR_OCC_46,202,29,164
2020-06-24,0,0,0,0,FR_OCC_46,202,29,164
2020-03-19,0,0,0,0,FR_NAQ_47,0,0,0
2020-03-20,0,0,0,0,FR_NAQ_47,0,0,0
2020-03-21,3,0,0,0,FR_NAQ_47,3,0,0
2020-03-22,2,1,0,0,FR_NAQ_47,5,0,0
2020-03-23,5,2,1,0,FR_NAQ_47,10,1,0
2020-03-24,3,0,1,1,FR_NAQ_47,13,2,1
2020-03-25,3,0,0,1,FR_NAQ_47,16,2,2
2020-03-26,2,2,2,1,FR_NAQ_47,18,4,3
2020-03-27,2,2,0,1,FR_NAQ_47,20,4,4
2020-03-28,8,3,0,0,FR_NAQ_47,28,4,4
2020-03-29,2,0,0,0,FR_NAQ_47,30,4,4
2020-03-30,3,1,0,2,FR_NAQ_47,33,4,6
2020-03-31,0,0,0,2,FR_NAQ_47,33,4,8
2020-04-01,4,0,0,0,FR_NAQ_47,37,4,8
2020-04-02,1,1,0,0,FR_NAQ_47,38,4,8
2020-04-03,2,0,0,3,FR_NAQ_47,40,4,11
2020-04-04,1,0,0,1,FR_NAQ_47,41,4,12
2020-04-05,2,0,0,0,FR_NAQ_47,43,4,12
2020-04-06,0,0,0,0,FR_NAQ_47,43,4,12
2020-04-07,2,0,0,3,FR_NAQ_47,45,4,15
2020-04-08,0,0,0,1,FR_NAQ_47,45,4,16
2020-04-09,1,0,1,0,FR_NAQ_47,46,5,16
2020-04-10,0,0,0,1,FR_NAQ_47,46,5,17
2020-04-11,0,0,0,0,FR_NAQ_47,46,5,17
2020-04-12,3,0,0,1,FR_NAQ_47,49,5,18
2020-04-13,0,0,0,0,FR_NAQ_47,49,5,18
2020-04-14,3,0,0,1,FR_NAQ_47,52,5,19
2020-04-15,3,0,0,6,FR_NAQ_47,55,5,25
2020-04-16,3,0,0,3,FR_NAQ_47,58,5,28
2020-04-17,5,0,1,3,FR_NAQ_47,63,6,31
2020-04-18,3,0,0,1,FR_NAQ_47,66,6,32
2020-04-19,3,0,0,1,FR_NAQ_47,69,6,33
2020-04-20,0,0,0,0,FR_NAQ_47,69,6,33
2020-04-21,2,0,0,0,FR_NAQ_47,71,6,33
2020-04-22,1,0,0,0,FR_NAQ_47,72,6,33
2020-04-23,0,0,0,0,FR_NAQ_47,72,6,33
2020-04-24,0,0,0,3,FR_NAQ_47,72,6,36
2020-04-25,0,0,0,2,FR_NAQ_47,72,6,38
2020-04-26,1,1,0,0,FR_NAQ_47,73,6,38
2020-04-27,1,0,0,0,FR_NAQ_47,74,6,38
2020-04-28,0,0,0,1,FR_NAQ_47,74,6,39
2020-04-29,3,0,0,3,FR_NAQ_47,77,6,42
2020-04-30,1,0,2,1,FR_NAQ_47,78,8,43
2020-05-01,0,0,0,0,FR_NAQ_47,78,8,43
2020-05-02,0,0,0,0,FR_NAQ_47,78,8,43
2020-05-03,0,0,0,0,FR_NAQ_47,78,8,43
2020-05-04,0,0,1,0,FR_NAQ_47,78,9,43
2020-05-05,0,0,0,1,FR_NAQ_47,78,9,44
2020-05-06,3,0,0,2,FR_NAQ_47,81,9,46
2020-05-07,3,0,0,6,FR_NAQ_47,84,9,52
2020-05-08,0,0,0,5,FR_NAQ_47,84,9,57
2020-05-09,0,0,0,0,FR_NAQ_47,84,9,57
2020-05-10,1,0,0,0,FR_NAQ_47,85,9,57
2020-05-11,2,0,0,0,FR_NAQ_47,87,9,57
2020-05-12,0,0,0,0,FR_NAQ_47,87,9,57
2020-05-13,0,0,0,0,FR_NAQ_47,87,9,57
2020-05-14,0,0,0,1,FR_NAQ_47,87,9,58
2020-05-15,1,0,0,0,FR_NAQ_47,88,9,58
2020-05-16,1,0,1,1,FR_NAQ_47,89,10,59
2020-05-17,0,0,0,0,FR_NAQ_47,89,10,59
2020-05-18,0,0,0,0,FR_NAQ_47,89,10,59
2020-05-19,0,0,0,1,FR_NAQ_47,89,10,60
2020-05-20,0,0,0,2,FR_NAQ_47,89,10,62
2020-05-21,0,0,0,0,FR_NAQ_47,89,10,62
2020-05-22,0,0,0,1,FR_NAQ_47,89,10,63
2020-05-23,0,0,0,1,FR_NAQ_47,89,10,64
2020-05-24,1,0,0,0,FR_NAQ_47,90,10,64
2020-05-25,2,0,0,0,FR_NAQ_47,92,10,64
2020-05-26,0,0,0,1,FR_NAQ_47,92,10,65
2020-05-27,0,0,0,0,FR_NAQ_47,92,10,65
2020-05-28,1,0,0,0,FR_NAQ_47,93,10,65
2020-05-29,0,0,0,1,FR_NAQ_47,93,10,66
2020-05-30,0,0,0,2,FR_NAQ_47,93,10,68
2020-05-31,0,0,0,0,FR_NAQ_47,93,10,68
2020-06-01,0,0,0,0,FR_NAQ_47,93,10,68
2020-06-02,0,0,0,0,FR_NAQ_47,93,10,68
2020-06-03,0,0,0,1,FR_NAQ_47,93,10,69
2020-06-04,0,0,0,7,FR_NAQ_47,93,10,76
2020-06-05,0,0,0,0,FR_NAQ_47,93,10,76
2020-06-06,0,0,0,0,FR_NAQ_47,93,10,76
2020-06-07,0,0,0,0,FR_NAQ_47,93,10,76
2020-06-08,0,0,0,1,FR_NAQ_47,93,10,77
2020-06-09,0,0,0,3,FR_NAQ_47,93,10,80
2020-06-10,1,1,1,0,FR_NAQ_47,94,11,80
2020-06-11,0,0,0,0,FR_NAQ_47,94,11,80
2020-06-12,0,0,0,0,FR_NAQ_47,94,11,80
2020-06-13,0,0,0,0,FR_NAQ_47,94,11,80
2020-06-14,1,0,0,1,FR_NAQ_47,95,11,81
2020-06-15,0,0,0,0,FR_NAQ_47,95,11,81
2020-06-16,1,0,0,0,FR_NAQ_47,96,11,81
2020-06-17,1,0,0,0,FR_NAQ_47,97,11,81
2020-06-18,0,0,0,0,FR_NAQ_47,97,11,81
2020-06-19,0,0,0,0,FR_NAQ_47,97,11,81
2020-06-20,0,0,0,0,FR_NAQ_47,97,11,81
2020-06-21,0,0,0,0,FR_NAQ_47,97,11,81
2020-06-22,0,0,0,0,FR_NAQ_47,97,11,81
2020-06-23,0,0,0,1,FR_NAQ_47,97,11,82
2020-06-24,0,0,0,2,FR_NAQ_47,97,11,84
2020-03-19,0,0,0,0,FR_OCC_48,0,0,0
2020-03-20,0,0,0,0,FR_OCC_48,0,0,0
2020-03-21,0,0,0,0,FR_OCC_48,0,0,0
2020-03-22,2,0,0,1,FR_OCC_48,2,0,1
2020-03-23,2,0,0,0,FR_OCC_48,4,0,1
2020-03-24,4,2,0,1,FR_OCC_48,8,0,2
2020-03-25,1,0,0,0,FR_OCC_48,9,0,2
2020-03-26,0,0,0,1,FR_OCC_48,9,0,3
2020-03-27,0,0,0,0,FR_OCC_48,9,0,3
2020-03-28,2,0,0,1,FR_OCC_48,11,0,4
2020-03-29,1,0,0,0,FR_OCC_48,12,0,4
2020-03-30,1,0,0,2,FR_OCC_48,13,0,6
2020-03-31,0,0,0,1,FR_OCC_48,13,0,7
2020-04-01,2,0,0,0,FR_OCC_48,15,0,7
2020-04-02,1,0,0,1,FR_OCC_48,16,0,8
2020-04-03,0,0,0,0,FR_OCC_48,16,0,8
2020-04-04,0,0,0,1,FR_OCC_48,16,0,9
2020-04-05,0,0,0,0,FR_OCC_48,16,0,9
2020-04-06,0,0,0,0,FR_OCC_48,16,0,9
2020-04-07,0,0,0,2,FR_OCC_48,16,0,11
2020-04-08,0,0,0,0,FR_OCC_48,16,0,11
2020-04-09,0,0,0,0,FR_OCC_48,16,0,11
2020-04-10,0,0,0,1,FR_OCC_48,16,0,12
2020-04-11,0,0,0,0,FR_OCC_48,16,0,12
2020-04-12,0,0,0,0,FR_OCC_48,16,0,12
2020-04-13,0,0,0,0,FR_OCC_48,16,0,12
2020-04-14,0,0,0,0,FR_OCC_48,16,0,12
2020-04-15,0,0,0,0,FR_OCC_48,16,0,12
2020-04-16,0,0,0,1,FR_OCC_48,16,0,13
2020-04-17,0,0,0,0,FR_OCC_48,16,0,13
2020-04-18,0,0,0,0,FR_OCC_48,16,0,13
2020-04-19,0,0,0,0,FR_OCC_48,16,0,13
2020-04-20,0,0,0,0,FR_OCC_48,16,0,13
2020-04-21,0,0,0,0,FR_OCC_48,16,0,13
2020-04-22,0,0,0,1,FR_OCC_48,16,0,14
2020-04-23,0,0,0,0,FR_OCC_48,16,0,14
2020-04-24,0,0,0,2,FR_OCC_48,16,0,16
2020-04-25,0,0,0,0,FR_OCC_48,16,0,16
2020-04-26,0,0,0,0,FR_OCC_48,16,0,16
2020-04-27,0,0,0,0,FR_OCC_48,16,0,16
2020-04-28,0,0,0,1,FR_OCC_48,16,0,17
2020-04-29,0,0,1,0,FR_OCC_48,16,1,17
2020-04-30,0,0,0,0,FR_OCC_48,16,1,17
2020-05-01,3,0,0,3,FR_OCC_48,19,1,20
2020-05-02,0,0,0,0,FR_OCC_48,19,1,20
2020-05-03,1,0,0,0,FR_OCC_48,20,1,20
2020-05-04,0,0,0,0,FR_OCC_48,20,1,20
2020-05-05,0,0,0,0,FR_OCC_48,20,1,20
2020-05-06,0,0,0,0,FR_OCC_48,20,1,20
2020-05-07,0,0,0,0,FR_OCC_48,20,1,20
2020-05-08,0,0,0,2,FR_OCC_48,20,1,22
2020-05-09,0,0,0,0,FR_OCC_48,20,1,22
2020-05-10,0,0,0,0,FR_OCC_48,20,1,22
2020-05-11,0,0,0,0,FR_OCC_48,20,1,22
2020-05-12,0,0,0,0,FR_OCC_48,20,1,22
2020-05-13,2,0,0,1,FR_OCC_48,22,1,23
2020-05-14,0,0,0,0,FR_OCC_48,22,1,23
2020-05-15,0,0,0,1,FR_OCC_48,22,1,24
2020-05-16,0,0,0,0,FR_OCC_48,22,1,24
2020-05-17,0,0,0,0,FR_OCC_48,22,1,24
2020-05-18,0,0,0,0,FR_OCC_48,22,1,24
2020-05-19,0,0,0,0,FR_OCC_48,22,1,24
2020-05-20,1,0,0,1,FR_OCC_48,23,1,25
2020-05-21,0,0,0,0,FR_OCC_48,23,1,25
2020-05-22,0,0,0,0,FR_OCC_48,23,1,25
2020-05-23,0,0,0,0,FR_OCC_48,23,1,25
2020-05-24,0,0,0,0,FR_OCC_48,23,1,25
2020-05-25,1,0,0,0,FR_OCC_48,24,1,25
2020-05-26,0,0,0,0,FR_OCC_48,24,1,25
2020-05-27,0,0,0,0,FR_OCC_48,24,1,25
2020-05-28,0,0,0,1,FR_OCC_48,24,1,26
2020-05-29,0,0,0,0,FR_OCC_48,24,1,26
2020-05-30,0,0,0,0,FR_OCC_48,24,1,26
2020-05-31,0,0,0,0,FR_OCC_48,24,1,26
2020-06-01,0,0,0,0,FR_OCC_48,24,1,26
2020-06-02,0,0,0,0,FR_OCC_48,24,1,26
2020-06-03,0,0,0,0,FR_OCC_48,24,1,26
2020-06-04,0,0,0,0,FR_OCC_48,24,1,26
2020-06-05,0,0,0,0,FR_OCC_48,24,1,26
2020-06-06,0,0,0,1,FR_OCC_48,24,1,27
2020-06-07,0,0,0,0,FR_OCC_48,24,1,27
2020-06-08,0,0,0,0,FR_OCC_48,24,1,27
2020-06-09,0,0,0,0,FR_OCC_48,24,1,27
2020-06-10,0,0,0,0,FR_OCC_48,24,1,27
2020-06-11,0,0,0,0,FR_OCC_48,24,1,27
2020-06-12,0,0,0,0,FR_OCC_48,24,1,27
2020-06-13,0,0,0,0,FR_OCC_48,24,1,27
2020-06-14,0,0,0,0,FR_OCC_48,24,1,27
2020-06-15,0,0,0,0,FR_OCC_48,24,1,27
2020-06-16,0,0,0,0,FR_OCC_48,24,1,27
2020-06-17,0,0,0,0,FR_OCC_48,24,1,27
2020-06-18,0,0,0,0,FR_OCC_48,24,1,27
2020-06-19,0,0,0,0,FR_OCC_48,24,1,27
2020-06-20,0,0,0,0,FR_OCC_48,24,1,27
2020-06-21,0,0,0,0,FR_OCC_48,24,1,27
2020-06-22,0,0,0,0,FR_OCC_48,24,1,27
2020-06-23,0,0,0,0,FR_OCC_48,24,1,27
2020-06-24,0,0,0,0,FR_OCC_48,24,1,27
2020-03-19,13,3,0,5,FR_PDL_49,13,0,5
2020-03-20,9,0,0,7,FR_PDL_49,22,0,12
2020-03-21,8,4,2,2,FR_PDL_49,30,2,14
2020-03-22,7,1,0,7,FR_PDL_49,37,2,21
2020-03-23,28,5,2,1,FR_PDL_49,65,4,22
2020-03-24,18,7,1,5,FR_PDL_49,83,5,27
2020-03-25,18,1,1,7,FR_PDL_49,101,6,34
2020-03-26,25,5,2,10,FR_PDL_49,126,8,44
2020-03-27,24,5,3,9,FR_PDL_49,150,11,53
2020-03-28,19,5,0,8,FR_PDL_49,169,11,61
2020-03-29,22,0,0,11,FR_PDL_49,191,11,72
2020-03-30,23,9,4,2,FR_PDL_49,214,15,74
2020-03-31,42,10,4,19,FR_PDL_49,256,19,93
2020-04-01,25,9,0,15,FR_PDL_49,281,19,108
2020-04-02,20,6,5,19,FR_PDL_49,301,24,127
2020-04-03,16,3,4,17,FR_PDL_49,317,28,144
2020-04-04,8,1,2,3,FR_PDL_49,325,30,147
2020-04-05,10,1,4,6,FR_PDL_49,335,34,153
2020-04-06,12,3,6,7,FR_PDL_49,347,40,160
2020-04-07,35,3,5,21,FR_PDL_49,382,45,181
2020-04-08,24,5,3,13,FR_PDL_49,406,48,194
2020-04-09,21,4,0,13,FR_PDL_49,427,48,207
2020-04-10,20,2,2,20,FR_PDL_49,447,50,227
2020-04-11,24,1,4,13,FR_PDL_49,471,54,240
2020-04-12,20,2,0,4,FR_PDL_49,491,54,244
2020-04-13,12,0,1,9,FR_PDL_49,503,55,253
2020-04-14,16,2,2,4,FR_PDL_49,519,57,257
2020-04-15,11,4,4,23,FR_PDL_49,530,61,280
2020-04-16,27,0,6,13,FR_PDL_49,557,67,293
2020-04-17,8,0,3,14,FR_PDL_49,565,70,307
2020-04-18,7,0,4,5,FR_PDL_49,572,74,312
2020-04-19,3,1,2,4,FR_PDL_49,575,76,316
2020-04-20,8,3,1,4,FR_PDL_49,583,77,320
2020-04-21,4,0,2,12,FR_PDL_49,587,79,332
2020-04-22,14,1,4,10,FR_PDL_49,601,83,342
2020-04-23,16,0,3,11,FR_PDL_49,617,86,353
2020-04-24,3,0,4,3,FR_PDL_49,620,90,356
2020-04-25,3,1,2,8,FR_PDL_49,623,92,364
2020-04-26,0,0,3,3,FR_PDL_49,623,95,367
2020-04-27,13,1,2,3,FR_PDL_49,636,97,370
2020-04-28,9,0,2,13,FR_PDL_49,645,99,383
2020-04-29,7,0,0,12,FR_PDL_49,652,99,395
2020-04-30,6,0,1,7,FR_PDL_49,658,100,402
2020-05-01,2,0,1,9,FR_PDL_49,660,101,411
2020-05-02,1,1,1,1,FR_PDL_49,661,102,412
2020-05-03,3,1,0,1,FR_PDL_49,664,102,413
2020-05-04,7,0,1,5,FR_PDL_49,671,103,418
2020-05-05,11,3,2,7,FR_PDL_49,682,105,425
2020-05-06,8,0,3,8,FR_PDL_49,690,108,433
2020-05-07,0,0,1,9,FR_PDL_49,690,109,442
2020-05-08,2,0,2,3,FR_PDL_49,692,111,445
2020-05-09,1,0,2,1,FR_PDL_49,693,113,446
2020-05-10,3,0,0,1,FR_PDL_49,696,113,447
2020-05-11,5,1,0,1,FR_PDL_49,701,113,448
2020-05-12,5,0,0,0,FR_PDL_49,706,113,448
2020-05-13,3,1,0,4,FR_PDL_49,709,113,452
2020-05-14,5,0,2,5,FR_PDL_49,714,115,457
2020-05-15,14,3,4,14,FR_PDL_49,728,119,471
2020-05-16,2,1,1,2,FR_PDL_49,730,120,473
2020-05-17,3,0,0,1,FR_PDL_49,733,120,474
2020-05-18,5,0,4,5,FR_PDL_49,738,124,479
2020-05-19,1,1,1,11,FR_PDL_49,739,125,490
2020-05-20,4,1,1,10,FR_PDL_49,743,126,500
2020-05-21,3,0,2,9,FR_PDL_49,746,128,509
2020-05-22,6,0,2,4,FR_PDL_49,752,130,513
2020-05-23,4,0,0,3,FR_PDL_49,756,130,516
2020-05-24,2,0,1,1,FR_PDL_49,758,131,517
2020-05-25,2,0,2,2,FR_PDL_49,760,133,519
2020-05-26,1,0,1,2,FR_PDL_49,761,134,521
2020-05-27,2,0,1,5,FR_PDL_49,763,135,526
2020-05-28,3,0,0,11,FR_PDL_49,766,135,537
2020-05-29,2,0,0,1,FR_PDL_49,768,135,538
2020-05-30,1,0,0,5,FR_PDL_49,769,135,543
2020-05-31,3,0,0,0,FR_PDL_49,772,135,543
2020-06-01,1,1,0,1,FR_PDL_49,773,135,544
2020-06-02,1,1,0,4,FR_PDL_49,774,135,548
2020-06-03,0,0,0,4,FR_PDL_49,774,135,552
2020-06-04,2,0,1,4,FR_PDL_49,776,136,556
2020-06-05,2,1,1,4,FR_PDL_49,778,137,560
2020-06-06,2,1,0,4,FR_PDL_49,780,137,564
2020-06-07,1,0,0,0,FR_PDL_49,781,137,564
2020-06-08,2,1,0,0,FR_PDL_49,783,137,564
2020-06-09,2,0,0,10,FR_PDL_49,785,137,574
2020-06-10,2,0,1,4,FR_PDL_49,787,138,578
2020-06-11,6,0,0,2,FR_PDL_49,793,138,580
2020-06-12,4,1,1,7,FR_PDL_49,797,139,587
2020-06-13,2,2,0,0,FR_PDL_49,799,139,587
2020-06-14,1,0,1,0,FR_PDL_49,800,140,587
2020-06-15,1,0,0,1,FR_PDL_49,801,140,588
2020-06-16,1,0,0,1,FR_PDL_49,802,140,589
2020-06-17,2,0,0,8,FR_PDL_49,804,140,597
2020-06-18,1,0,1,3,FR_PDL_49,805,141,600
2020-06-19,0,0,0,3,FR_PDL_49,805,141,603
2020-06-20,0,0,0,2,FR_PDL_49,805,141,605
2020-06-21,0,0,1,0,FR_PDL_49,805,142,605
2020-06-22,1,0,0,1,FR_PDL_49,806,142,606
2020-06-23,0,0,0,0,FR_PDL_49,806,142,606
2020-06-24,0,0,1,3,FR_PDL_49,806,143,609
2020-03-19,0,2,0,1,FR_NOR_50,0,0,1
2020-03-20,6,2,0,0,FR_NOR_50,6,0,1
2020-03-21,6,0,0,1,FR_NOR_50,12,0,2
2020-03-22,2,2,0,0,FR_NOR_50,14,0,2
2020-03-23,2,1,0,1,FR_NOR_50,16,0,3
2020-03-24,2,1,2,0,FR_NOR_50,18,2,3
2020-03-25,6,0,1,4,FR_NOR_50,24,3,7
2020-03-26,2,1,0,1,FR_NOR_50,26,3,8
2020-03-27,7,1,1,2,FR_NOR_50,33,4,10
2020-03-28,6,4,0,0,FR_NOR_50,39,4,10
2020-03-29,9,2,2,2,FR_NOR_50,48,6,12
2020-03-30,12,3,1,1,FR_NOR_50,60,7,13
2020-03-31,5,1,3,2,FR_NOR_50,65,10,15
2020-04-01,10,3,0,2,FR_NOR_50,75,10,17
2020-04-02,9,2,1,5,FR_NOR_50,84,11,22
2020-04-03,7,1,0,4,FR_NOR_50,91,11,26
2020-04-04,9,1,1,2,FR_NOR_50,100,12,28
2020-04-05,12,2,2,0,FR_NOR_50,112,14,28
2020-04-06,2,1,2,3,FR_NOR_50,114,16,31
2020-04-07,8,1,2,8,FR_NOR_50,122,18,39
2020-04-08,1,0,0,3,FR_NOR_50,123,18,42
2020-04-09,9,0,2,1,FR_NOR_50,132,20,43
2020-04-10,10,1,0,3,FR_NOR_50,142,20,46
2020-04-11,2,0,2,7,FR_NOR_50,144,22,53
2020-04-12,3,0,0,2,FR_NOR_50,147,22,55
2020-04-13,1,0,0,0,FR_NOR_50,148,22,55
2020-04-14,11,0,5,1,FR_NOR_50,159,27,56
2020-04-15,6,2,3,5,FR_NOR_50,165,30,61
2020-04-16,5,1,0,4,FR_NOR_50,170,30,65
2020-04-17,1,0,0,2,FR_NOR_50,171,30,67
2020-04-18,3,1,1,2,FR_NOR_50,174,31,69
2020-04-19,5,2,0,0,FR_NOR_50,179,31,69
2020-04-20,7,2,2,1,FR_NOR_50,186,33,70
2020-04-21,2,0,0,8,FR_NOR_50,188,33,78
2020-04-22,1,0,2,7,FR_NOR_50,189,35,85
2020-04-23,4,0,1,9,FR_NOR_50,193,36,94
2020-04-24,0,0,1,1,FR_NOR_50,193,37,95
2020-04-25,0,0,0,0,FR_NOR_50,193,37,95
2020-04-26,1,0,0,0,FR_NOR_50,194,37,95
2020-04-27,1,0,0,1,FR_NOR_50,195,37,96
2020-04-28,4,2,2,2,FR_NOR_50,199,39,98
2020-04-29,3,0,2,2,FR_NOR_50,202,41,100
2020-04-30,3,0,0,1,FR_NOR_50,205,41,101
2020-05-01,2,0,0,0,FR_NOR_50,207,41,101
2020-05-02,1,0,0,2,FR_NOR_50,208,41,103
2020-05-03,2,0,1,1,FR_NOR_50,210,42,104
2020-05-04,6,0,0,1,FR_NOR_50,216,42,105
2020-05-05,2,0,1,3,FR_NOR_50,218,43,108
2020-05-06,0,0,0,2,FR_NOR_50,218,43,110
2020-05-07,1,0,0,1,FR_NOR_50,219,43,111
2020-05-08,1,0,0,0,FR_NOR_50,220,43,111
2020-05-09,0,0,0,1,FR_NOR_50,220,43,112
2020-05-10,0,0,0,0,FR_NOR_50,220,43,112
2020-05-11,0,0,1,5,FR_NOR_50,220,44,117
2020-05-12,3,0,2,1,FR_NOR_50,223,46,118
2020-05-13,3,0,0,0,FR_NOR_50,226,46,118
2020-05-14,0,0,0,2,FR_NOR_50,226,46,120
2020-05-15,0,0,0,1,FR_NOR_50,226,46,121
2020-05-16,0,0,0,0,FR_NOR_50,226,46,121
2020-05-17,0,0,0,0,FR_NOR_50,226,46,121
2020-05-18,1,0,1,0,FR_NOR_50,227,47,121
2020-05-19,0,0,0,1,FR_NOR_50,227,47,122
2020-05-20,0,0,0,0,FR_NOR_50,227,47,122
2020-05-21,0,0,0,0,FR_NOR_50,227,47,122
2020-05-22,1,0,0,1,FR_NOR_50,228,47,123
2020-05-23,0,0,0,2,FR_NOR_50,228,47,125
2020-05-24,4,0,0,0,FR_NOR_50,232,47,125
2020-05-25,2,0,0,1,FR_NOR_50,234,47,126
2020-05-26,2,0,1,1,FR_NOR_50,236,48,127
2020-05-27,0,0,0,0,FR_NOR_50,236,48,127
2020-05-28,0,0,0,0,FR_NOR_50,236,48,127
2020-05-29,1,0,0,0,FR_NOR_50,237,48,127
2020-05-30,0,0,0,0,FR_NOR_50,237,48,127
2020-05-31,0,1,0,0,FR_NOR_50,237,48,127
2020-06-01,0,0,0,0,FR_NOR_50,237,48,127
2020-06-02,0,0,0,0,FR_NOR_50,237,48,127
2020-06-03,2,0,0,0,FR_NOR_50,239,48,127
2020-06-04,0,0,0,1,FR_NOR_50,239,48,128
2020-06-05,1,1,0,0,FR_NOR_50,240,48,128
2020-06-06,4,0,0,4,FR_NOR_50,244,48,132
2020-06-07,0,0,0,0,FR_NOR_50,244,48,132
2020-06-08,0,0,0,0,FR_NOR_50,244,48,132
2020-06-09,2,0,0,3,FR_NOR_50,246,48,135
2020-06-10,0,0,0,1,FR_NOR_50,246,48,136
2020-06-11,0,0,0,1,FR_NOR_50,246,48,137
2020-06-12,0,0,0,0,FR_NOR_50,246,48,137
2020-06-13,0,0,0,0,FR_NOR_50,246,48,137
2020-06-14,0,0,0,0,FR_NOR_50,246,48,137
2020-06-15,0,0,0,0,FR_NOR_50,246,48,137
2020-06-16,0,0,0,1,FR_NOR_50,246,48,138
2020-06-17,0,0,0,3,FR_NOR_50,246,48,141
2020-06-18,0,0,0,0,FR_NOR_50,246,48,141
2020-06-19,0,0,0,2,FR_NOR_50,246,48,143
2020-06-20,0,0,0,0,FR_NOR_50,246,48,143
2020-06-21,0,0,0,1,FR_NOR_50,246,48,144
2020-06-22,0,0,0,0,FR_NOR_50,246,48,144
2020-06-23,0,0,0,0,FR_NOR_50,246,48,144
2020-06-24,0,0,0,0,FR_NOR_50,246,48,144
2020-03-19,25,2,1,11,FR_GES_51,25,1,11
2020-03-20,16,3,0,9,FR_GES_51,41,1,20
2020-03-21,26,6,0,1,FR_GES_51,67,1,21
2020-03-22,28,5,3,3,FR_GES_51,95,4,24
2020-03-23,33,9,3,9,FR_GES_51,128,7,33
2020-03-24,48,5,2,14,FR_GES_51,176,9,47
2020-03-25,58,10,6,13,FR_GES_51,234,15,60
2020-03-26,27,4,3,6,FR_GES_51,261,18,66
2020-03-27,31,5,1,9,FR_GES_51,292,19,75
2020-03-28,80,13,4,34,FR_GES_51,372,23,109
2020-03-29,26,4,2,14,FR_GES_51,398,25,123
2020-03-30,33,14,15,11,FR_GES_51,431,40,134
2020-03-31,100,3,6,36,FR_GES_51,531,46,170
2020-04-01,49,4,7,26,FR_GES_51,580,53,196
2020-04-02,56,4,5,19,FR_GES_51,636,58,215
2020-04-03,23,5,9,22,FR_GES_51,659,67,237
2020-04-04,47,4,3,16,FR_GES_51,706,70,253
2020-04-05,7,0,0,0,FR_GES_51,713,70,253
2020-04-06,29,1,10,18,FR_GES_51,742,80,271
2020-04-07,58,7,8,44,FR_GES_51,800,88,315
2020-04-08,36,2,17,35,FR_GES_51,836,105,350
2020-04-09,34,3,5,19,FR_GES_51,870,110,369
2020-04-10,42,2,10,24,FR_GES_51,912,120,393
2020-04-11,16,5,14,31,FR_GES_51,928,134,424
2020-04-12,32,4,6,10,FR_GES_51,960,140,434
2020-04-13,20,0,2,4,FR_GES_51,980,142,438
2020-04-14,19,1,7,20,FR_GES_51,999,149,458
2020-04-15,38,5,5,34,FR_GES_51,1037,154,492
2020-04-16,8,0,3,10,FR_GES_51,1045,157,502
2020-04-17,28,3,7,23,FR_GES_51,1073,164,525
2020-04-18,14,3,14,30,FR_GES_51,1087,178,555
2020-04-19,11,1,0,2,FR_GES_51,1098,178,557
2020-04-20,17,3,8,17,FR_GES_51,1115,186,574
2020-04-21,36,1,3,30,FR_GES_51,1151,189,604
2020-04-22,22,2,4,19,FR_GES_51,1173,193,623
2020-04-23,12,0,5,14,FR_GES_51,1185,198,637
2020-04-24,23,2,1,13,FR_GES_51,1208,199,650
2020-04-25,8,0,3,14,FR_GES_51,1216,202,664
2020-04-26,5,0,2,1,FR_GES_51,1221,204,665
2020-04-27,7,0,7,6,FR_GES_51,1228,211,671
2020-04-28,19,1,3,15,FR_GES_51,1247,214,686
2020-04-29,8,1,0,9,FR_GES_51,1255,214,695
2020-04-30,12,1,2,17,FR_GES_51,1267,216,712
2020-05-01,9,3,1,8,FR_GES_51,1276,217,720
2020-05-02,10,3,1,6,FR_GES_51,1286,218,726
2020-05-03,8,2,2,0,FR_GES_51,1294,220,726
2020-05-04,6,1,4,1,FR_GES_51,1300,224,727
2020-05-05,7,1,3,9,FR_GES_51,1307,227,736
2020-05-06,4,0,1,12,FR_GES_51,1311,228,748
2020-05-07,19,1,2,13,FR_GES_51,1330,230,761
2020-05-08,3,0,0,2,FR_GES_51,1333,230,763
2020-05-09,5,2,2,10,FR_GES_51,1338,232,773
2020-05-10,0,0,2,1,FR_GES_51,1338,234,774
2020-05-11,3,0,4,6,FR_GES_51,1341,238,780
2020-05-12,9,0,5,12,FR_GES_51,1350,243,792
2020-05-13,5,0,0,10,FR_GES_51,1355,243,802
2020-05-14,2,0,4,38,FR_GES_51,1357,247,840
2020-05-15,8,0,1,35,FR_GES_51,1365,248,875
2020-05-16,1,0,0,7,FR_GES_51,1366,248,882
2020-05-17,2,0,0,0,FR_GES_51,1368,248,882
2020-05-18,9,0,1,5,FR_GES_51,1377,249,887
2020-05-19,2,1,2,7,FR_GES_51,1379,251,894
2020-05-20,1,0,0,7,FR_GES_51,1380,251,901
2020-05-21,3,0,2,2,FR_GES_51,1383,253,903
2020-05-22,1,0,0,3,FR_GES_51,1384,253,906
2020-05-23,7,1,2,8,FR_GES_51,1391,255,914
2020-05-24,3,0,0,1,FR_GES_51,1394,255,915
2020-05-25,2,0,0,3,FR_GES_51,1396,255,918
2020-05-26,4,0,0,8,FR_GES_51,1400,255,926
2020-05-27,1,0,3,14,FR_GES_51,1401,258,940
2020-05-28,3,0,0,1,FR_GES_51,1404,258,941
2020-05-29,4,1,1,10,FR_GES_51,1408,259,951
2020-05-30,2,0,0,7,FR_GES_51,1410,259,958
2020-05-31,0,0,0,0,FR_GES_51,1410,259,958
2020-06-01,0,0,0,0,FR_GES_51,1410,259,958
2020-06-02,3,1,3,6,FR_GES_51,1413,262,964
2020-06-03,2,1,1,4,FR_GES_51,1415,263,968
2020-06-04,1,0,0,0,FR_GES_51,1416,263,968
2020-06-05,1,0,0,5,FR_GES_51,1417,263,973
2020-06-06,0,0,0,0,FR_GES_51,1417,263,973
2020-06-07,2,0,0,0,FR_GES_51,1419,263,973
2020-06-08,2,0,1,12,FR_GES_51,1421,264,985
2020-06-09,3,0,0,1,FR_GES_51,1424,264,986
2020-06-10,0,0,0,3,FR_GES_51,1424,264,989
2020-06-11,2,0,1,0,FR_GES_51,1426,265,989
2020-06-12,2,0,0,4,FR_GES_51,1428,265,993
2020-06-13,0,0,1,1,FR_GES_51,1428,266,994
2020-06-14,0,0,0,0,FR_GES_51,1428,266,994
2020-06-15,0,0,0,0,FR_GES_51,1428,266,994
2020-06-16,0,0,0,0,FR_GES_51,1428,266,994
2020-06-17,1,0,0,1,FR_GES_51,1429,266,995
2020-06-18,0,0,3,7,FR_GES_51,1429,269,1002
2020-06-19,0,0,0,3,FR_GES_51,1429,269,1005
2020-06-20,3,0,0,2,FR_GES_51,1432,269,1007
2020-06-21,0,0,0,0,FR_GES_51,1432,269,1007
2020-06-22,2,0,0,2,FR_GES_51,1434,269,1009
2020-06-23,0,0,1,0,FR_GES_51,1434,270,1009
2020-06-24,0,0,0,1,FR_GES_51,1434,270,1010
2020-03-19,0,0,0,0,FR_GES_52,0,0,0
2020-03-20,13,0,3,5,FR_GES_52,13,3,5
2020-03-21,2,2,0,0,FR_GES_52,15,3,5
2020-03-22,2,0,0,0,FR_GES_52,17,3,5
2020-03-23,0,0,0,1,FR_GES_52,17,3,6
2020-03-24,15,1,1,5,FR_GES_52,32,4,11
2020-03-25,0,1,0,1,FR_GES_52,32,4,12
2020-03-26,16,1,2,1,FR_GES_52,48,6,13
2020-03-27,18,1,1,4,FR_GES_52,66,7,17
2020-03-28,5,1,0,0,FR_GES_52,71,7,17
2020-03-29,0,0,0,0,FR_GES_52,71,7,17
2020-03-30,2,0,0,0,FR_GES_52,73,7,17
2020-03-31,11,2,0,2,FR_GES_52,84,7,19
2020-04-01,2,0,0,1,FR_GES_52,86,7,20
2020-04-02,3,0,0,3,FR_GES_52,89,7,23
2020-04-03,33,0,10,11,FR_GES_52,122,17,34
2020-04-04,33,3,5,10,FR_GES_52,155,22,44
2020-04-05,5,2,2,2,FR_GES_52,160,24,46
2020-04-06,19,4,2,5,FR_GES_52,179,26,51
2020-04-07,21,3,8,7,FR_GES_52,200,34,58
2020-04-08,7,1,2,10,FR_GES_52,207,36,68
2020-04-09,9,0,0,9,FR_GES_52,216,36,77
2020-04-10,12,1,1,11,FR_GES_52,228,37,88
2020-04-11,8,1,3,6,FR_GES_52,236,40,94
2020-04-12,6,0,2,4,FR_GES_52,242,42,98
2020-04-13,2,0,0,1,FR_GES_52,244,42,99
2020-04-14,4,1,1,0,FR_GES_52,248,43,99
2020-04-15,7,1,2,12,FR_GES_52,255,45,111
2020-04-16,5,2,1,6,FR_GES_52,260,46,117
2020-04-17,4,1,0,4,FR_GES_52,264,46,121
2020-04-18,9,5,2,6,FR_GES_52,273,48,127
2020-04-19,4,0,1,1,FR_GES_52,277,49,128
2020-04-20,2,2,0,0,FR_GES_52,279,49,128
2020-04-21,32,0,2,37,FR_GES_52,311,51,165
2020-04-22,6,2,1,5,FR_GES_52,317,52,170
2020-04-23,1,0,1,2,FR_GES_52,318,53,172
2020-04-24,1,0,1,1,FR_GES_52,319,54,173
2020-04-25,7,1,1,3,FR_GES_52,326,55,176
2020-04-26,0,0,1,1,FR_GES_52,326,56,177
2020-04-27,0,0,1,0,FR_GES_52,326,57,177
2020-04-28,4,1,1,2,FR_GES_52,330,58,179
2020-04-29,2,0,1,2,FR_GES_52,332,59,181
2020-04-30,1,0,0,6,FR_GES_52,333,59,187
2020-05-01,2,1,0,0,FR_GES_52,335,59,187
2020-05-02,1,0,0,6,FR_GES_52,336,59,193
2020-05-03,3,0,0,1,FR_GES_52,339,59,194
2020-05-04,10,0,1,1,FR_GES_52,349,60,195
2020-05-05,2,0,1,2,FR_GES_52,351,61,197
2020-05-06,2,0,3,9,FR_GES_52,353,64,206
2020-05-07,24,0,1,3,FR_GES_52,377,65,209
2020-05-08,9,0,3,7,FR_GES_52,386,68,216
2020-05-09,7,1,1,2,FR_GES_52,393,69,218
2020-05-10,0,0,0,0,FR_GES_52,393,69,218
2020-05-11,2,0,2,2,FR_GES_52,395,71,220
2020-05-12,5,2,2,11,FR_GES_52,400,73,231
2020-05-13,5,0,0,3,FR_GES_52,405,73,234
2020-05-14,4,1,1,2,FR_GES_52,409,74,236
2020-05-15,2,0,0,3,FR_GES_52,411,74,239
2020-05-16,1,0,0,2,FR_GES_52,412,74,241
2020-05-17,0,0,0,0,FR_GES_52,412,74,241
2020-05-18,3,1,1,4,FR_GES_52,415,75,245
2020-05-19,0,0,0,1,FR_GES_52,415,75,246
2020-05-20,0,1,3,3,FR_GES_52,415,78,249
2020-05-21,0,0,0,1,FR_GES_52,415,78,250
2020-05-22,0,0,1,0,FR_GES_52,415,79,250
2020-05-23,4,1,1,5,FR_GES_52,419,80,255
2020-05-24,0,0,0,0,FR_GES_52,419,80,255
2020-05-25,1,0,0,1,FR_GES_52,420,80,256
2020-05-26,0,0,0,1,FR_GES_52,420,80,257
2020-05-27,4,0,0,1,FR_GES_52,424,80,258
2020-05-28,11,9,1,3,FR_GES_52,435,81,261
2020-05-29,7,0,0,6,FR_GES_52,442,81,267
2020-05-30,0,0,1,1,FR_GES_52,442,82,268
2020-05-31,1,0,0,0,FR_GES_52,443,82,268
2020-06-01,2,0,1,2,FR_GES_52,445,83,270
2020-06-02,0,0,1,2,FR_GES_52,445,84,272
2020-06-03,0,0,1,8,FR_GES_52,445,85,280
2020-06-04,0,0,1,2,FR_GES_52,445,86,282
2020-06-05,0,0,1,6,FR_GES_52,445,87,288
2020-06-06,0,0,0,2,FR_GES_52,445,87,290
2020-06-07,0,0,0,0,FR_GES_52,445,87,290
2020-06-08,0,0,0,0,FR_GES_52,445,87,290
2020-06-09,2,0,0,0,FR_GES_52,447,87,290
2020-06-10,0,0,0,1,FR_GES_52,447,87,291
2020-06-11,1,0,0,0,FR_GES_52,448,87,291
2020-06-12,0,0,0,5,FR_GES_52,448,87,296
2020-06-13,0,0,1,6,FR_GES_52,448,88,302
2020-06-14,0,0,0,0,FR_GES_52,448,88,302
2020-06-15,2,0,1,0,FR_GES_52,450,89,302
2020-06-16,0,0,0,0,FR_GES_52,450,89,302
2020-06-17,1,0,0,1,FR_GES_52,451,89,303
2020-06-18,1,0,0,1,FR_GES_52,452,89,304
2020-06-19,2,0,0,0,FR_GES_52,454,89,304
2020-06-20,1,0,0,0,FR_GES_52,455,89,304
2020-06-21,0,0,0,0,FR_GES_52,455,89,304
2020-06-22,1,0,0,1,FR_GES_52,456,89,305
2020-06-23,3,0,0,0,FR_GES_52,459,89,305
2020-06-24,0,0,0,0,FR_GES_52,459,89,305
2020-03-19,3,2,0,1,FR_PDL_53,3,0,1
2020-03-20,1,0,0,0,FR_PDL_53,4,0,1
2020-03-21,1,0,0,0,FR_PDL_53,5,0,1
2020-03-22,1,0,0,0,FR_PDL_53,6,0,1
2020-03-23,6,1,1,0,FR_PDL_53,12,1,1
2020-03-24,0,0,0,0,FR_PDL_53,12,1,1
2020-03-25,7,2,0,0,FR_PDL_53,19,1,1
2020-03-26,9,1,2,0,FR_PDL_53,28,3,1
2020-03-27,18,1,0,0,FR_PDL_53,46,3,1
2020-03-28,3,1,2,0,FR_PDL_53,49,5,1
2020-03-29,8,1,0,0,FR_PDL_53,57,5,1
2020-03-30,4,1,2,1,FR_PDL_53,61,7,2
2020-03-31,9,3,1,4,FR_PDL_53,70,8,6
2020-04-01,3,1,0,3,FR_PDL_53,73,8,9
2020-04-02,8,0,0,3,FR_PDL_53,81,8,12
2020-04-03,6,1,1,1,FR_PDL_53,87,9,13
2020-04-04,8,1,2,2,FR_PDL_53,95,11,15
2020-04-05,2,0,0,3,FR_PDL_53,97,11,18
2020-04-06,2,0,0,1,FR_PDL_53,99,11,19
2020-04-07,2,0,1,5,FR_PDL_53,101,12,24
2020-04-08,8,2,1,3,FR_PDL_53,109,13,27
2020-04-09,6,1,1,3,FR_PDL_53,115,14,30
2020-04-10,4,0,3,2,FR_PDL_53,119,17,32
2020-04-11,1,0,1,9,FR_PDL_53,120,18,41
2020-04-12,4,0,0,0,FR_PDL_53,124,18,41
2020-04-13,2,1,1,2,FR_PDL_53,126,19,43
2020-04-14,4,0,0,1,FR_PDL_53,130,19,44
2020-04-15,14,0,2,5,FR_PDL_53,144,21,49
2020-04-16,21,0,4,3,FR_PDL_53,165,25,52
2020-04-17,5,0,1,4,FR_PDL_53,170,26,56
2020-04-18,2,1,0,3,FR_PDL_53,172,26,59
2020-04-19,2,0,0,1,FR_PDL_53,174,26,60
2020-04-20,2,1,1,1,FR_PDL_53,176,27,61
2020-04-21,3,0,0,3,FR_PDL_53,179,27,64
2020-04-22,6,0,0,5,FR_PDL_53,185,27,69
2020-04-23,1,0,0,2,FR_PDL_53,186,27,71
2020-04-24,1,0,0,5,FR_PDL_53,187,27,76
2020-04-25,0,0,0,1,FR_PDL_53,187,27,77
2020-04-26,0,0,0,0,FR_PDL_53,187,27,77
2020-04-27,4,1,1,2,FR_PDL_53,191,28,79
2020-04-28,3,0,1,4,FR_PDL_53,194,29,83
2020-04-29,3,0,0,3,FR_PDL_53,197,29,86
2020-04-30,7,0,3,3,FR_PDL_53,204,32,89
2020-05-01,0,0,0,3,FR_PDL_53,204,32,92
2020-05-02,2,0,2,0,FR_PDL_53,206,34,92
2020-05-03,0,0,0,0,FR_PDL_53,206,34,92
2020-05-04,1,0,0,2,FR_PDL_53,207,34,94
2020-05-05,6,0,0,8,FR_PDL_53,213,34,102
2020-05-06,1,0,0,6,FR_PDL_53,214,34,108
2020-05-07,0,0,1,0,FR_PDL_53,214,35,108
2020-05-08,1,0,0,5,FR_PDL_53,215,35,113
2020-05-09,0,0,0,0,FR_PDL_53,215,35,113
2020-05-10,0,0,0,0,FR_PDL_53,215,35,113
2020-05-11,0,0,1,2,FR_PDL_53,215,36,115
2020-05-12,6,0,1,18,FR_PDL_53,221,37,133
2020-05-13,0,0,0,4,FR_PDL_53,221,37,137
2020-05-14,0,0,1,3,FR_PDL_53,221,38,140
2020-05-15,2,0,0,3,FR_PDL_53,223,38,143
2020-05-16,0,0,2,0,FR_PDL_53,223,40,143
2020-05-17,0,0,0,0,FR_PDL_53,223,40,143
2020-05-18,1,1,0,0,FR_PDL_53,224,40,143
2020-05-19,0,0,0,2,FR_PDL_53,224,40,145
2020-05-20,1,0,0,0,FR_PDL_53,225,40,145
2020-05-21,0,0,1,0,FR_PDL_53,225,41,145
2020-05-22,1,0,0,3,FR_PDL_53,226,41,148
2020-05-23,0,0,1,0,FR_PDL_53,226,42,148
2020-05-24,0,0,0,0,FR_PDL_53,226,42,148
2020-05-25,0,0,1,0,FR_PDL_53,226,43,148
2020-05-26,0,0,0,1,FR_PDL_53,226,43,149
2020-05-27,2,0,0,3,FR_PDL_53,228,43,152
2020-05-28,1,0,0,0,FR_PDL_53,229,43,152
2020-05-29,1,0,1,3,FR_PDL_53,230,44,155
2020-05-30,0,0,0,7,FR_PDL_53,230,44,162
2020-05-31,0,0,0,4,FR_PDL_53,230,44,166
2020-06-01,1,0,0,0,FR_PDL_53,231,44,166
2020-06-02,1,0,1,1,FR_PDL_53,232,45,167
2020-06-03,0,0,0,2,FR_PDL_53,232,45,169
2020-06-04,0,0,0,2,FR_PDL_53,232,45,171
2020-06-05,1,0,0,0,FR_PDL_53,233,45,171
2020-06-06,0,0,0,4,FR_PDL_53,233,45,175
2020-06-07,0,0,0,0,FR_PDL_53,233,45,175
2020-06-08,0,0,0,0,FR_PDL_53,233,45,175
2020-06-09,0,0,0,0,FR_PDL_53,233,45,175
2020-06-10,1,0,0,2,FR_PDL_53,234,45,177
2020-06-11,0,0,0,2,FR_PDL_53,234,45,179
2020-06-12,0,0,0,0,FR_PDL_53,234,45,179
2020-06-13,1,0,0,1,FR_PDL_53,235,45,180
2020-06-14,0,0,0,0,FR_PDL_53,235,45,180
2020-06-15,1,0,0,0,FR_PDL_53,236,45,180
2020-06-16,0,0,0,0,FR_PDL_53,236,45,180
2020-06-17,0,0,0,1,FR_PDL_53,236,45,181
2020-06-18,0,0,0,0,FR_PDL_53,236,45,181
2020-06-19,1,0,0,1,FR_PDL_53,237,45,182
2020-06-20,0,0,0,0,FR_PDL_53,237,45,182
2020-06-21,0,0,0,0,FR_PDL_53,237,45,182
2020-06-22,0,0,0,0,FR_PDL_53,237,45,182
2020-06-23,0,0,0,2,FR_PDL_53,237,45,184
2020-06-24,0,0,0,0,FR_PDL_53,237,45,184
2020-03-19,14,2,2,1,FR_GES_54,14,2,1
2020-03-20,9,1,1,0,FR_GES_54,23,3,1
2020-03-21,19,7,10,0,FR_GES_54,42,13,1
2020-03-22,44,23,2,10,FR_GES_54,86,15,11
2020-03-23,24,6,3,4,FR_GES_54,110,18,15
2020-03-24,42,17,5,8,FR_GES_54,152,23,23
2020-03-25,45,6,4,6,FR_GES_54,197,27,29
2020-03-26,27,5,5,10,FR_GES_54,224,32,39
2020-03-27,56,17,2,13,FR_GES_54,280,34,52
2020-03-28,76,26,3,12,FR_GES_54,356,37,64
2020-03-29,21,2,4,8,FR_GES_54,377,41,72
2020-03-30,72,14,8,17,FR_GES_54,449,49,89
2020-03-31,35,8,9,6,FR_GES_54,484,58,95
2020-04-01,75,20,17,40,FR_GES_54,559,75,135
2020-04-02,101,24,10,25,FR_GES_54,660,85,160
2020-04-03,75,14,14,35,FR_GES_54,735,99,195
2020-04-04,27,6,7,21,FR_GES_54,762,106,216
2020-04-05,13,3,7,15,FR_GES_54,775,113,231
2020-04-06,48,9,8,17,FR_GES_54,823,121,248
2020-04-07,36,5,9,46,FR_GES_54,859,130,294
2020-04-08,56,4,11,48,FR_GES_54,915,141,342
2020-04-09,24,5,5,30,FR_GES_54,939,146,372
2020-04-10,83,4,24,23,FR_GES_54,1022,170,395
2020-04-11,18,0,8,12,FR_GES_54,1040,178,407
2020-04-12,23,3,3,28,FR_GES_54,1063,181,435
2020-04-13,21,6,5,7,FR_GES_54,1084,186,442
2020-04-14,33,1,6,24,FR_GES_54,1117,192,466
2020-04-15,36,1,10,42,FR_GES_54,1153,202,508
2020-04-16,19,2,8,30,FR_GES_54,1172,210,538
2020-04-17,18,1,5,15,FR_GES_54,1190,215,553
2020-04-18,26,2,13,19,FR_GES_54,1216,228,572
2020-04-19,9,2,5,7,FR_GES_54,1225,233,579
2020-04-20,12,2,3,12,FR_GES_54,1237,236,591
2020-04-21,21,3,6,12,FR_GES_54,1258,242,603
2020-04-22,19,4,8,14,FR_GES_54,1277,250,617
2020-04-23,26,3,0,13,FR_GES_54,1303,250,630
2020-04-24,19,1,6,7,FR_GES_54,1322,256,637
2020-04-25,35,4,2,29,FR_GES_54,1357,258,666
2020-04-26,4,3,1,3,FR_GES_54,1361,259,669
2020-04-27,16,2,1,14,FR_GES_54,1377,260,683
2020-04-28,23,4,9,9,FR_GES_54,1400,269,692
2020-04-29,21,0,20,69,FR_GES_54,1421,289,761
2020-04-30,16,4,2,20,FR_GES_54,1437,291,781
2020-05-01,19,3,4,13,FR_GES_54,1456,295,794
2020-05-02,6,2,0,4,FR_GES_54,1462,295,798
2020-05-03,1,1,3,3,FR_GES_54,1463,298,801
2020-05-04,9,3,1,7,FR_GES_54,1472,299,808
2020-05-05,8,1,2,26,FR_GES_54,1480,301,834
2020-05-06,17,0,4,15,FR_GES_54,1497,305,849
2020-05-07,10,0,2,10,FR_GES_54,1507,307,859
2020-05-08,12,2,10,7,FR_GES_54,1519,317,866
2020-05-09,1,1,3,5,FR_GES_54,1520,320,871
2020-05-10,18,0,2,7,FR_GES_54,1538,322,878
2020-05-11,4,1,4,2,FR_GES_54,1542,326,880
2020-05-12,14,0,7,22,FR_GES_54,1556,333,902
2020-05-13,13,0,4,40,FR_GES_54,1569,337,942
2020-05-14,6,0,0,14,FR_GES_54,1575,337,956
2020-05-15,8,1,2,8,FR_GES_54,1583,339,964
2020-05-16,4,3,2,10,FR_GES_54,1587,341,974
2020-05-17,1,1,1,0,FR_GES_54,1588,342,974
2020-05-18,3,0,2,7,FR_GES_54,1591,344,981
2020-05-19,11,1,1,11,FR_GES_54,1602,345,992
2020-05-20,2,0,1,15,FR_GES_54,1604,346,1007
2020-05-21,4,2,0,8,FR_GES_54,1608,346,1015
2020-05-22,6,1,2,13,FR_GES_54,1614,348,1028
2020-05-23,8,1,2,1,FR_GES_54,1622,350,1029
2020-05-24,5,2,2,2,FR_GES_54,1627,352,1031
2020-05-25,21,2,0,42,FR_GES_54,1648,352,1073
2020-05-26,7,0,3,8,FR_GES_54,1655,355,1081
2020-05-27,6,0,1,8,FR_GES_54,1661,356,1089
2020-05-28,4,0,0,5,FR_GES_54,1665,356,1094
2020-05-29,5,1,0,8,FR_GES_54,1670,356,1102
2020-05-30,2,1,0,10,FR_GES_54,1672,356,1112
2020-05-31,1,0,0,2,FR_GES_54,1673,356,1114
2020-06-01,0,0,0,0,FR_GES_54,1673,356,1114
2020-06-02,2,0,1,6,FR_GES_54,1675,357,1120
2020-06-03,5,0,0,5,FR_GES_54,1680,357,1125
2020-06-04,4,0,3,11,FR_GES_54,1684,360,1136
2020-06-05,4,0,3,8,FR_GES_54,1688,363,1144
2020-06-06,11,1,1,2,FR_GES_54,1699,364,1146
2020-06-07,1,0,1,0,FR_GES_54,1700,365,1146
2020-06-08,4,0,2,8,FR_GES_54,1704,367,1154
2020-06-09,4,0,4,6,FR_GES_54,1708,371,1160
2020-06-10,7,0,0,7,FR_GES_54,1715,371,1167
2020-06-11,7,2,0,5,FR_GES_54,1722,371,1172
2020-06-12,5,1,0,6,FR_GES_54,1727,371,1178
2020-06-13,0,0,0,0,FR_GES_54,1727,371,1178
2020-06-14,1,1,0,1,FR_GES_54,1728,371,1179
2020-06-15,1,1,0,4,FR_GES_54,1729,371,1183
2020-06-16,4,1,0,13,FR_GES_54,1733,371,1196
2020-06-17,5,1,0,2,FR_GES_54,1738,371,1198
2020-06-18,6,2,0,1,FR_GES_54,1744,371,1199
2020-06-19,4,1,0,12,FR_GES_54,1748,371,1211
2020-06-20,0,0,0,2,FR_GES_54,1748,371,1213
2020-06-21,1,0,0,0,FR_GES_54,1749,371,1213
2020-06-22,2,0,0,15,FR_GES_54,1751,371,1228
2020-06-23,3,0,0,1,FR_GES_54,1754,371,1229
2020-06-24,6,0,0,9,FR_GES_54,1760,371,1238
2020-03-19,38,4,0,5,FR_GES_55,38,0,5
2020-03-20,5,1,0,1,FR_GES_55,43,0,6
2020-03-21,17,1,1,1,FR_GES_55,60,1,7
2020-03-22,0,0,0,0,FR_GES_55,60,1,7
2020-03-23,35,1,1,9,FR_GES_55,95,2,16
2020-03-24,23,3,7,4,FR_GES_55,118,9,20
2020-03-25,16,1,2,4,FR_GES_55,134,11,24
2020-03-26,19,2,1,8,FR_GES_55,153,12,32
2020-03-27,17,2,1,5,FR_GES_55,170,13,37
2020-03-28,4,0,1,1,FR_GES_55,174,14,38
2020-03-29,3,0,0,1,FR_GES_55,177,14,39
2020-03-30,40,4,3,18,FR_GES_55,217,17,57
2020-03-31,13,0,5,15,FR_GES_55,230,22,72
2020-04-01,31,3,0,9,FR_GES_55,261,22,81
2020-04-02,10,3,1,17,FR_GES_55,271,23,98
2020-04-03,20,7,2,13,FR_GES_55,291,25,111
2020-04-04,18,3,2,10,FR_GES_55,309,27,121
2020-04-05,2,1,1,3,FR_GES_55,311,28,124
2020-04-06,24,3,3,8,FR_GES_55,335,31,132
2020-04-07,18,1,3,19,FR_GES_55,353,34,151
2020-04-08,10,1,6,8,FR_GES_55,363,40,159
2020-04-09,10,1,2,14,FR_GES_55,373,42,173
2020-04-10,13,5,1,13,FR_GES_55,386,43,186
2020-04-11,6,1,3,10,FR_GES_55,392,46,196
2020-04-12,12,0,4,7,FR_GES_55,404,50,203
2020-04-13,1,1,0,1,FR_GES_55,405,50,204
2020-04-14,14,3,1,9,FR_GES_55,419,51,213
2020-04-15,17,1,2,13,FR_GES_55,436,53,226
2020-04-16,9,1,2,8,FR_GES_55,445,55,234
2020-04-17,14,0,9,4,FR_GES_55,459,64,238
2020-04-18,15,2,3,7,FR_GES_55,474,67,245
2020-04-19,7,0,2,2,FR_GES_55,481,69,247
2020-04-20,7,0,3,5,FR_GES_55,488,72,252
2020-04-21,5,0,3,10,FR_GES_55,493,75,262
2020-04-22,11,0,4,9,FR_GES_55,504,79,271
2020-04-23,7,1,1,8,FR_GES_55,511,80,279
2020-04-24,6,0,0,4,FR_GES_55,517,80,283
2020-04-25,3,0,3,3,FR_GES_55,520,83,286
2020-04-26,3,1,1,1,FR_GES_55,523,84,287
2020-04-27,3,0,2,5,FR_GES_55,526,86,292
2020-04-28,5,0,0,7,FR_GES_55,531,86,299
2020-04-29,8,0,2,4,FR_GES_55,539,88,303
2020-04-30,10,0,0,1,FR_GES_55,549,88,304
2020-05-01,4,0,0,2,FR_GES_55,553,88,306
2020-05-02,2,0,1,2,FR_GES_55,555,89,308
2020-05-03,4,0,0,0,FR_GES_55,559,89,308
2020-05-04,3,0,2,6,FR_GES_55,562,91,314
2020-05-05,5,1,1,3,FR_GES_55,567,92,317
2020-05-06,9,1,1,3,FR_GES_55,576,93,320
2020-05-07,5,0,3,3,FR_GES_55,581,96,323
2020-05-08,5,0,0,2,FR_GES_55,586,96,325
2020-05-09,2,0,1,0,FR_GES_55,588,97,325
2020-05-10,1,0,1,0,FR_GES_55,589,98,325
2020-05-11,6,0,1,6,FR_GES_55,595,99,331
2020-05-12,10,0,4,4,FR_GES_55,605,103,335
2020-05-13,3,1,1,8,FR_GES_55,608,104,343
2020-05-14,4,1,0,2,FR_GES_55,612,104,345
2020-05-15,20,1,0,7,FR_GES_55,632,104,352
2020-05-16,10,0,0,8,FR_GES_55,642,104,360
2020-05-17,1,0,0,0,FR_GES_55,643,104,360
2020-05-18,8,1,0,6,FR_GES_55,651,104,366
2020-05-19,10,2,2,6,FR_GES_55,661,106,372
2020-05-20,1,1,1,2,FR_GES_55,662,107,374
2020-05-21,1,0,0,7,FR_GES_55,663,107,381
2020-05-22,3,1,0,2,FR_GES_55,666,107,383
2020-05-23,5,1,0,2,FR_GES_55,671,107,385
2020-05-24,0,0,0,8,FR_GES_55,671,107,393
2020-05-25,5,0,2,3,FR_GES_55,676,109,396
2020-05-26,0,0,1,12,FR_GES_55,676,110,408
2020-05-27,6,0,0,3,FR_GES_55,682,110,411
2020-05-28,4,2,0,37,FR_GES_55,686,110,448
2020-05-29,9,1,0,29,FR_GES_55,695,110,477
2020-05-30,1,1,0,3,FR_GES_55,696,110,480
2020-05-31,0,0,1,0,FR_GES_55,696,111,480
2020-06-01,1,0,0,0,FR_GES_55,697,111,480
2020-06-02,2,0,1,6,FR_GES_55,699,112,486
2020-06-03,6,0,1,4,FR_GES_55,705,113,490
2020-06-04,4,0,0,2,FR_GES_55,709,113,492
2020-06-05,5,0,1,2,FR_GES_55,714,114,494
2020-06-06,2,0,0,0,FR_GES_55,716,114,494
2020-06-07,0,0,0,0,FR_GES_55,716,114,494
2020-06-08,4,0,1,1,FR_GES_55,720,115,495
2020-06-09,0,0,0,6,FR_GES_55,720,115,501
2020-06-10,2,0,0,5,FR_GES_55,722,115,506
2020-06-11,2,0,0,7,FR_GES_55,724,115,513
2020-06-12,2,0,0,7,FR_GES_55,726,115,520
2020-06-13,1,0,1,3,FR_GES_55,727,116,523
2020-06-14,0,0,0,0,FR_GES_55,727,116,523
2020-06-15,2,0,0,1,FR_GES_55,729,116,524
2020-06-16,0,0,2,0,FR_GES_55,729,118,524
2020-06-17,1,0,0,1,FR_GES_55,730,118,525
2020-06-18,6,0,0,1,FR_GES_55,736,118,526
2020-06-19,1,1,0,0,FR_GES_55,737,118,526
2020-06-20,0,0,0,1,FR_GES_55,737,118,527
2020-06-21,0,0,0,0,FR_GES_55,737,118,527
2020-06-22,5,0,1,5,FR_GES_55,742,119,532
2020-06-23,2,0,0,3,FR_GES_55,744,119,535
2020-06-24,0,0,0,0,FR_GES_55,744,119,535
2020-03-19,12,1,3,2,FR_BRE_56,12,3,2
2020-03-20,6,0,0,2,FR_BRE_56,18,3,4
2020-03-21,24,4,3,1,FR_BRE_56,42,6,5
2020-03-22,11,5,1,4,FR_BRE_56,53,7,9
2020-03-23,5,0,4,4,FR_BRE_56,58,11,13
2020-03-24,9,1,0,8,FR_BRE_56,67,11,21
2020-03-25,14,0,3,9,FR_BRE_56,81,14,30
2020-03-26,27,5,1,5,FR_BRE_56,108,15,35
2020-03-27,13,3,4,10,FR_BRE_56,121,19,45
2020-03-28,12,6,0,7,FR_BRE_56,133,19,52
2020-03-29,14,1,3,5,FR_BRE_56,147,22,57
2020-03-30,16,3,1,3,FR_BRE_56,163,23,60
2020-03-31,13,3,1,4,FR_BRE_56,176,24,64
2020-04-01,26,5,2,5,FR_BRE_56,202,26,69
2020-04-02,18,2,3,9,FR_BRE_56,220,29,78
2020-04-03,13,5,2,4,FR_BRE_56,233,31,82
2020-04-04,7,2,3,13,FR_BRE_56,240,34,95
2020-04-05,8,1,5,3,FR_BRE_56,248,39,98
2020-04-06,10,1,3,6,FR_BRE_56,258,42,104
2020-04-07,9,2,4,9,FR_BRE_56,267,46,113
2020-04-08,35,2,3,22,FR_BRE_56,302,49,135
2020-04-09,6,1,0,13,FR_BRE_56,308,49,148
2020-04-10,7,2,2,13,FR_BRE_56,315,51,161
2020-04-11,14,4,3,18,FR_BRE_56,329,54,179
2020-04-12,7,2,1,4,FR_BRE_56,336,55,183
2020-04-13,2,2,0,3,FR_BRE_56,338,55,186
2020-04-14,8,2,5,7,FR_BRE_56,346,60,193
2020-04-15,3,0,4,9,FR_BRE_56,349,64,202
2020-04-16,5,0,3,6,FR_BRE_56,354,67,208
2020-04-17,6,0,0,4,FR_BRE_56,360,67,212
2020-04-18,11,1,1,11,FR_BRE_56,371,68,223
2020-04-19,2,0,1,0,FR_BRE_56,373,69,223
2020-04-20,5,0,1,2,FR_BRE_56,378,70,225
2020-04-21,9,1,1,7,FR_BRE_56,387,71,232
2020-04-22,8,1,0,6,FR_BRE_56,395,71,238
2020-04-23,11,0,0,4,FR_BRE_56,406,71,242
2020-04-24,14,0,0,7,FR_BRE_56,420,71,249
2020-04-25,1,0,1,6,FR_BRE_56,421,72,255
2020-04-26,1,1,0,2,FR_BRE_56,422,72,257
2020-04-27,2,1,0,1,FR_BRE_56,424,72,258
2020-04-28,14,1,1,8,FR_BRE_56,438,73,266
2020-04-29,4,2,1,4,FR_BRE_56,442,74,270
2020-04-30,7,0,2,10,FR_BRE_56,449,76,280
2020-05-01,2,0,0,3,FR_BRE_56,451,76,283
2020-05-02,3,1,1,4,FR_BRE_56,454,77,287
2020-05-03,3,0,1,3,FR_BRE_56,457,78,290
2020-05-04,2,2,1,3,FR_BRE_56,459,79,293
2020-05-05,2,0,0,3,FR_BRE_56,461,79,296
2020-05-06,3,1,0,7,FR_BRE_56,464,79,303
2020-05-07,1,2,0,2,FR_BRE_56,465,79,305
2020-05-08,2,0,0,4,FR_BRE_56,467,79,309
2020-05-09,1,1,0,5,FR_BRE_56,468,79,314
2020-05-10,1,1,0,1,FR_BRE_56,469,79,315
2020-05-11,1,1,1,1,FR_BRE_56,470,80,316
2020-05-12,4,0,0,4,FR_BRE_56,474,80,320
2020-05-13,0,1,0,13,FR_BRE_56,474,80,333
2020-05-14,0,0,0,3,FR_BRE_56,474,80,336
2020-05-15,0,0,0,3,FR_BRE_56,474,80,339
2020-05-16,2,1,0,2,FR_BRE_56,476,80,341
2020-05-17,0,0,0,2,FR_BRE_56,476,80,343
2020-05-18,1,1,3,8,FR_BRE_56,477,83,351
2020-05-19,0,0,0,11,FR_BRE_56,477,83,362
2020-05-20,4,1,0,4,FR_BRE_56,481,83,366
2020-05-21,1,0,0,1,FR_BRE_56,482,83,367
2020-05-22,0,0,0,0,FR_BRE_56,482,83,367
2020-05-23,0,0,0,1,FR_BRE_56,482,83,368
2020-05-24,0,0,0,0,FR_BRE_56,482,83,368
2020-05-25,3,0,1,1,FR_BRE_56,485,84,369
2020-05-26,0,0,1,3,FR_BRE_56,485,85,372
2020-05-27,1,0,0,3,FR_BRE_56,486,85,375
2020-05-28,2,1,1,1,FR_BRE_56,488,86,376
2020-05-29,2,0,0,2,FR_BRE_56,490,86,378
2020-05-30,4,0,0,2,FR_BRE_56,494,86,380
2020-05-31,1,0,0,0,FR_BRE_56,495,86,380
2020-06-01,0,0,0,0,FR_BRE_56,495,86,380
2020-06-02,1,1,0,6,FR_BRE_56,496,86,386
2020-06-03,2,0,0,3,FR_BRE_56,498,86,389
2020-06-04,1,0,0,3,FR_BRE_56,499,86,392
2020-06-05,0,0,0,2,FR_BRE_56,499,86,394
2020-06-06,0,0,0,0,FR_BRE_56,499,86,394
2020-06-07,1,0,0,0,FR_BRE_56,500,86,394
2020-06-08,0,0,0,0,FR_BRE_56,500,86,394
2020-06-09,0,0,0,2,FR_BRE_56,500,86,396
2020-06-10,0,0,0,1,FR_BRE_56,500,86,397
2020-06-11,0,0,0,1,FR_BRE_56,500,86,398
2020-06-12,0,0,1,2,FR_BRE_56,500,87,400
2020-06-13,1,0,0,8,FR_BRE_56,501,87,408
2020-06-14,0,0,0,0,FR_BRE_56,501,87,408
2020-06-15,0,0,0,0,FR_BRE_56,501,87,408
2020-06-16,0,0,0,1,FR_BRE_56,501,87,409
2020-06-17,0,0,0,0,FR_BRE_56,501,87,409
2020-06-18,0,0,0,2,FR_BRE_56,501,87,411
2020-06-19,1,0,0,2,FR_BRE_56,502,87,413
2020-06-20,0,0,0,3,FR_BRE_56,502,87,416
2020-06-21,0,0,0,0,FR_BRE_56,502,87,416
2020-06-22,0,0,0,0,FR_BRE_56,502,87,416
2020-06-23,1,0,1,0,FR_BRE_56,503,88,416
2020-06-24,0,0,0,0,FR_BRE_56,503,88,416
2020-03-19,36,15,4,5,FR_GES_57,36,4,5
2020-03-20,76,14,3,8,FR_GES_57,112,7,13
2020-03-21,68,11,3,15,FR_GES_57,180,10,28
2020-03-22,65,8,11,12,FR_GES_57,245,21,40
2020-03-23,69,13,17,8,FR_GES_57,314,38,48
2020-03-24,173,27,12,24,FR_GES_57,487,50,72
2020-03-25,92,20,14,34,FR_GES_57,579,64,106
2020-03-26,125,12,20,30,FR_GES_57,704,84,136
2020-03-27,106,16,24,28,FR_GES_57,810,108,164
2020-03-28,124,27,30,32,FR_GES_57,934,138,196
2020-03-29,87,23,11,11,FR_GES_57,1021,149,207
2020-03-30,117,25,19,21,FR_GES_57,1138,168,228
2020-03-31,121,23,11,24,FR_GES_57,1259,179,252
2020-04-01,147,17,19,47,FR_GES_57,1406,198,299
2020-04-02,110,20,30,57,FR_GES_57,1516,228,356
2020-04-03,127,16,42,70,FR_GES_57,1643,270,426
2020-04-04,83,15,30,42,FR_GES_57,1726,300,468
2020-04-05,66,12,25,44,FR_GES_57,1792,325,512
2020-04-06,75,20,21,51,FR_GES_57,1867,346,563
2020-04-07,115,12,31,63,FR_GES_57,1982,377,626
2020-04-08,75,8,29,64,FR_GES_57,2057,406,690
2020-04-09,89,8,16,52,FR_GES_57,2146,422,742
2020-04-10,116,1,24,58,FR_GES_57,2262,446,800
2020-04-11,34,7,15,26,FR_GES_57,2296,461,826
2020-04-12,53,5,13,29,FR_GES_57,2349,474,855
2020-04-13,27,10,17,15,FR_GES_57,2376,491,870
2020-04-14,63,6,16,23,FR_GES_57,2439,507,893
2020-04-15,95,8,18,72,FR_GES_57,2534,525,965
2020-04-16,71,5,11,61,FR_GES_57,2605,536,1026
2020-04-17,50,8,8,54,FR_GES_57,2655,544,1080
2020-04-18,41,8,12,59,FR_GES_57,2696,556,1139
2020-04-19,13,3,9,19,FR_GES_57,2709,565,1158
2020-04-20,36,2,10,22,FR_GES_57,2745,575,1180
2020-04-21,31,4,7,45,FR_GES_57,2776,582,1225
2020-04-22,58,6,11,44,FR_GES_57,2834,593,1269
2020-04-23,56,7,8,59,FR_GES_57,2890,601,1328
2020-04-24,38,4,9,53,FR_GES_57,2928,610,1381
2020-04-25,30,2,13,63,FR_GES_57,2958,623,1444
2020-04-26,17,4,3,20,FR_GES_57,2975,626,1464
2020-04-27,29,1,9,26,FR_GES_57,3004,635,1490
2020-04-28,27,7,9,43,FR_GES_57,3031,644,1533
2020-04-29,34,1,8,63,FR_GES_57,3065,652,1596
2020-04-30,24,5,8,69,FR_GES_57,3089,660,1665
2020-05-01,20,1,13,39,FR_GES_57,3109,673,1704
2020-05-02,33,3,5,26,FR_GES_57,3142,678,1730
2020-05-03,18,4,3,7,FR_GES_57,3160,681,1737
2020-05-04,18,3,6,30,FR_GES_57,3178,687,1767
2020-05-05,24,5,9,42,FR_GES_57,3202,696,1809
2020-05-06,23,2,6,47,FR_GES_57,3225,702,1856
2020-05-07,27,3,4,26,FR_GES_57,3252,706,1882
2020-05-08,27,5,11,28,FR_GES_57,3279,717,1910
2020-05-09,5,1,0,11,FR_GES_57,3284,717,1921
2020-05-10,4,1,1,8,FR_GES_57,3288,718,1929
2020-05-11,11,1,3,3,FR_GES_57,3299,721,1932
2020-05-12,28,4,8,33,FR_GES_57,3327,729,1965
2020-05-13,30,4,10,18,FR_GES_57,3357,739,1983
2020-05-14,22,0,7,36,FR_GES_57,3379,746,2019
2020-05-15,12,3,16,24,FR_GES_57,3391,762,2043
2020-05-16,5,0,5,15,FR_GES_57,3396,767,2058
2020-05-17,4,1,7,6,FR_GES_57,3400,774,2064
2020-05-18,5,0,8,2,FR_GES_57,3405,782,2066
2020-05-19,15,2,7,24,FR_GES_57,3420,789,2090
2020-05-20,13,4,7,38,FR_GES_57,3433,796,2128
2020-05-21,7,6,1,15,FR_GES_57,3440,797,2143
2020-05-22,3,0,4,4,FR_GES_57,3443,801,2147
2020-05-23,13,2,0,3,FR_GES_57,3456,801,2150
2020-05-24,6,1,0,8,FR_GES_57,3462,801,2158
2020-05-25,8,2,0,6,FR_GES_57,3470,801,2164
2020-05-26,3,2,3,9,FR_GES_57,3473,804,2173
2020-05-27,3,1,1,11,FR_GES_57,3476,805,2184
2020-05-28,5,0,1,10,FR_GES_57,3481,806,2194
2020-05-29,3,2,2,7,FR_GES_57,3484,808,2201
2020-05-30,5,2,3,27,FR_GES_57,3489,811,2228
2020-05-31,5,1,1,1,FR_GES_57,3494,812,2229
2020-06-01,5,3,2,15,FR_GES_57,3499,814,2244
2020-06-02,13,1,4,14,FR_GES_57,3512,818,2258
2020-06-03,20,5,3,22,FR_GES_57,3532,821,2280
2020-06-04,6,1,3,22,FR_GES_57,3538,824,2302
2020-06-05,10,1,2,11,FR_GES_57,3548,826,2313
2020-06-06,1,0,1,19,FR_GES_57,3549,827,2332
2020-06-07,2,0,0,3,FR_GES_57,3551,827,2335
2020-06-08,2,0,4,2,FR_GES_57,3553,831,2337
2020-06-09,1,0,1,8,FR_GES_57,3554,832,2345
2020-06-10,3,2,4,12,FR_GES_57,3557,836,2357
2020-06-11,0,0,1,2,FR_GES_57,3557,837,2359
2020-06-12,2,0,1,27,FR_GES_57,3559,838,2386
2020-06-13,6,3,0,7,FR_GES_57,3565,838,2393
2020-06-14,3,2,0,0,FR_GES_57,3568,838,2393
2020-06-15,0,0,2,1,FR_GES_57,3568,840,2394
2020-06-16,2,1,1,4,FR_GES_57,3570,841,2398
2020-06-17,6,0,2,11,FR_GES_57,3576,843,2409
2020-06-18,0,0,1,7,FR_GES_57,3576,844,2416
2020-06-19,10,0,1,15,FR_GES_57,3586,845,2431
2020-06-20,0,0,0,1,FR_GES_57,3586,845,2432
2020-06-21,0,0,0,0,FR_GES_57,3586,845,2432
2020-06-22,1,0,0,0,FR_GES_57,3587,845,2432
2020-06-23,0,0,1,1,FR_GES_57,3587,846,2433
2020-06-24,0,0,0,1,FR_GES_57,3587,846,2434
2020-03-19,1,1,0,0,FR_BFC_58,1,0,0
2020-03-20,0,0,0,0,FR_BFC_58,1,0,0
2020-03-21,0,0,0,0,FR_BFC_58,1,0,0
2020-03-22,1,1,0,0,FR_BFC_58,2,0,0
2020-03-23,1,0,0,0,FR_BFC_58,3,0,0
2020-03-24,0,0,0,0,FR_BFC_58,3,0,0
2020-03-25,0,0,0,0,FR_BFC_58,3,0,0
2020-03-26,1,0,0,0,FR_BFC_58,4,0,0
2020-03-27,2,1,0,0,FR_BFC_58,6,0,0
2020-03-28,2,1,0,1,FR_BFC_58,8,0,1
2020-03-29,0,0,0,0,FR_BFC_58,8,0,1
2020-03-30,2,0,0,0,FR_BFC_58,10,0,1
2020-03-31,2,1,2,0,FR_BFC_58,12,2,1
2020-04-01,1,1,1,0,FR_BFC_58,13,3,1
2020-04-02,6,0,1,1,FR_BFC_58,19,4,2
2020-04-03,7,0,1,0,FR_BFC_58,26,5,2
2020-04-04,8,0,0,4,FR_BFC_58,34,5,6
2020-04-05,8,3,0,1,FR_BFC_58,42,5,7
2020-04-06,4,0,1,0,FR_BFC_58,46,6,7
2020-04-07,1,0,1,2,FR_BFC_58,47,7,9
2020-04-08,5,1,0,3,FR_BFC_58,52,7,12
2020-04-09,1,0,0,0,FR_BFC_58,53,7,12
2020-04-10,13,2,0,2,FR_BFC_58,66,7,14
2020-04-11,7,0,0,2,FR_BFC_58,73,7,16
2020-04-12,3,1,0,1,FR_BFC_58,76,7,17
2020-04-13,5,2,1,0,FR_BFC_58,81,8,17
2020-04-14,2,0,4,1,FR_BFC_58,83,12,18
2020-04-15,2,1,0,4,FR_BFC_58,85,12,22
2020-04-16,10,1,0,1,FR_BFC_58,95,12,23
2020-04-17,4,0,0,4,FR_BFC_58,99,12,27
2020-04-18,3,2,2,2,FR_BFC_58,102,14,29
2020-04-19,1,1,1,0,FR_BFC_58,103,15,29
2020-04-20,2,0,3,0,FR_BFC_58,105,18,29
2020-04-21,2,2,1,1,FR_BFC_58,107,19,30
2020-04-22,2,0,2,2,FR_BFC_58,109,21,32
2020-04-23,3,0,0,7,FR_BFC_58,112,21,39
2020-04-24,3,1,0,3,FR_BFC_58,115,21,42
2020-04-25,3,0,1,2,FR_BFC_58,118,22,44
2020-04-26,0,0,0,0,FR_BFC_58,118,22,44
2020-04-27,0,0,0,1,FR_BFC_58,118,22,45
2020-04-28,1,1,0,2,FR_BFC_58,119,22,47
2020-04-29,3,0,0,2,FR_BFC_58,122,22,49
2020-04-30,1,0,0,0,FR_BFC_58,123,22,49
2020-05-01,0,0,0,1,FR_BFC_58,123,22,50
2020-05-02,0,0,1,0,FR_BFC_58,123,23,50
2020-05-03,0,0,0,0,FR_BFC_58,123,23,50
2020-05-04,0,0,0,0,FR_BFC_58,123,23,50
2020-05-05,0,0,0,1,FR_BFC_58,123,23,51
2020-05-06,0,0,1,1,FR_BFC_58,123,24,52
2020-05-07,0,0,0,4,FR_BFC_58,123,24,56
2020-05-08,0,0,0,1,FR_BFC_58,123,24,57
2020-05-09,0,0,0,0,FR_BFC_58,123,24,57
2020-05-10,0,0,1,0,FR_BFC_58,123,25,57
2020-05-11,2,2,0,1,FR_BFC_58,125,25,58
2020-05-12,2,1,0,0,FR_BFC_58,127,25,58
2020-05-13,0,0,0,2,FR_BFC_58,127,25,60
2020-05-14,0,0,0,1,FR_BFC_58,127,25,61
2020-05-15,1,1,0,0,FR_BFC_58,128,25,61
2020-05-16,0,0,0,1,FR_BFC_58,128,25,62
2020-05-17,0,0,0,0,FR_BFC_58,128,25,62
2020-05-18,0,0,0,0,FR_BFC_58,128,25,62
2020-05-19,0,0,0,0,FR_BFC_58,128,25,62
2020-05-20,1,0,0,10,FR_BFC_58,129,25,72
2020-05-21,1,0,0,4,FR_BFC_58,130,25,76
2020-05-22,0,0,0,0,FR_BFC_58,130,25,76
2020-05-23,0,0,0,0,FR_BFC_58,130,25,76
2020-05-24,0,0,1,0,FR_BFC_58,130,26,76
2020-05-25,0,0,0,0,FR_BFC_58,130,26,76
2020-05-26,1,0,0,1,FR_BFC_58,131,26,77
2020-05-27,0,0,1,1,FR_BFC_58,131,27,78
2020-05-28,0,0,0,2,FR_BFC_58,131,27,80
2020-05-29,0,0,0,8,FR_BFC_58,131,27,88
2020-05-30,4,0,0,1,FR_BFC_58,135,27,89
2020-05-31,0,0,0,0,FR_BFC_58,135,27,89
2020-06-01,0,0,0,0,FR_BFC_58,135,27,89
2020-06-02,0,0,0,0,FR_BFC_58,135,27,89
2020-06-03,1,0,0,0,FR_BFC_58,136,27,89
2020-06-04,0,0,0,0,FR_BFC_58,136,27,89
2020-06-05,0,0,0,0,FR_BFC_58,136,27,89
2020-06-06,0,0,0,0,FR_BFC_58,136,27,89
2020-06-07,0,0,0,0,FR_BFC_58,136,27,89
2020-06-08,0,0,0,0,FR_BFC_58,136,27,89
2020-06-09,0,0,0,1,FR_BFC_58,136,27,90
2020-06-10,0,0,0,0,FR_BFC_58,136,27,90
2020-06-11,0,0,0,0,FR_BFC_58,136,27,90
2020-06-12,0,0,0,0,FR_BFC_58,136,27,90
2020-06-13,0,0,0,0,FR_BFC_58,136,27,90
2020-06-14,0,0,0,0,FR_BFC_58,136,27,90
2020-06-15,0,0,0,0,FR_BFC_58,136,27,90
2020-06-16,0,0,0,0,FR_BFC_58,136,27,90
2020-06-17,0,0,0,0,FR_BFC_58,136,27,90
2020-06-18,0,0,0,0,FR_BFC_58,136,27,90
2020-06-19,0,0,0,0,FR_BFC_58,136,27,90
2020-06-20,0,0,0,0,FR_BFC_58,136,27,90
2020-06-21,0,0,0,0,FR_BFC_58,136,27,90
2020-06-22,1,0,0,0,FR_BFC_58,137,27,90
2020-06-23,0,0,0,0,FR_BFC_58,137,27,90
2020-06-24,0,0,0,3,FR_BFC_58,137,27,93
2020-03-19,72,13,3,24,FR_HDF_59,72,3,24
2020-03-20,19,9,1,4,FR_HDF_59,91,4,28
2020-03-21,30,15,1,7,FR_HDF_59,121,5,35
2020-03-22,32,7,7,2,FR_HDF_59,153,12,37
2020-03-23,58,26,2,11,FR_HDF_59,211,14,48
2020-03-24,50,15,4,2,FR_HDF_59,261,18,50
2020-03-25,63,20,1,5,FR_HDF_59,324,19,55
2020-03-26,66,17,7,14,FR_HDF_59,390,26,69
2020-03-27,84,34,8,27,FR_HDF_59,474,34,96
2020-03-28,77,16,5,16,FR_HDF_59,551,39,112
2020-03-29,80,23,3,19,FR_HDF_59,631,42,131
2020-03-30,105,26,12,26,FR_HDF_59,736,54,157
2020-03-31,129,39,11,44,FR_HDF_59,865,65,201
2020-04-01,95,19,15,36,FR_HDF_59,960,80,237
2020-04-02,157,35,21,43,FR_HDF_59,1117,101,280
2020-04-03,100,23,22,46,FR_HDF_59,1217,123,326
2020-04-04,94,19,13,40,FR_HDF_59,1311,136,366
2020-04-05,78,18,12,14,FR_HDF_59,1389,148,380
2020-04-06,112,17,19,39,FR_HDF_59,1501,167,419
2020-04-07,101,19,17,63,FR_HDF_59,1602,184,482
2020-04-08,89,7,15,72,FR_HDF_59,1691,199,554
2020-04-09,90,14,16,51,FR_HDF_59,1781,215,605
2020-04-10,103,15,15,59,FR_HDF_59,1884,230,664
2020-04-11,71,9,20,51,FR_HDF_59,1955,250,715
2020-04-12,39,2,11,11,FR_HDF_59,1994,261,726
2020-04-13,41,9,15,8,FR_HDF_59,2035,276,734
2020-04-14,60,4,21,24,FR_HDF_59,2095,297,758
2020-04-15,79,4,21,93,FR_HDF_59,2174,318,851
2020-04-16,74,8,15,63,FR_HDF_59,2248,333,914
2020-04-17,56,13,17,61,FR_HDF_59,2304,350,975
2020-04-18,44,4,8,30,FR_HDF_59,2348,358,1005
2020-04-19,32,9,6,19,FR_HDF_59,2380,364,1024
2020-04-20,54,3,7,18,FR_HDF_59,2434,371,1042
2020-04-21,62,11,13,71,FR_HDF_59,2496,384,1113
2020-04-22,39,5,9,30,FR_HDF_59,2535,393,1143
2020-04-23,42,7,6,39,FR_HDF_59,2577,399,1182
2020-04-24,30,5,7,40,FR_HDF_59,2607,406,1222
2020-04-25,36,1,6,33,FR_HDF_59,2643,412,1255
2020-04-26,7,3,1,7,FR_HDF_59,2650,413,1262
2020-04-27,10,3,5,14,FR_HDF_59,2660,418,1276
2020-04-28,53,5,8,45,FR_HDF_59,2713,426,1321
2020-04-29,17,0,6,39,FR_HDF_59,2730,432,1360
2020-04-30,33,5,8,36,FR_HDF_59,2763,440,1396
2020-05-01,24,2,6,21,FR_HDF_59,2787,446,1417
2020-05-02,23,0,2,3,FR_HDF_59,2810,448,1420
2020-05-03,13,5,1,4,FR_HDF_59,2823,449,1424
2020-05-04,28,4,3,9,FR_HDF_59,2851,452,1433
2020-05-05,20,2,20,53,FR_HDF_59,2871,472,1486
2020-05-06,33,6,16,64,FR_HDF_59,2904,488,1550
2020-05-07,23,4,7,20,FR_HDF_59,2927,495,1570
2020-05-08,23,3,3,25,FR_HDF_59,2950,498,1595
2020-05-09,4,2,1,4,FR_HDF_59,2954,499,1599
2020-05-10,11,2,3,6,FR_HDF_59,2965,502,1605
2020-05-11,18,1,7,8,FR_HDF_59,2983,509,1613
2020-05-12,32,4,10,50,FR_HDF_59,3015,519,1663
2020-05-13,26,4,2,33,FR_HDF_59,3041,521,1696
2020-05-14,18,4,4,18,FR_HDF_59,3059,525,1714
2020-05-15,20,0,9,31,FR_HDF_59,3079,534,1745
2020-05-16,24,2,4,19,FR_HDF_59,3103,538,1764
2020-05-17,10,2,2,6,FR_HDF_59,3113,540,1770
2020-05-18,18,2,6,11,FR_HDF_59,3131,546,1781
2020-05-19,21,2,4,38,FR_HDF_59,3152,550,1819
2020-05-20,33,6,5,25,FR_HDF_59,3185,555,1844
2020-05-21,17,1,4,23,FR_HDF_59,3202,559,1867
2020-05-22,10,0,1,13,FR_HDF_59,3212,560,1880
2020-05-23,6,0,2,15,FR_HDF_59,3218,562,1895
2020-05-24,11,1,2,6,FR_HDF_59,3229,564,1901
2020-05-25,6,0,4,18,FR_HDF_59,3235,568,1919
2020-05-26,18,3,3,23,FR_HDF_59,3253,571,1942
2020-05-27,25,0,2,28,FR_HDF_59,3278,573,1970
2020-05-28,13,1,4,15,FR_HDF_59,3291,577,1985
2020-05-29,9,0,2,30,FR_HDF_59,3300,579,2015
2020-05-30,18,1,6,28,FR_HDF_59,3318,585,2043
2020-05-31,2,1,0,3,FR_HDF_59,3320,585,2046
2020-06-01,4,1,2,4,FR_HDF_59,3324,587,2050
2020-06-02,7,0,2,11,FR_HDF_59,3331,589,2061
2020-06-03,8,1,6,22,FR_HDF_59,3339,595,2083
2020-06-04,10,4,2,13,FR_HDF_59,3349,597,2096
2020-06-05,13,0,5,20,FR_HDF_59,3362,602,2116
2020-06-06,8,3,2,5,FR_HDF_59,3370,604,2121
2020-06-07,3,0,1,0,FR_HDF_59,3373,605,2121
2020-06-08,6,2,3,6,FR_HDF_59,3379,608,2127
2020-06-09,17,2,1,25,FR_HDF_59,3396,609,2152
2020-06-10,9,2,1,11,FR_HDF_59,3405,610,2163
2020-06-11,2,1,0,12,FR_HDF_59,3407,610,2175
2020-06-12,5,0,1,10,FR_HDF_59,3412,611,2185
2020-06-13,2,0,1,3,FR_HDF_59,3414,612,2188
2020-06-14,1,0,0,0,FR_HDF_59,3415,612,2188
2020-06-15,6,1,1,7,FR_HDF_59,3421,613,2195
2020-06-16,9,0,3,8,FR_HDF_59,3430,616,2203
2020-06-17,3,1,2,11,FR_HDF_59,3433,618,2214
2020-06-18,9,0,1,6,FR_HDF_59,3442,619,2220
2020-06-19,3,1,0,6,FR_HDF_59,3445,619,2226
2020-06-20,2,0,1,7,FR_HDF_59,3447,620,2233
2020-06-21,0,0,1,0,FR_HDF_59,3447,621,2233
2020-06-22,2,0,1,6,FR_HDF_59,3449,622,2239
2020-06-23,7,1,0,10,FR_HDF_59,3456,622,2249
2020-06-24,7,0,0,15,FR_HDF_59,3463,622,2264
2020-03-19,43,3,11,8,FR_HDF_60,43,11,8
2020-03-20,11,6,1,4,FR_HDF_60,54,12,12
2020-03-21,30,1,0,14,FR_HDF_60,84,12,26
2020-03-22,14,1,1,4,FR_HDF_60,98,13,30
2020-03-23,45,4,10,7,FR_HDF_60,143,23,37
2020-03-24,41,4,9,17,FR_HDF_60,184,32,54
2020-03-25,34,10,6,7,FR_HDF_60,218,38,61
2020-03-26,61,7,14,31,FR_HDF_60,279,52,92
2020-03-27,30,10,9,12,FR_HDF_60,309,61,104
2020-03-28,37,0,11,7,FR_HDF_60,346,72,111
2020-03-29,23,3,5,3,FR_HDF_60,369,77,114
2020-03-30,35,5,8,10,FR_HDF_60,404,85,124
2020-03-31,41,6,15,11,FR_HDF_60,445,100,135
2020-04-01,70,9,20,33,FR_HDF_60,515,120,168
2020-04-02,102,15,7,32,FR_HDF_60,617,127,200
2020-04-03,47,5,15,29,FR_HDF_60,664,142,229
2020-04-04,23,1,8,29,FR_HDF_60,687,150,258
2020-04-05,26,4,2,6,FR_HDF_60,713,152,264
2020-04-06,39,2,10,10,FR_HDF_60,752,162,274
2020-04-07,82,9,17,32,FR_HDF_60,834,179,306
2020-04-08,75,7,10,48,FR_HDF_60,909,189,354
2020-04-09,28,3,2,23,FR_HDF_60,937,191,377
2020-04-10,46,6,9,27,FR_HDF_60,983,200,404
2020-04-11,39,2,9,20,FR_HDF_60,1022,209,424
2020-04-12,43,4,10,15,FR_HDF_60,1065,219,439
2020-04-13,7,0,7,2,FR_HDF_60,1072,226,441
2020-04-14,32,2,9,24,FR_HDF_60,1104,235,465
2020-04-15,56,3,13,16,FR_HDF_60,1160,248,481
2020-04-16,43,4,10,34,FR_HDF_60,1203,258,515
2020-04-17,45,3,6,22,FR_HDF_60,1248,264,537
2020-04-18,14,2,3,9,FR_HDF_60,1262,267,546
2020-04-19,32,3,4,12,FR_HDF_60,1294,271,558
2020-04-20,14,1,13,14,FR_HDF_60,1308,284,572
2020-04-21,22,2,5,27,FR_HDF_60,1330,289,599
2020-04-22,25,5,9,36,FR_HDF_60,1355,298,635
2020-04-23,25,3,6,19,FR_HDF_60,1380,304,654
2020-04-24,30,2,6,31,FR_HDF_60,1410,310,685
2020-04-25,14,0,4,10,FR_HDF_60,1424,314,695
2020-04-26,5,1,1,2,FR_HDF_60,1429,315,697
2020-04-27,14,0,8,18,FR_HDF_60,1443,323,715
2020-04-28,22,1,6,28,FR_HDF_60,1465,329,743
2020-04-29,7,2,2,10,FR_HDF_60,1472,331,753
2020-04-30,3,3,4,14,FR_HDF_60,1475,335,767
2020-05-01,6,1,4,8,FR_HDF_60,1481,339,775
2020-05-02,5,0,0,2,FR_HDF_60,1486,339,777
2020-05-03,7,0,4,14,FR_HDF_60,1493,343,791
2020-05-04,8,0,2,5,FR_HDF_60,1501,345,796
2020-05-05,10,1,6,15,FR_HDF_60,1511,351,811
2020-05-06,3,1,3,7,FR_HDF_60,1514,354,818
2020-05-07,5,0,1,12,FR_HDF_60,1519,355,830
2020-05-08,13,1,6,12,FR_HDF_60,1532,361,842
2020-05-09,3,0,0,5,FR_HDF_60,1535,361,847
2020-05-10,1,0,3,2,FR_HDF_60,1536,364,849
2020-05-11,18,5,7,8,FR_HDF_60,1554,371,857
2020-05-12,6,1,6,5,FR_HDF_60,1560,377,862
2020-05-13,1,0,0,6,FR_HDF_60,1561,377,868
2020-05-14,10,1,0,6,FR_HDF_60,1571,377,874
2020-05-15,11,1,1,15,FR_HDF_60,1582,378,889
2020-05-16,6,0,1,6,FR_HDF_60,1588,379,895
2020-05-17,2,0,0,0,FR_HDF_60,1590,379,895
2020-05-18,10,0,5,10,FR_HDF_60,1600,384,905
2020-05-19,15,1,1,30,FR_HDF_60,1615,385,935
2020-05-20,6,0,1,4,FR_HDF_60,1621,386,939
2020-05-21,3,0,0,5,FR_HDF_60,1624,386,944
2020-05-22,5,0,1,12,FR_HDF_60,1629,387,956
2020-05-23,2,0,2,5,FR_HDF_60,1631,389,961
2020-05-24,2,0,1,0,FR_HDF_60,1633,390,961
2020-05-25,5,0,2,6,FR_HDF_60,1638,392,967
2020-05-26,2,0,0,7,FR_HDF_60,1640,392,974
2020-05-27,4,0,3,5,FR_HDF_60,1644,395,979
2020-05-28,3,0,2,6,FR_HDF_60,1647,397,985
2020-05-29,3,0,1,20,FR_HDF_60,1650,398,1005
2020-05-30,2,0,1,3,FR_HDF_60,1652,399,1008
2020-05-31,0,0,0,0,FR_HDF_60,1652,399,1008
2020-06-01,11,0,1,0,FR_HDF_60,1663,400,1008
2020-06-02,10,0,1,6,FR_HDF_60,1673,401,1014
2020-06-03,0,0,0,5,FR_HDF_60,1673,401,1019
2020-06-04,1,0,1,7,FR_HDF_60,1674,402,1026
2020-06-05,0,0,0,15,FR_HDF_60,1674,402,1041
2020-06-06,0,0,0,1,FR_HDF_60,1674,402,1042
2020-06-07,1,0,0,1,FR_HDF_60,1675,402,1043
2020-06-08,7,0,1,3,FR_HDF_60,1682,403,1046
2020-06-09,0,0,0,16,FR_HDF_60,1682,403,1062
2020-06-10,0,0,0,1,FR_HDF_60,1682,403,1063
2020-06-11,0,0,0,3,FR_HDF_60,1682,403,1066
2020-06-12,2,0,1,2,FR_HDF_60,1684,404,1068
2020-06-13,2,0,0,1,FR_HDF_60,1686,404,1069
2020-06-14,1,0,1,2,FR_HDF_60,1687,405,1071
2020-06-15,0,0,2,1,FR_HDF_60,1687,407,1072
2020-06-16,2,0,1,4,FR_HDF_60,1689,408,1076
2020-06-17,0,0,2,1,FR_HDF_60,1689,410,1077
2020-06-18,1,0,0,4,FR_HDF_60,1690,410,1081
2020-06-19,0,0,2,3,FR_HDF_60,1690,412,1084
2020-06-20,1,0,1,1,FR_HDF_60,1691,413,1085
2020-06-21,1,0,0,0,FR_HDF_60,1692,413,1085
2020-06-22,0,0,1,3,FR_HDF_60,1692,414,1088
2020-06-23,0,0,0,4,FR_HDF_60,1692,414,1092
2020-06-24,1,0,0,6,FR_HDF_60,1693,414,1098
2020-03-19,2,1,0,2,FR_NOR_61,2,0,2
2020-03-20,0,0,0,0,FR_NOR_61,2,0,2
2020-03-21,0,0,0,0,FR_NOR_61,2,0,2
2020-03-22,0,0,0,0,FR_NOR_61,2,0,2
2020-03-23,6,1,0,4,FR_NOR_61,8,0,6
2020-03-24,5,0,0,3,FR_NOR_61,13,0,9
2020-03-25,14,2,1,10,FR_NOR_61,27,1,19
2020-03-26,7,1,0,4,FR_NOR_61,34,1,23
2020-03-27,2,1,0,1,FR_NOR_61,36,1,24
2020-03-28,6,0,0,3,FR_NOR_61,42,1,27
2020-03-29,5,0,0,0,FR_NOR_61,47,1,27
2020-03-30,4,1,0,1,FR_NOR_61,51,1,28
2020-03-31,17,2,2,6,FR_NOR_61,68,3,34
2020-04-01,19,0,2,7,FR_NOR_61,87,5,41
2020-04-02,11,2,2,0,FR_NOR_61,98,7,41
2020-04-03,7,2,1,3,FR_NOR_61,105,8,44
2020-04-04,10,2,0,5,FR_NOR_61,115,8,49
2020-04-05,6,1,1,1,FR_NOR_61,121,9,50
2020-04-06,6,0,0,8,FR_NOR_61,127,9,58
2020-04-07,14,0,2,9,FR_NOR_61,141,11,67
2020-04-08,13,0,1,11,FR_NOR_61,154,12,78
2020-04-09,6,0,2,1,FR_NOR_61,160,14,79
2020-04-10,15,0,0,10,FR_NOR_61,175,14,89
2020-04-11,5,1,2,9,FR_NOR_61,180,16,98
2020-04-12,6,1,1,1,FR_NOR_61,186,17,99
2020-04-13,1,1,2,2,FR_NOR_61,187,19,101
2020-04-14,9,0,0,6,FR_NOR_61,196,19,107
2020-04-15,8,1,1,8,FR_NOR_61,204,20,115
2020-04-16,3,0,0,5,FR_NOR_61,207,20,120
2020-04-17,6,1,3,3,FR_NOR_61,213,23,123
2020-04-18,4,0,0,8,FR_NOR_61,217,23,131
2020-04-19,3,0,1,0,FR_NOR_61,220,24,131
2020-04-20,4,0,1,5,FR_NOR_61,224,25,136
2020-04-21,2,1,0,7,FR_NOR_61,226,25,143
2020-04-22,3,0,2,2,FR_NOR_61,229,27,145
2020-04-23,2,0,0,1,FR_NOR_61,231,27,146
2020-04-24,4,3,0,5,FR_NOR_61,235,27,151
2020-04-25,9,0,0,0,FR_NOR_61,244,27,151
2020-04-26,0,0,0,0,FR_NOR_61,244,27,151
2020-04-27,3,0,1,0,FR_NOR_61,247,28,151
2020-04-28,5,0,0,1,FR_NOR_61,252,28,152
2020-04-29,1,0,0,3,FR_NOR_61,253,28,155
2020-04-30,5,0,0,3,FR_NOR_61,258,28,158
2020-05-01,1,0,0,3,FR_NOR_61,259,28,161
2020-05-02,2,0,0,0,FR_NOR_61,261,28,161
2020-05-03,1,0,0,1,FR_NOR_61,262,28,162
2020-05-04,8,0,1,1,FR_NOR_61,270,29,163
2020-05-05,2,0,1,1,FR_NOR_61,272,30,164
2020-05-06,2,0,2,2,FR_NOR_61,274,32,166
2020-05-07,2,0,0,0,FR_NOR_61,276,32,166
2020-05-08,1,0,0,8,FR_NOR_61,277,32,174
2020-05-09,1,0,0,1,FR_NOR_61,278,32,175
2020-05-10,0,0,1,0,FR_NOR_61,278,33,175
2020-05-11,2,0,2,1,FR_NOR_61,280,35,176
2020-05-12,1,1,0,3,FR_NOR_61,281,35,179
2020-05-13,0,0,0,0,FR_NOR_61,281,35,179
2020-05-14,1,0,1,2,FR_NOR_61,282,36,181
2020-05-15,0,0,0,2,FR_NOR_61,282,36,183
2020-05-16,0,0,0,0,FR_NOR_61,282,36,183
2020-05-17,2,0,0,1,FR_NOR_61,284,36,184
2020-05-18,1,0,0,0,FR_NOR_61,285,36,184
2020-05-19,4,0,1,1,FR_NOR_61,289,37,185
2020-05-20,0,0,0,2,FR_NOR_61,289,37,187
2020-05-21,0,0,0,0,FR_NOR_61,289,37,187
2020-05-22,2,0,0,0,FR_NOR_61,291,37,187
2020-05-23,1,0,0,4,FR_NOR_61,292,37,191
2020-05-24,0,0,0,0,FR_NOR_61,292,37,191
2020-05-25,2,0,0,0,FR_NOR_61,294,37,191
2020-05-26,5,0,1,2,FR_NOR_61,299,38,193
2020-05-27,1,1,0,8,FR_NOR_61,300,38,201
2020-05-28,1,0,0,2,FR_NOR_61,301,38,203
2020-05-29,0,0,0,0,FR_NOR_61,301,38,203
2020-05-30,0,0,0,1,FR_NOR_61,301,38,204
2020-05-31,0,0,0,0,FR_NOR_61,301,38,204
2020-06-01,0,0,0,0,FR_NOR_61,301,38,204
2020-06-02,0,0,0,4,FR_NOR_61,301,38,208
2020-06-03,4,0,0,4,FR_NOR_61,305,38,212
2020-06-04,0,0,0,4,FR_NOR_61,305,38,216
2020-06-05,1,0,0,0,FR_NOR_61,306,38,216
2020-06-06,0,0,0,2,FR_NOR_61,306,38,218
2020-06-07,0,0,0,0,FR_NOR_61,306,38,218
2020-06-08,0,0,0,1,FR_NOR_61,306,38,219
2020-06-09,1,0,0,1,FR_NOR_61,307,38,220
2020-06-10,0,0,0,1,FR_NOR_61,307,38,221
2020-06-11,0,0,0,0,FR_NOR_61,307,38,221
2020-06-12,0,0,0,1,FR_NOR_61,307,38,222
2020-06-13,1,0,0,2,FR_NOR_61,308,38,224
2020-06-14,0,0,0,0,FR_NOR_61,308,38,224
2020-06-15,1,0,0,0,FR_NOR_61,309,38,224
2020-06-16,1,0,1,0,FR_NOR_61,310,39,224
2020-06-17,0,0,0,2,FR_NOR_61,310,39,226
2020-06-18,2,0,0,1,FR_NOR_61,312,39,227
2020-06-19,4,0,0,2,FR_NOR_61,316,39,229
2020-06-20,0,0,0,0,FR_NOR_61,316,39,229
2020-06-21,0,0,0,0,FR_NOR_61,316,39,229
2020-06-22,1,0,1,1,FR_NOR_61,317,40,230
2020-06-23,0,0,0,0,FR_NOR_61,317,40,230
2020-06-24,0,0,0,0,FR_NOR_61,317,40,230
2020-03-19,30,6,0,13,FR_HDF_62,30,0,13
2020-03-20,26,9,1,6,FR_HDF_62,56,1,19
2020-03-21,12,3,0,6,FR_HDF_62,68,1,25
2020-03-22,6,2,0,4,FR_HDF_62,74,1,29
2020-03-23,22,9,2,0,FR_HDF_62,96,3,29
2020-03-24,32,10,3,1,FR_HDF_62,128,6,30
2020-03-25,28,8,2,9,FR_HDF_62,156,8,39
2020-03-26,29,5,1,10,FR_HDF_62,185,9,49
2020-03-27,16,3,0,9,FR_HDF_62,201,9,58
2020-03-28,40,13,3,9,FR_HDF_62,241,12,67
2020-03-29,29,5,1,5,FR_HDF_62,270,13,72
2020-03-30,41,19,4,9,FR_HDF_62,311,17,81
2020-03-31,35,7,2,11,FR_HDF_62,346,19,92
2020-04-01,77,13,4,10,FR_HDF_62,423,23,102
2020-04-02,45,10,4,24,FR_HDF_62,468,27,126
2020-04-03,89,18,7,30,FR_HDF_62,557,34,156
2020-04-04,48,10,8,21,FR_HDF_62,605,42,177
2020-04-05,13,4,4,10,FR_HDF_62,618,46,187
2020-04-06,51,6,9,13,FR_HDF_62,669,55,200
2020-04-07,72,12,9,23,FR_HDF_62,741,64,223
2020-04-08,55,7,11,37,FR_HDF_62,796,75,260
2020-04-09,52,8,7,28,FR_HDF_62,848,82,288
2020-04-10,51,6,12,51,FR_HDF_62,899,94,339
2020-04-11,27,3,4,32,FR_HDF_62,926,98,371
2020-04-12,40,2,7,22,FR_HDF_62,966,105,393
2020-04-13,28,3,2,14,FR_HDF_62,994,107,407
2020-04-14,37,9,9,13,FR_HDF_62,1031,116,420
2020-04-15,59,17,14,45,FR_HDF_62,1090,130,465
2020-04-16,62,5,8,25,FR_HDF_62,1152,138,490
2020-04-17,42,5,17,38,FR_HDF_62,1194,155,528
2020-04-18,41,4,3,31,FR_HDF_62,1235,158,559
2020-04-19,16,2,3,12,FR_HDF_62,1251,161,571
2020-04-20,21,6,4,12,FR_HDF_62,1272,165,583
2020-04-21,95,2,9,86,FR_HDF_62,1367,174,669
2020-04-22,25,3,5,27,FR_HDF_62,1392,179,696
2020-04-23,51,6,22,48,FR_HDF_62,1443,201,744
2020-04-24,22,2,5,19,FR_HDF_62,1465,206,763
2020-04-25,24,1,13,11,FR_HDF_62,1489,219,774
2020-04-26,7,0,3,5,FR_HDF_62,1496,222,779
2020-04-27,47,7,6,31,FR_HDF_62,1543,228,810
2020-04-28,17,3,2,27,FR_HDF_62,1560,230,837
2020-04-29,21,0,5,24,FR_HDF_62,1581,235,861
2020-04-30,45,7,4,51,FR_HDF_62,1626,239,912
2020-05-01,22,0,3,18,FR_HDF_62,1648,242,930
2020-05-02,7,2,3,3,FR_HDF_62,1655,245,933
2020-05-03,2,0,2,2,FR_HDF_62,1657,247,935
2020-05-04,28,3,7,20,FR_HDF_62,1685,254,955
2020-05-05,21,7,3,29,FR_HDF_62,1706,257,984
2020-05-06,27,2,0,21,FR_HDF_62,1733,257,1005
2020-05-07,5,0,2,26,FR_HDF_62,1738,259,1031
2020-05-08,3,1,0,9,FR_HDF_62,1741,259,1040
2020-05-09,5,1,1,4,FR_HDF_62,1746,260,1044
2020-05-10,1,0,0,7,FR_HDF_62,1747,260,1051
2020-05-11,13,0,5,11,FR_HDF_62,1760,265,1062
2020-05-12,31,2,5,23,FR_HDF_62,1791,270,1085
2020-05-13,8,3,1,17,FR_HDF_62,1799,271,1102
2020-05-14,17,2,5,34,FR_HDF_62,1816,276,1136
2020-05-15,24,2,5,33,FR_HDF_62,1840,281,1169
2020-05-16,7,0,4,9,FR_HDF_62,1847,285,1178
2020-05-17,0,0,2,0,FR_HDF_62,1847,287,1178
2020-05-18,10,1,2,16,FR_HDF_62,1857,289,1194
2020-05-19,11,2,3,18,FR_HDF_62,1868,292,1212
2020-05-20,5,2,2,2,FR_HDF_62,1873,294,1214
2020-05-21,1,0,3,2,FR_HDF_62,1874,297,1216
2020-05-22,5,4,2,2,FR_HDF_62,1879,299,1218
2020-05-23,4,0,2,9,FR_HDF_62,1883,301,1227
2020-05-24,2,0,1,1,FR_HDF_62,1885,302,1228
2020-05-25,10,2,1,9,FR_HDF_62,1895,303,1237
2020-05-26,6,0,2,13,FR_HDF_62,1901,305,1250
2020-05-27,1,0,0,4,FR_HDF_62,1902,305,1254
2020-05-28,8,1,2,14,FR_HDF_62,1910,307,1268
2020-05-29,10,1,1,7,FR_HDF_62,1920,308,1275
2020-05-30,1,1,1,2,FR_HDF_62,1921,309,1277
2020-05-31,1,0,0,0,FR_HDF_62,1922,309,1277
2020-06-01,0,0,1,0,FR_HDF_62,1922,310,1277
2020-06-02,3,1,3,8,FR_HDF_62,1925,313,1285
2020-06-03,7,1,2,3,FR_HDF_62,1932,315,1288
2020-06-04,3,1,6,26,FR_HDF_62,1935,321,1314
2020-06-05,7,0,3,6,FR_HDF_62,1942,324,1320
2020-06-06,0,0,0,1,FR_HDF_62,1942,324,1321
2020-06-07,0,0,0,0,FR_HDF_62,1942,324,1321
2020-06-08,2,1,1,0,FR_HDF_62,1944,325,1321
2020-06-09,1,0,1,6,FR_HDF_62,1945,326,1327
2020-06-10,2,1,2,1,FR_HDF_62,1947,328,1328
2020-06-11,0,0,1,2,FR_HDF_62,1947,329,1330
2020-06-12,2,0,0,5,FR_HDF_62,1949,329,1335
2020-06-13,0,0,0,6,FR_HDF_62,1949,329,1341
2020-06-14,0,0,0,0,FR_HDF_62,1949,329,1341
2020-06-15,1,0,0,1,FR_HDF_62,1950,329,1342
2020-06-16,0,0,0,2,FR_HDF_62,1950,329,1344
2020-06-17,0,0,0,0,FR_HDF_62,1950,329,1344
2020-06-18,0,0,0,1,FR_HDF_62,1950,329,1345
2020-06-19,0,0,0,2,FR_HDF_62,1950,329,1347
2020-06-20,1,0,0,0,FR_HDF_62,1951,329,1347
2020-06-21,0,0,0,0,FR_HDF_62,1951,329,1347
2020-06-22,2,0,0,1,FR_HDF_62,1953,329,1348
2020-06-23,0,0,0,2,FR_HDF_62,1953,329,1350
2020-06-24,0,0,1,8,FR_HDF_62,1953,330,1358
2020-03-19,1,1,0,2,FR_ARA_63,1,0,2
2020-03-20,0,0,0,4,FR_ARA_63,1,0,6
2020-03-21,2,1,0,2,FR_ARA_63,3,0,8
2020-03-22,1,1,0,0,FR_ARA_63,4,0,8
2020-03-23,3,0,0,0,FR_ARA_63,7,0,8
2020-03-24,14,4,0,0,FR_ARA_63,21,0,8
2020-03-25,3,2,0,1,FR_ARA_63,24,0,9
2020-03-26,6,1,0,1,FR_ARA_63,30,0,10
2020-03-27,9,2,0,1,FR_ARA_63,39,0,11
2020-03-28,10,4,0,0,FR_ARA_63,49,0,11
2020-03-29,13,10,0,0,FR_ARA_63,62,0,11
2020-03-30,15,11,1,3,FR_ARA_63,77,1,14
2020-03-31,2,1,0,3,FR_ARA_63,79,1,17
2020-04-01,24,1,1,5,FR_ARA_63,103,2,22
2020-04-02,5,4,1,6,FR_ARA_63,108,3,28
2020-04-03,6,3,1,6,FR_ARA_63,114,4,34
2020-04-04,5,2,0,11,FR_ARA_63,119,4,45
2020-04-05,13,10,3,1,FR_ARA_63,132,7,46
2020-04-06,7,0,1,2,FR_ARA_63,139,8,48
2020-04-07,7,2,4,11,FR_ARA_63,146,12,59
2020-04-08,7,0,3,7,FR_ARA_63,153,15,66
2020-04-09,4,0,1,4,FR_ARA_63,157,16,70
2020-04-10,7,0,0,7,FR_ARA_63,164,16,77
2020-04-11,4,0,3,2,FR_ARA_63,168,19,79
2020-04-12,4,0,0,0,FR_ARA_63,172,19,79
2020-04-13,4,0,0,0,FR_ARA_63,176,19,79
2020-04-14,1,1,0,1,FR_ARA_63,177,19,80
2020-04-15,4,0,0,6,FR_ARA_63,181,19,86
2020-04-16,5,1,3,1,FR_ARA_63,186,22,87
2020-04-17,3,0,1,5,FR_ARA_63,189,23,92
2020-04-18,6,1,2,4,FR_ARA_63,195,25,96
2020-04-19,0,0,1,2,FR_ARA_63,195,26,98
2020-04-20,4,0,2,1,FR_ARA_63,199,28,99
2020-04-21,4,2,0,5,FR_ARA_63,203,28,104
2020-04-22,1,0,3,5,FR_ARA_63,204,31,109
2020-04-23,3,0,0,9,FR_ARA_63,207,31,118
2020-04-24,3,1,1,4,FR_ARA_63,210,32,122
2020-04-25,2,1,1,1,FR_ARA_63,212,33,123
2020-04-26,0,0,0,0,FR_ARA_63,212,33,123
2020-04-27,1,0,1,1,FR_ARA_63,213,34,124
2020-04-28,0,0,0,3,FR_ARA_63,213,34,127
2020-04-29,0,0,0,1,FR_ARA_63,213,34,128
2020-04-30,5,1,2,3,FR_ARA_63,218,36,131
2020-05-01,1,0,0,2,FR_ARA_63,219,36,133
2020-05-02,2,1,1,5,FR_ARA_63,221,37,138
2020-05-03,4,2,0,1,FR_ARA_63,225,37,139
2020-05-04,1,0,0,0,FR_ARA_63,226,37,139
2020-05-05,2,0,0,3,FR_ARA_63,228,37,142
2020-05-06,0,0,1,3,FR_ARA_63,228,38,145
2020-05-07,2,1,1,3,FR_ARA_63,230,39,148
2020-05-08,0,0,0,2,FR_ARA_63,230,39,150
2020-05-09,0,0,0,0,FR_ARA_63,230,39,150
2020-05-10,0,0,0,0,FR_ARA_63,230,39,150
2020-05-11,1,0,0,1,FR_ARA_63,231,39,151
2020-05-12,1,0,1,0,FR_ARA_63,232,40,151
2020-05-13,4,0,0,2,FR_ARA_63,236,40,153
2020-05-14,1,0,0,0,FR_ARA_63,237,40,153
2020-05-15,0,0,0,6,FR_ARA_63,237,40,159
2020-05-16,0,0,0,0,FR_ARA_63,237,40,159
2020-05-17,8,0,0,0,FR_ARA_63,245,40,159
2020-05-18,0,0,1,0,FR_ARA_63,245,41,159
2020-05-19,3,0,0,3,FR_ARA_63,248,41,162
2020-05-20,2,0,0,2,FR_ARA_63,250,41,164
2020-05-21,1,0,0,2,FR_ARA_63,251,41,166
2020-05-22,1,0,0,0,FR_ARA_63,252,41,166
2020-05-23,1,0,0,3,FR_ARA_63,253,41,169
2020-05-24,2,2,0,0,FR_ARA_63,255,41,169
2020-05-25,0,1,0,2,FR_ARA_63,255,41,171
2020-05-26,0,0,1,0,FR_ARA_63,255,42,171
2020-05-27,2,0,0,0,FR_ARA_63,257,42,171
2020-05-28,0,0,1,3,FR_ARA_63,257,43,174
2020-05-29,0,0,0,5,FR_ARA_63,257,43,179
2020-05-30,0,0,0,1,FR_ARA_63,257,43,180
2020-05-31,0,0,0,0,FR_ARA_63,257,43,180
2020-06-01,0,0,0,0,FR_ARA_63,257,43,180
2020-06-02,0,0,0,0,FR_ARA_63,257,43,180
2020-06-03,1,1,0,1,FR_ARA_63,258,43,181
2020-06-04,0,0,0,0,FR_ARA_63,258,43,181
2020-06-05,0,0,0,1,FR_ARA_63,258,43,182
2020-06-06,0,0,0,1,FR_ARA_63,258,43,183
2020-06-07,0,0,0,0,FR_ARA_63,258,43,183
2020-06-08,0,0,0,0,FR_ARA_63,258,43,183
2020-06-09,0,0,0,0,FR_ARA_63,258,43,183
2020-06-10,1,0,0,0,FR_ARA_63,259,43,183
2020-06-11,0,0,0,0,FR_ARA_63,259,43,183
2020-06-12,0,0,0,0,FR_ARA_63,259,43,183
2020-06-13,0,0,0,0,FR_ARA_63,259,43,183
2020-06-14,0,0,0,0,FR_ARA_63,259,43,183
2020-06-15,0,0,0,0,FR_ARA_63,259,43,183
2020-06-16,0,0,0,0,FR_ARA_63,259,43,183
2020-06-17,0,0,0,1,FR_ARA_63,259,43,184
2020-06-18,0,0,0,0,FR_ARA_63,259,43,184
2020-06-19,0,0,0,0,FR_ARA_63,259,43,184
2020-06-20,0,0,0,0,FR_ARA_63,259,43,184
2020-06-21,0,0,0,0,FR_ARA_63,259,43,184
2020-06-22,0,0,0,0,FR_ARA_63,259,43,184
2020-06-23,0,0,0,0,FR_ARA_63,259,43,184
2020-06-24,0,0,0,0,FR_ARA_63,259,43,184
2020-03-19,6,0,0,1,FR_NAQ_64,6,0,1
2020-03-20,1,0,1,1,FR_NAQ_64,7,1,2
2020-03-21,5,2,0,0,FR_NAQ_64,12,1,2
2020-03-22,3,0,0,0,FR_NAQ_64,15,1,2
2020-03-23,7,0,0,3,FR_NAQ_64,22,1,5
2020-03-24,7,5,0,2,FR_NAQ_64,29,1,7
2020-03-25,13,3,2,1,FR_NAQ_64,42,3,8
2020-03-26,19,2,1,10,FR_NAQ_64,61,4,18
2020-03-27,16,3,1,3,FR_NAQ_64,77,5,21
2020-03-28,10,1,1,7,FR_NAQ_64,87,6,28
2020-03-29,9,4,0,4,FR_NAQ_64,96,6,32
2020-03-30,8,2,3,2,FR_NAQ_64,104,9,34
2020-03-31,17,8,1,3,FR_NAQ_64,121,10,37
2020-04-01,8,1,0,9,FR_NAQ_64,129,10,46
2020-04-02,19,4,2,16,FR_NAQ_64,148,12,62
2020-04-03,5,1,1,1,FR_NAQ_64,153,13,63
2020-04-04,14,1,0,11,FR_NAQ_64,167,13,74
2020-04-05,1,0,1,3,FR_NAQ_64,168,14,77
2020-04-06,10,0,1,1,FR_NAQ_64,178,15,78
2020-04-07,0,0,0,5,FR_NAQ_64,178,15,83
2020-04-08,13,2,1,5,FR_NAQ_64,191,16,88
2020-04-09,10,1,0,1,FR_NAQ_64,201,16,89
2020-04-10,10,1,2,9,FR_NAQ_64,211,18,98
2020-04-11,4,0,0,9,FR_NAQ_64,215,18,107
2020-04-12,4,0,2,1,FR_NAQ_64,219,20,108
2020-04-13,2,0,1,2,FR_NAQ_64,221,21,110
2020-04-14,1,0,1,1,FR_NAQ_64,222,22,111
2020-04-15,3,1,0,6,FR_NAQ_64,225,22,117
2020-04-16,4,0,0,8,FR_NAQ_64,229,22,125
2020-04-17,2,0,2,0,FR_NAQ_64,231,24,125
2020-04-18,5,0,0,12,FR_NAQ_64,236,24,137
2020-04-19,0,0,0,1,FR_NAQ_64,236,24,138
2020-04-20,2,0,0,1,FR_NAQ_64,238,24,139
2020-04-21,0,0,0,0,FR_NAQ_64,238,24,139
2020-04-22,2,0,0,4,FR_NAQ_64,240,24,143
2020-04-23,3,0,0,8,FR_NAQ_64,243,24,151
2020-04-24,1,1,0,1,FR_NAQ_64,244,24,152
2020-04-25,2,0,1,6,FR_NAQ_64,246,25,158
2020-04-26,1,0,1,2,FR_NAQ_64,247,26,160
2020-04-27,2,0,1,1,FR_NAQ_64,249,27,161
2020-04-28,3,0,2,7,FR_NAQ_64,252,29,168
2020-04-29,2,0,0,10,FR_NAQ_64,254,29,178
2020-04-30,0,0,0,1,FR_NAQ_64,254,29,179
2020-05-01,0,0,0,5,FR_NAQ_64,254,29,184
2020-05-02,0,0,0,0,FR_NAQ_64,254,29,184
2020-05-03,1,1,0,0,FR_NAQ_64,255,29,184
2020-05-04,1,0,0,0,FR_NAQ_64,256,29,184
2020-05-05,1,0,0,3,FR_NAQ_64,257,29,187
2020-05-06,0,0,0,5,FR_NAQ_64,257,29,192
2020-05-07,0,0,0,2,FR_NAQ_64,257,29,194
2020-05-08,1,0,0,1,FR_NAQ_64,258,29,195
2020-05-09,0,0,0,0,FR_NAQ_64,258,29,195
2020-05-10,0,0,0,1,FR_NAQ_64,258,29,196
2020-05-11,0,0,0,0,FR_NAQ_64,258,29,196
2020-05-12,0,0,0,1,FR_NAQ_64,258,29,197
2020-05-13,0,0,0,2,FR_NAQ_64,258,29,199
2020-05-14,0,0,1,0,FR_NAQ_64,258,30,199
2020-05-15,2,0,0,2,FR_NAQ_64,260,30,201
2020-05-16,0,0,0,0,FR_NAQ_64,260,30,201
2020-05-17,0,0,0,2,FR_NAQ_64,260,30,203
2020-05-18,0,0,0,0,FR_NAQ_64,260,30,203
2020-05-19,1,1,0,2,FR_NAQ_64,261,30,205
2020-05-20,0,0,0,1,FR_NAQ_64,261,30,206
2020-05-21,0,0,0,0,FR_NAQ_64,261,30,206
2020-05-22,0,0,0,1,FR_NAQ_64,261,30,207
2020-05-23,0,0,0,1,FR_NAQ_64,261,30,208
2020-05-24,0,0,0,1,FR_NAQ_64,261,30,209
2020-05-25,0,0,0,13,FR_NAQ_64,261,30,222
2020-05-26,0,0,1,0,FR_NAQ_64,261,31,222
2020-05-27,0,0,0,1,FR_NAQ_64,261,31,223
2020-05-28,0,0,0,1,FR_NAQ_64,261,31,224
2020-05-29,1,0,0,1,FR_NAQ_64,262,31,225
2020-05-30,1,0,0,0,FR_NAQ_64,263,31,225
2020-05-31,1,0,0,0,FR_NAQ_64,264,31,225
2020-06-01,0,0,0,1,FR_NAQ_64,264,31,226
2020-06-02,0,0,0,0,FR_NAQ_64,264,31,226
2020-06-03,0,0,0,2,FR_NAQ_64,264,31,228
2020-06-04,0,0,0,0,FR_NAQ_64,264,31,228
2020-06-05,3,0,0,1,FR_NAQ_64,267,31,229
2020-06-06,0,0,0,0,FR_NAQ_64,267,31,229
2020-06-07,0,0,0,0,FR_NAQ_64,267,31,229
2020-06-08,0,0,0,0,FR_NAQ_64,267,31,229
2020-06-09,1,0,0,1,FR_NAQ_64,268,31,230
2020-06-10,0,0,0,1,FR_NAQ_64,268,31,231
2020-06-11,0,0,0,1,FR_NAQ_64,268,31,232
2020-06-12,0,0,0,0,FR_NAQ_64,268,31,232
2020-06-13,0,0,0,1,FR_NAQ_64,268,31,233
2020-06-14,0,0,0,0,FR_NAQ_64,268,31,233
2020-06-15,0,0,0,0,FR_NAQ_64,268,31,233
2020-06-16,0,0,0,2,FR_NAQ_64,268,31,235
2020-06-17,0,0,0,1,FR_NAQ_64,268,31,236
2020-06-18,0,0,0,0,FR_NAQ_64,268,31,236
2020-06-19,0,0,0,0,FR_NAQ_64,268,31,236
2020-06-20,0,0,0,0,FR_NAQ_64,268,31,236
2020-06-21,0,0,0,0,FR_NAQ_64,268,31,236
2020-06-22,0,0,0,0,FR_NAQ_64,268,31,236
2020-06-23,0,0,0,0,FR_NAQ_64,268,31,236
2020-06-24,0,0,0,0,FR_NAQ_64,268,31,236
2020-03-19,2,1,0,0,FR_OCC_65,2,0,0
2020-03-20,0,0,0,0,FR_OCC_65,2,0,0
2020-03-21,3,0,0,0,FR_OCC_65,5,0,0
2020-03-22,2,0,0,1,FR_OCC_65,7,0,1
2020-03-23,2,0,0,1,FR_OCC_65,9,0,2
2020-03-24,0,0,0,2,FR_OCC_65,9,0,4
2020-03-25,1,1,0,0,FR_OCC_65,10,0,4
2020-03-26,11,0,1,2,FR_OCC_65,21,1,6
2020-03-27,2,1,0,0,FR_OCC_65,23,1,6
2020-03-28,6,2,0,1,FR_OCC_65,29,1,7
2020-03-29,5,0,0,1,FR_OCC_65,34,1,8
2020-03-30,6,2,0,2,FR_OCC_65,40,1,10
2020-03-31,2,0,0,3,FR_OCC_65,42,1,13
2020-04-01,13,0,0,2,FR_OCC_65,55,1,15
2020-04-02,6,0,2,2,FR_OCC_65,61,3,17
2020-04-03,4,0,0,3,FR_OCC_65,65,3,20
2020-04-04,8,0,2,3,FR_OCC_65,73,5,23
2020-04-05,14,3,2,2,FR_OCC_65,87,7,25
2020-04-06,4,0,0,1,FR_OCC_65,91,7,26
2020-04-07,7,0,0,4,FR_OCC_65,98,7,30
2020-04-08,9,1,0,4,FR_OCC_65,107,7,34
2020-04-09,6,0,0,4,FR_OCC_65,113,7,38
2020-04-10,11,0,0,7,FR_OCC_65,124,7,45
2020-04-11,10,0,1,3,FR_OCC_65,134,8,48
2020-04-12,10,1,0,0,FR_OCC_65,144,8,48
2020-04-13,4,0,2,2,FR_OCC_65,148,10,50
2020-04-14,5,0,2,2,FR_OCC_65,153,12,52
2020-04-15,8,0,2,6,FR_OCC_65,161,14,58
2020-04-16,1,0,0,4,FR_OCC_65,162,14,62
2020-04-17,2,0,0,4,FR_OCC_65,164,14,66
2020-04-18,3,0,0,5,FR_OCC_65,167,14,71
2020-04-19,2,0,0,1,FR_OCC_65,169,14,72
2020-04-20,9,0,2,1,FR_OCC_65,178,16,73
2020-04-21,0,0,1,5,FR_OCC_65,178,17,78
2020-04-22,2,0,1,2,FR_OCC_65,180,18,80
2020-04-23,2,0,0,4,FR_OCC_65,182,18,84
2020-04-24,4,0,1,1,FR_OCC_65,186,19,85
2020-04-25,0,0,0,0,FR_OCC_65,186,19,85
2020-04-26,0,0,0,1,FR_OCC_65,186,19,86
2020-04-27,0,0,0,2,FR_OCC_65,186,19,88
2020-04-28,3,0,1,4,FR_OCC_65,189,20,92
2020-04-29,1,0,0,1,FR_OCC_65,190,20,93
2020-04-30,1,1,0,3,FR_OCC_65,191,20,96
2020-05-01,0,0,0,4,FR_OCC_65,191,20,100
2020-05-02,1,0,0,0,FR_OCC_65,192,20,100
2020-05-03,0,0,1,0,FR_OCC_65,192,21,100
2020-05-04,2,0,1,0,FR_OCC_65,194,22,100
2020-05-05,0,0,0,8,FR_OCC_65,194,22,108
2020-05-06,1,0,2,3,FR_OCC_65,195,24,111
2020-05-07,1,1,0,5,FR_OCC_65,196,24,116
2020-05-08,0,0,0,4,FR_OCC_65,196,24,120
2020-05-09,0,0,0,0,FR_OCC_65,196,24,120
2020-05-10,0,0,1,0,FR_OCC_65,196,25,120
2020-05-11,0,0,0,0,FR_OCC_65,196,25,120
2020-05-12,0,0,0,3,FR_OCC_65,196,25,123
2020-05-13,0,0,0,1,FR_OCC_65,196,25,124
2020-05-14,0,0,0,0,FR_OCC_65,196,25,124
2020-05-15,0,0,0,0,FR_OCC_65,196,25,124
2020-05-16,1,0,0,2,FR_OCC_65,197,25,126
2020-05-17,0,0,0,0,FR_OCC_65,197,25,126
2020-05-18,0,0,0,5,FR_OCC_65,197,25,131
2020-05-19,0,0,0,2,FR_OCC_65,197,25,133
2020-05-20,0,0,0,9,FR_OCC_65,197,25,142
2020-05-21,0,0,0,2,FR_OCC_65,197,25,144
2020-05-22,0,0,0,0,FR_OCC_65,197,25,144
2020-05-23,0,0,0,0,FR_OCC_65,197,25,144
2020-05-24,0,0,0,0,FR_OCC_65,197,25,144
2020-05-25,0,0,0,0,FR_OCC_65,197,25,144
2020-05-26,0,0,0,3,FR_OCC_65,197,25,147
2020-05-27,0,0,0,0,FR_OCC_65,197,25,147
2020-05-28,0,0,0,0,FR_OCC_65,197,25,147
2020-05-29,0,0,1,0,FR_OCC_65,197,26,147
2020-05-30,0,0,0,0,FR_OCC_65,197,26,147
2020-05-31,0,0,0,0,FR_OCC_65,197,26,147
2020-06-01,0,0,0,0,FR_OCC_65,197,26,147
2020-06-02,0,0,0,0,FR_OCC_65,197,26,147
2020-06-03,0,0,0,1,FR_OCC_65,197,26,148
2020-06-04,0,0,0,1,FR_OCC_65,197,26,149
2020-06-05,0,0,0,0,FR_OCC_65,197,26,149
2020-06-06,0,0,0,4,FR_OCC_65,197,26,153
2020-06-07,0,0,0,0,FR_OCC_65,197,26,153
2020-06-08,0,0,0,0,FR_OCC_65,197,26,153
2020-06-09,0,0,0,0,FR_OCC_65,197,26,153
2020-06-10,0,0,0,0,FR_OCC_65,197,26,153
2020-06-11,0,0,0,0,FR_OCC_65,197,26,153
2020-06-12,0,0,0,1,FR_OCC_65,197,26,154
2020-06-13,0,0,0,0,FR_OCC_65,197,26,154
2020-06-14,0,0,0,0,FR_OCC_65,197,26,154
2020-06-15,0,0,1,0,FR_OCC_65,197,27,154
2020-06-16,0,0,0,1,FR_OCC_65,197,27,155
2020-06-17,0,0,0,1,FR_OCC_65,197,27,156
2020-06-18,0,0,0,1,FR_OCC_65,197,27,157
2020-06-19,0,0,0,0,FR_OCC_65,197,27,157
2020-06-20,0,0,0,0,FR_OCC_65,197,27,157
2020-06-21,0,0,0,0,FR_OCC_65,197,27,157
2020-06-22,0,0,0,0,FR_OCC_65,197,27,157
2020-06-23,0,0,0,0,FR_OCC_65,197,27,157
2020-06-24,0,0,0,0,FR_OCC_65,197,27,157
2020-03-19,19,9,3,2,FR_OCC_66,19,3,2
2020-03-20,7,6,1,0,FR_OCC_66,26,4,2
2020-03-21,1,1,1,0,FR_OCC_66,27,5,2
2020-03-22,41,7,0,1,FR_OCC_66,68,5,3
2020-03-23,23,4,1,2,FR_OCC_66,91,6,5
2020-03-24,16,6,1,6,FR_OCC_66,107,7,11
2020-03-25,20,4,0,11,FR_OCC_66,127,7,22
2020-03-26,23,7,1,7,FR_OCC_66,150,8,29
2020-03-27,13,2,1,9,FR_OCC_66,163,9,38
2020-03-28,25,5,0,10,FR_OCC_66,188,9,48
2020-03-29,17,3,2,7,FR_OCC_66,205,11,55
2020-03-30,11,7,2,8,FR_OCC_66,216,13,63
2020-03-31,19,4,1,18,FR_OCC_66,235,14,81
2020-04-01,13,4,1,19,FR_OCC_66,248,15,100
2020-04-02,11,0,1,10,FR_OCC_66,259,16,110
2020-04-03,10,2,0,18,FR_OCC_66,269,16,128
2020-04-04,11,3,1,5,FR_OCC_66,280,17,133
2020-04-05,7,0,0,9,FR_OCC_66,287,17,142
2020-04-06,9,1,1,6,FR_OCC_66,296,18,148
2020-04-07,9,5,2,13,FR_OCC_66,305,20,161
2020-04-08,5,1,0,10,FR_OCC_66,310,20,171
2020-04-09,3,1,0,7,FR_OCC_66,313,20,178
2020-04-10,9,4,1,14,FR_OCC_66,322,21,192
2020-04-11,5,0,1,5,FR_OCC_66,327,22,197
2020-04-12,2,0,1,1,FR_OCC_66,329,23,198
2020-04-13,6,0,0,12,FR_OCC_66,335,23,210
2020-04-14,2,0,0,10,FR_OCC_66,337,23,220
2020-04-15,3,1,1,11,FR_OCC_66,340,24,231
2020-04-16,2,0,0,9,FR_OCC_66,342,24,240
2020-04-17,1,0,1,7,FR_OCC_66,343,25,247
2020-04-18,1,0,0,6,FR_OCC_66,344,25,253
2020-04-19,1,1,0,0,FR_OCC_66,345,25,253
2020-04-20,1,0,1,1,FR_OCC_66,346,26,254
2020-04-21,3,1,0,5,FR_OCC_66,349,26,259
2020-04-22,2,0,0,4,FR_OCC_66,351,26,263
2020-04-23,4,0,2,1,FR_OCC_66,355,28,264
2020-04-24,0,0,1,0,FR_OCC_66,355,29,264
2020-04-25,2,0,0,4,FR_OCC_66,357,29,268
2020-04-26,0,0,0,1,FR_OCC_66,357,29,269
2020-04-27,1,0,1,1,FR_OCC_66,358,30,270
2020-04-28,3,0,1,4,FR_OCC_66,361,31,274
2020-04-29,3,0,1,2,FR_OCC_66,364,32,276
2020-04-30,0,0,2,2,FR_OCC_66,364,34,278
2020-05-01,1,0,0,2,FR_OCC_66,365,34,280
2020-05-02,0,0,0,0,FR_OCC_66,365,34,280
2020-05-03,1,0,0,2,FR_OCC_66,366,34,282
2020-05-04,1,0,0,0,FR_OCC_66,367,34,282
2020-05-05,1,0,1,4,FR_OCC_66,368,35,286
2020-05-06,0,0,0,1,FR_OCC_66,368,35,287
2020-05-07,0,0,0,0,FR_OCC_66,368,35,287
2020-05-08,0,0,0,0,FR_OCC_66,368,35,287
2020-05-09,0,0,0,0,FR_OCC_66,368,35,287
2020-05-10,0,0,0,0,FR_OCC_66,368,35,287
2020-05-11,0,0,0,0,FR_OCC_66,368,35,287
2020-05-12,0,0,0,4,FR_OCC_66,368,35,291
2020-05-13,1,1,0,0,FR_OCC_66,369,35,291
2020-05-14,0,0,0,0,FR_OCC_66,369,35,291
2020-05-15,0,0,0,1,FR_OCC_66,369,35,292
2020-05-16,0,0,0,0,FR_OCC_66,369,35,292
2020-05-17,0,0,0,0,FR_OCC_66,369,35,292
2020-05-18,0,0,0,1,FR_OCC_66,369,35,293
2020-05-19,0,0,0,0,FR_OCC_66,369,35,293
2020-05-20,0,0,0,1,FR_OCC_66,369,35,294
2020-05-21,0,0,0,2,FR_OCC_66,369,35,296
2020-05-22,0,0,0,0,FR_OCC_66,369,35,296
2020-05-23,1,0,0,0,FR_OCC_66,370,35,296
2020-05-24,0,0,0,0,FR_OCC_66,370,35,296
2020-05-25,0,0,0,0,FR_OCC_66,370,35,296
2020-05-26,0,0,0,0,FR_OCC_66,370,35,296
2020-05-27,0,0,0,0,FR_OCC_66,370,35,296
2020-05-28,0,0,0,0,FR_OCC_66,370,35,296
2020-05-29,0,0,0,0,FR_OCC_66,370,35,296
2020-05-30,0,0,0,0,FR_OCC_66,370,35,296
2020-05-31,0,0,0,0,FR_OCC_66,370,35,296
2020-06-01,0,0,0,0,FR_OCC_66,370,35,296
2020-06-02,0,1,0,0,FR_OCC_66,370,35,296
2020-06-03,0,0,0,0,FR_OCC_66,370,35,296
2020-06-04,0,0,0,0,FR_OCC_66,370,35,296
2020-06-05,0,0,0,0,FR_OCC_66,370,35,296
2020-06-06,0,0,0,0,FR_OCC_66,370,35,296
2020-06-07,0,0,0,0,FR_OCC_66,370,35,296
2020-06-08,0,0,0,0,FR_OCC_66,370,35,296
2020-06-09,0,0,0,0,FR_OCC_66,370,35,296
2020-06-10,0,0,0,0,FR_OCC_66,370,35,296
2020-06-11,0,0,0,1,FR_OCC_66,370,35,297
2020-06-12,0,0,0,0,FR_OCC_66,370,35,297
2020-06-13,0,0,0,0,FR_OCC_66,370,35,297
2020-06-14,0,0,0,0,FR_OCC_66,370,35,297
2020-06-15,0,0,0,0,FR_OCC_66,370,35,297
2020-06-16,0,0,0,0,FR_OCC_66,370,35,297
2020-06-17,0,0,0,0,FR_OCC_66,370,35,297
2020-06-18,0,0,0,0,FR_OCC_66,370,35,297
2020-06-19,0,0,0,0,FR_OCC_66,370,35,297
2020-06-20,0,0,0,0,FR_OCC_66,370,35,297
2020-06-21,0,0,0,0,FR_OCC_66,370,35,297
2020-06-22,0,0,0,0,FR_OCC_66,370,35,297
2020-06-23,0,0,0,0,FR_OCC_66,370,35,297
2020-06-24,0,0,0,0,FR_OCC_66,370,35,297
2020-03-19,161,30,8,28,FR_GES_67,161,8,28
2020-03-20,44,6,6,10,FR_GES_67,205,14,38
2020-03-21,67,21,3,10,FR_GES_67,272,17,48
2020-03-22,79,16,11,0,FR_GES_67,351,28,48
2020-03-23,86,28,8,24,FR_GES_67,437,36,72
2020-03-24,130,28,19,44,FR_GES_67,567,55,116
2020-03-25,116,25,14,32,FR_GES_67,683,69,148
2020-03-26,126,24,13,75,FR_GES_67,809,82,223
2020-03-27,102,36,16,24,FR_GES_67,911,98,247
2020-03-28,87,17,11,28,FR_GES_67,998,109,275
2020-03-29,90,19,18,16,FR_GES_67,1088,127,291
2020-03-30,69,22,18,13,FR_GES_67,1157,145,304
2020-03-31,142,35,27,41,FR_GES_67,1299,172,345
2020-04-01,162,36,27,83,FR_GES_67,1461,199,428
2020-04-02,89,20,18,37,FR_GES_67,1550,217,465
2020-04-03,165,31,30,91,FR_GES_67,1715,247,556
2020-04-04,91,21,11,58,FR_GES_67,1806,258,614
2020-04-05,79,12,15,33,FR_GES_67,1885,273,647
2020-04-06,53,10,11,35,FR_GES_67,1938,284,682
2020-04-07,88,10,18,61,FR_GES_67,2026,302,743
2020-04-08,90,20,15,75,FR_GES_67,2116,317,818
2020-04-09,107,7,14,74,FR_GES_67,2223,331,892
2020-04-10,115,11,11,88,FR_GES_67,2338,342,980
2020-04-11,20,2,3,13,FR_GES_67,2358,345,993
2020-04-12,40,4,7,38,FR_GES_67,2398,352,1031
2020-04-13,19,0,5,10,FR_GES_67,2417,357,1041
2020-04-14,59,6,18,23,FR_GES_67,2476,375,1064
2020-04-15,74,3,13,100,FR_GES_67,2550,388,1164
2020-04-16,53,12,9,64,FR_GES_67,2603,397,1228
2020-04-17,64,11,18,68,FR_GES_67,2667,415,1296
2020-04-18,61,4,10,57,FR_GES_67,2728,425,1353
2020-04-19,18,3,5,16,FR_GES_67,2746,430,1369
2020-04-20,34,4,6,13,FR_GES_67,2780,436,1382
2020-04-21,73,4,15,52,FR_GES_67,2853,451,1434
2020-04-22,38,2,13,56,FR_GES_67,2891,464,1490
2020-04-23,30,6,10,83,FR_GES_67,2921,474,1573
2020-04-24,13,1,7,29,FR_GES_67,2934,481,1602
2020-04-25,33,4,4,21,FR_GES_67,2967,485,1623
2020-04-26,5,0,6,7,FR_GES_67,2972,491,1630
2020-04-27,39,8,7,19,FR_GES_67,3011,498,1649
2020-04-28,31,1,10,37,FR_GES_67,3042,508,1686
2020-04-29,35,4,6,48,FR_GES_67,3077,514,1734
2020-04-30,23,2,6,33,FR_GES_67,3100,520,1767
2020-05-01,21,4,15,37,FR_GES_67,3121,535,1804
2020-05-02,11,0,10,11,FR_GES_67,3132,545,1815
2020-05-03,3,0,2,10,FR_GES_67,3135,547,1825
2020-05-04,13,3,5,14,FR_GES_67,3148,552,1839
2020-05-05,22,2,3,24,FR_GES_67,3170,555,1863
2020-05-06,37,2,6,45,FR_GES_67,3207,561,1908
2020-05-07,20,5,5,35,FR_GES_67,3227,566,1943
2020-05-08,16,1,8,27,FR_GES_67,3243,574,1970
2020-05-09,4,0,0,6,FR_GES_67,3247,574,1976
2020-05-10,6,1,2,4,FR_GES_67,3253,576,1980
2020-05-11,13,4,3,17,FR_GES_67,3266,579,1997
2020-05-12,19,2,3,23,FR_GES_67,3285,582,2020
2020-05-13,31,3,6,31,FR_GES_67,3316,588,2051
2020-05-14,8,0,6,18,FR_GES_67,3324,594,2069
2020-05-15,14,1,7,45,FR_GES_67,3338,601,2114
2020-05-16,3,4,3,23,FR_GES_67,3341,604,2137
2020-05-17,6,3,2,19,FR_GES_67,3347,606,2156
2020-05-18,18,0,3,20,FR_GES_67,3365,609,2176
2020-05-19,13,1,7,28,FR_GES_67,3378,616,2204
2020-05-20,8,1,2,13,FR_GES_67,3386,618,2217
2020-05-21,3,0,0,9,FR_GES_67,3389,618,2226
2020-05-22,20,1,4,20,FR_GES_67,3409,622,2246
2020-05-23,5,1,0,13,FR_GES_67,3414,622,2259
2020-05-24,1,0,6,10,FR_GES_67,3415,628,2269
2020-05-25,3,0,1,12,FR_GES_67,3418,629,2281
2020-05-26,5,0,1,12,FR_GES_67,3423,630,2293
2020-05-27,11,2,2,32,FR_GES_67,3434,632,2325
2020-05-28,12,0,3,18,FR_GES_67,3446,635,2343
2020-05-29,9,1,5,38,FR_GES_67,3455,640,2381
2020-05-30,20,0,2,21,FR_GES_67,3475,642,2402
2020-05-31,2,1,1,7,FR_GES_67,3477,643,2409
2020-06-01,0,0,1,0,FR_GES_67,3477,644,2409
2020-06-02,5,1,1,5,FR_GES_67,3482,645,2414
2020-06-03,9,0,2,19,FR_GES_67,3491,647,2433
2020-06-04,2,1,0,16,FR_GES_67,3493,647,2449
2020-06-05,6,2,3,25,FR_GES_67,3499,650,2474
2020-06-06,2,0,0,5,FR_GES_67,3501,650,2479
2020-06-07,0,0,1,1,FR_GES_67,3501,651,2480
2020-06-08,4,3,3,10,FR_GES_67,3505,654,2490
2020-06-09,2,0,0,17,FR_GES_67,3507,654,2507
2020-06-10,7,0,3,15,FR_GES_67,3514,657,2522
2020-06-11,2,1,0,8,FR_GES_67,3516,657,2530
2020-06-12,2,1,3,25,FR_GES_67,3518,660,2555
2020-06-13,1,2,0,8,FR_GES_67,3519,660,2563
2020-06-14,0,0,1,0,FR_GES_67,3519,661,2563
2020-06-15,7,0,0,7,FR_GES_67,3526,661,2570
2020-06-16,7,1,2,8,FR_GES_67,3533,663,2578
2020-06-17,4,0,0,5,FR_GES_67,3537,663,2583
2020-06-18,6,0,2,6,FR_GES_67,3543,665,2589
2020-06-19,1,0,1,9,FR_GES_67,3544,666,2598
2020-06-20,1,0,0,0,FR_GES_67,3545,666,2598
2020-06-21,1,0,1,1,FR_GES_67,3546,667,2599
2020-06-22,0,0,1,0,FR_GES_67,3546,668,2599
2020-06-23,2,0,2,18,FR_GES_67,3548,670,2617
2020-06-24,2,0,1,12,FR_GES_67,3550,671,2629
2020-03-19,140,13,18,24,FR_GES_68,140,18,24
2020-03-20,92,19,13,30,FR_GES_68,232,31,54
2020-03-21,83,8,20,39,FR_GES_68,315,51,93
2020-03-22,50,8,16,13,FR_GES_68,365,67,106
2020-03-23,141,21,22,14,FR_GES_68,506,89,120
2020-03-24,179,17,33,42,FR_GES_68,685,122,162
2020-03-25,201,23,52,54,FR_GES_68,886,174,216
2020-03-26,177,35,33,49,FR_GES_68,1063,207,265
2020-03-27,160,19,22,37,FR_GES_68,1223,229,302
2020-03-28,143,19,36,76,FR_GES_68,1366,265,378
2020-03-29,113,18,24,33,FR_GES_68,1479,289,411
2020-03-30,176,27,36,57,FR_GES_68,1655,325,468
2020-03-31,169,37,36,95,FR_GES_68,1824,361,563
2020-04-01,125,18,26,44,FR_GES_68,1949,387,607
2020-04-02,161,21,26,96,FR_GES_68,2110,413,703
2020-04-03,106,23,24,61,FR_GES_68,2216,437,764
2020-04-04,31,9,17,72,FR_GES_68,2247,454,836
2020-04-05,56,10,13,43,FR_GES_68,2303,467,879
2020-04-06,98,17,41,29,FR_GES_68,2401,508,908
2020-04-07,123,16,18,81,FR_GES_68,2524,526,989
2020-04-08,81,18,23,73,FR_GES_68,2605,549,1062
2020-04-09,68,9,19,71,FR_GES_68,2673,568,1133
2020-04-10,85,5,18,38,FR_GES_68,2758,586,1171
2020-04-11,32,11,6,28,FR_GES_68,2790,592,1199
2020-04-12,29,8,12,14,FR_GES_68,2819,604,1213
2020-04-13,21,4,7,20,FR_GES_68,2840,611,1233
2020-04-14,72,10,13,37,FR_GES_68,2912,624,1270
2020-04-15,77,6,14,95,FR_GES_68,2989,638,1365
2020-04-16,56,8,24,91,FR_GES_68,3045,662,1456
2020-04-17,51,4,2,42,FR_GES_68,3096,664,1498
2020-04-18,26,4,5,42,FR_GES_68,3122,669,1540
2020-04-19,18,1,2,33,FR_GES_68,3140,671,1573
2020-04-20,38,8,5,20,FR_GES_68,3178,676,1593
2020-04-21,51,3,6,56,FR_GES_68,3229,682,1649
2020-04-22,20,10,4,52,FR_GES_68,3249,686,1701
2020-04-23,31,5,3,30,FR_GES_68,3280,689,1731
2020-04-24,38,5,5,33,FR_GES_68,3318,694,1764
2020-04-25,11,4,3,44,FR_GES_68,3329,697,1808
2020-04-26,19,5,7,10,FR_GES_68,3348,704,1818
2020-04-27,38,6,8,25,FR_GES_68,3386,712,1843
2020-04-28,33,3,6,61,FR_GES_68,3419,718,1904
2020-04-29,27,3,4,49,FR_GES_68,3446,722,1953
2020-04-30,43,1,9,40,FR_GES_68,3489,731,1993
2020-05-01,20,2,2,36,FR_GES_68,3509,733,2029
2020-05-02,12,4,4,21,FR_GES_68,3521,737,2050
2020-05-03,9,2,4,8,FR_GES_68,3530,741,2058
2020-05-04,44,3,5,9,FR_GES_68,3574,746,2067
2020-05-05,36,11,11,50,FR_GES_68,3610,757,2117
2020-05-06,19,1,3,35,FR_GES_68,3629,760,2152
2020-05-07,23,3,4,36,FR_GES_68,3652,764,2188
2020-05-08,16,1,2,27,FR_GES_68,3668,766,2215
2020-05-09,5,0,1,14,FR_GES_68,3673,767,2229
2020-05-10,3,0,0,3,FR_GES_68,3676,767,2232
2020-05-11,29,2,7,26,FR_GES_68,3705,774,2258
2020-05-12,30,2,4,26,FR_GES_68,3735,778,2284
2020-05-13,6,0,2,33,FR_GES_68,3741,780,2317
2020-05-14,50,0,13,65,FR_GES_68,3791,793,2382
2020-05-15,24,0,1,20,FR_GES_68,3815,794,2402
2020-05-16,8,1,1,21,FR_GES_68,3823,795,2423
2020-05-17,9,2,3,17,FR_GES_68,3832,798,2440
2020-05-18,23,6,4,11,FR_GES_68,3855,802,2451
2020-05-19,21,2,3,43,FR_GES_68,3876,805,2494
2020-05-20,19,1,3,29,FR_GES_68,3895,808,2523
2020-05-21,4,0,0,10,FR_GES_68,3899,808,2533
2020-05-22,15,2,4,36,FR_GES_68,3914,812,2569
2020-05-23,19,3,3,24,FR_GES_68,3933,815,2593
2020-05-24,0,1,0,0,FR_GES_68,3933,815,2593
2020-05-25,19,1,4,26,FR_GES_68,3952,819,2619
2020-05-26,11,1,3,24,FR_GES_68,3963,822,2643
2020-05-27,23,3,2,53,FR_GES_68,3986,824,2696
2020-05-28,8,0,2,21,FR_GES_68,3994,826,2717
2020-05-29,5,1,1,21,FR_GES_68,3999,827,2738
2020-05-30,7,1,2,16,FR_GES_68,4006,829,2754
2020-05-31,0,1,0,0,FR_GES_68,4006,829,2754
2020-06-01,0,0,0,0,FR_GES_68,4006,829,2754
2020-06-02,13,1,7,31,FR_GES_68,4019,836,2785
2020-06-03,9,0,3,21,FR_GES_68,4028,839,2806
2020-06-04,15,1,0,16,FR_GES_68,4043,839,2822
2020-06-05,22,1,3,54,FR_GES_68,4065,842,2876
2020-06-06,4,0,2,12,FR_GES_68,4069,844,2888
2020-06-07,0,0,0,0,FR_GES_68,4069,844,2888
2020-06-08,6,1,2,14,FR_GES_68,4075,846,2902
2020-06-09,4,1,0,27,FR_GES_68,4079,846,2929
2020-06-10,2,0,1,18,FR_GES_68,4081,847,2947
2020-06-11,2,1,0,14,FR_GES_68,4083,847,2961
2020-06-12,6,0,0,20,FR_GES_68,4089,847,2981
2020-06-13,2,0,0,5,FR_GES_68,4091,847,2986
2020-06-14,0,0,0,0,FR_GES_68,4091,847,2986
2020-06-15,11,2,0,15,FR_GES_68,4102,847,3001
2020-06-16,4,1,0,20,FR_GES_68,4106,847,3021
2020-06-17,3,1,0,16,FR_GES_68,4109,847,3037
2020-06-18,4,0,1,10,FR_GES_68,4113,848,3047
2020-06-19,2,0,2,6,FR_GES_68,4115,850,3053
2020-06-20,2,1,1,4,FR_GES_68,4117,851,3057
2020-06-21,0,0,0,0,FR_GES_68,4117,851,3057
2020-06-22,6,1,2,18,FR_GES_68,4123,853,3075
2020-06-23,3,1,1,15,FR_GES_68,4126,854,3090
2020-06-24,5,0,0,7,FR_GES_68,4131,854,3097
2020-03-19,244,28,17,46,FR_ARA_69,244,17,46
2020-03-20,32,9,2,11,FR_ARA_69,276,19,57
2020-03-21,70,7,2,4,FR_ARA_69,346,21,61
2020-03-22,56,9,6,10,FR_ARA_69,402,27,71
2020-03-23,109,22,7,8,FR_ARA_69,511,34,79
2020-03-24,83,23,8,21,FR_ARA_69,594,42,100
2020-03-25,128,42,10,20,FR_ARA_69,722,52,120
2020-03-26,146,21,14,40,FR_ARA_69,868,66,160
2020-03-27,181,36,17,58,FR_ARA_69,1049,83,218
2020-03-28,185,66,14,38,FR_ARA_69,1234,97,256
2020-03-29,104,34,15,26,FR_ARA_69,1338,112,282
2020-03-30,117,50,13,18,FR_ARA_69,1455,125,300
2020-03-31,135,29,9,45,FR_ARA_69,1590,134,345
2020-04-01,148,34,21,60,FR_ARA_69,1738,155,405
2020-04-02,113,23,20,51,FR_ARA_69,1851,175,456
2020-04-03,131,23,11,59,FR_ARA_69,1982,186,515
2020-04-04,91,28,14,60,FR_ARA_69,2073,200,575
2020-04-05,86,31,16,28,FR_ARA_69,2159,216,603
2020-04-06,65,12,20,51,FR_ARA_69,2224,236,654
2020-04-07,109,16,17,122,FR_ARA_69,2333,253,776
2020-04-08,96,15,24,79,FR_ARA_69,2429,277,855
2020-04-09,136,12,10,71,FR_ARA_69,2565,287,926
2020-04-10,86,11,13,74,FR_ARA_69,2651,300,1000
2020-04-11,128,15,10,61,FR_ARA_69,2779,310,1061
2020-04-12,39,5,5,30,FR_ARA_69,2818,315,1091
2020-04-13,28,9,10,6,FR_ARA_69,2846,325,1097
2020-04-14,64,7,16,36,FR_ARA_69,2910,341,1133
2020-04-15,104,14,19,89,FR_ARA_69,3014,360,1222
2020-04-16,74,13,14,54,FR_ARA_69,3088,374,1276
2020-04-17,89,8,8,66,FR_ARA_69,3177,382,1342
2020-04-18,66,8,14,61,FR_ARA_69,3243,396,1403
2020-04-19,41,6,8,10,FR_ARA_69,3284,404,1413
2020-04-20,35,7,18,29,FR_ARA_69,3319,422,1442
2020-04-21,62,10,15,58,FR_ARA_69,3381,437,1500
2020-04-22,61,5,6,61,FR_ARA_69,3442,443,1561
2020-04-23,50,4,7,43,FR_ARA_69,3492,450,1604
2020-04-24,61,7,10,58,FR_ARA_69,3553,460,1662
2020-04-25,62,3,7,40,FR_ARA_69,3615,467,1702
2020-04-26,18,0,7,12,FR_ARA_69,3633,474,1714
2020-04-27,24,6,13,30,FR_ARA_69,3657,487,1744
2020-04-28,46,2,10,75,FR_ARA_69,3703,497,1819
2020-04-29,33,3,11,40,FR_ARA_69,3736,508,1859
2020-04-30,40,4,12,25,FR_ARA_69,3776,520,1884
2020-05-01,47,10,9,42,FR_ARA_69,3823,529,1926
2020-05-02,24,6,5,10,FR_ARA_69,3847,534,1936
2020-05-03,12,2,4,4,FR_ARA_69,3859,538,1940
2020-05-04,13,1,7,25,FR_ARA_69,3872,545,1965
2020-05-05,31,5,7,46,FR_ARA_69,3903,552,2011
2020-05-06,20,4,7,43,FR_ARA_69,3923,559,2054
2020-05-07,39,3,10,62,FR_ARA_69,3962,569,2116
2020-05-08,25,5,2,51,FR_ARA_69,3987,571,2167
2020-05-09,4,1,0,9,FR_ARA_69,3991,571,2176
2020-05-10,3,1,4,6,FR_ARA_69,3994,575,2182
2020-05-11,9,2,4,15,FR_ARA_69,4003,579,2197
2020-05-12,15,4,5,46,FR_ARA_69,4018,584,2243
2020-05-13,10,2,3,58,FR_ARA_69,4028,587,2301
2020-05-14,17,3,7,33,FR_ARA_69,4045,594,2334
2020-05-15,7,2,2,18,FR_ARA_69,4052,596,2352
2020-05-16,42,2,10,46,FR_ARA_69,4094,606,2398
2020-05-17,8,2,1,1,FR_ARA_69,4102,607,2399
2020-05-18,8,1,3,30,FR_ARA_69,4110,610,2429
2020-05-19,22,3,3,38,FR_ARA_69,4132,613,2467
2020-05-20,9,1,0,36,FR_ARA_69,4141,613,2503
2020-05-21,15,2,1,30,FR_ARA_69,4156,614,2533
2020-05-22,7,0,3,3,FR_ARA_69,4163,617,2536
2020-05-23,6,0,4,3,FR_ARA_69,4169,621,2539
2020-05-24,2,0,0,0,FR_ARA_69,4171,621,2539
2020-05-25,24,1,3,60,FR_ARA_69,4195,624,2599
2020-05-26,14,0,4,25,FR_ARA_69,4209,628,2624
2020-05-27,8,2,1,44,FR_ARA_69,4217,629,2668
2020-05-28,8,1,6,57,FR_ARA_69,4225,635,2725
2020-05-29,9,1,4,42,FR_ARA_69,4234,639,2767
2020-05-30,17,9,0,7,FR_ARA_69,4251,639,2774
2020-05-31,19,9,1,1,FR_ARA_69,4270,640,2775
2020-06-01,0,0,0,0,FR_ARA_69,4270,640,2775
2020-06-02,6,0,2,18,FR_ARA_69,4276,642,2793
2020-06-03,12,0,4,25,FR_ARA_69,4288,646,2818
2020-06-04,6,1,1,53,FR_ARA_69,4294,647,2871
2020-06-05,6,1,0,40,FR_ARA_69,4300,647,2911
2020-06-06,1,0,1,8,FR_ARA_69,4301,648,2919
2020-06-07,1,0,0,1,FR_ARA_69,4302,648,2920
2020-06-08,4,0,2,9,FR_ARA_69,4306,650,2929
2020-06-09,8,0,3,12,FR_ARA_69,4314,653,2941
2020-06-10,4,0,3,18,FR_ARA_69,4318,656,2959
2020-06-11,6,0,3,16,FR_ARA_69,4324,659,2975
2020-06-12,2,0,1,10,FR_ARA_69,4326,660,2985
2020-06-13,4,1,1,6,FR_ARA_69,4330,661,2991
2020-06-14,0,0,0,0,FR_ARA_69,4330,661,2991
2020-06-15,1,0,1,26,FR_ARA_69,4331,662,3017
2020-06-16,9,0,1,12,FR_ARA_69,4340,663,3029
2020-06-17,4,2,1,35,FR_ARA_69,4344,664,3064
2020-06-18,5,0,1,10,FR_ARA_69,4349,665,3074
2020-06-19,3,0,0,5,FR_ARA_69,4352,665,3079
2020-06-20,9,0,1,8,FR_ARA_69,4361,666,3087
2020-06-21,1,0,0,14,FR_ARA_69,4362,666,3101
2020-06-22,4,0,1,1,FR_ARA_69,4366,667,3102
2020-06-23,7,0,0,9,FR_ARA_69,4373,667,3111
2020-06-24,2,0,0,5,FR_ARA_69,4375,667,3116
2020-03-19,8,2,0,1,FR_BFC_70,8,0,1
2020-03-20,8,1,0,2,FR_BFC_70,16,0,3
2020-03-21,4,2,0,0,FR_BFC_70,20,0,3
2020-03-22,0,1,0,0,FR_BFC_70,20,0,3
2020-03-23,3,2,0,0,FR_BFC_70,23,0,3
2020-03-24,16,7,3,3,FR_BFC_70,39,3,6
2020-03-25,15,8,3,3,FR_BFC_70,54,6,9
2020-03-26,21,4,0,2,FR_BFC_70,75,6,11
2020-03-27,15,3,0,9,FR_BFC_70,90,6,20
2020-03-28,8,4,3,5,FR_BFC_70,98,9,25
2020-03-29,7,2,1,3,FR_BFC_70,105,10,28
2020-03-30,15,4,4,9,FR_BFC_70,120,14,37
2020-03-31,27,8,6,11,FR_BFC_70,147,20,48
2020-04-01,14,3,3,10,FR_BFC_70,161,23,58
2020-04-02,21,3,6,5,FR_BFC_70,182,29,63
2020-04-03,10,1,2,4,FR_BFC_70,192,31,67
2020-04-04,9,3,3,6,FR_BFC_70,201,34,73
2020-04-05,7,3,4,1,FR_BFC_70,208,38,74
2020-04-06,9,1,7,2,FR_BFC_70,217,45,76
2020-04-07,16,2,1,12,FR_BFC_70,233,46,88
2020-04-08,7,2,0,3,FR_BFC_70,240,46,91
2020-04-09,10,0,0,6,FR_BFC_70,250,46,97
2020-04-10,5,1,2,7,FR_BFC_70,255,48,104
2020-04-11,0,0,1,2,FR_BFC_70,255,49,106
2020-04-12,1,0,1,2,FR_BFC_70,256,50,108
2020-04-13,1,1,1,0,FR_BFC_70,257,51,108
2020-04-14,12,2,1,2,FR_BFC_70,269,52,110
2020-04-15,14,0,5,18,FR_BFC_70,283,57,128
2020-04-16,6,0,1,5,FR_BFC_70,289,58,133
2020-04-17,5,1,1,3,FR_BFC_70,294,59,136
2020-04-18,2,0,0,0,FR_BFC_70,296,59,136
2020-04-19,0,0,0,0,FR_BFC_70,296,59,136
2020-04-20,10,2,2,13,FR_BFC_70,306,61,149
2020-04-21,3,0,0,3,FR_BFC_70,309,61,152
2020-04-22,3,0,2,2,FR_BFC_70,312,63,154
2020-04-23,4,0,1,4,FR_BFC_70,316,64,158
2020-04-24,18,0,0,3,FR_BFC_70,334,64,161
2020-04-25,0,0,3,0,FR_BFC_70,334,67,161
2020-04-26,2,0,1,0,FR_BFC_70,336,68,161
2020-04-27,1,0,0,13,FR_BFC_70,337,68,174
2020-04-28,3,0,0,6,FR_BFC_70,340,68,180
2020-04-29,2,0,2,3,FR_BFC_70,342,70,183
2020-04-30,2,0,0,1,FR_BFC_70,344,70,184
2020-05-01,0,0,0,1,FR_BFC_70,344,70,185
2020-05-02,0,0,1,0,FR_BFC_70,344,71,185
2020-05-03,0,0,1,0,FR_BFC_70,344,72,185
2020-05-04,6,0,2,6,FR_BFC_70,350,74,191
2020-05-05,2,1,0,1,FR_BFC_70,352,74,192
2020-05-06,4,0,0,7,FR_BFC_70,356,74,199
2020-05-07,4,0,0,20,FR_BFC_70,360,74,219
2020-05-08,1,1,1,2,FR_BFC_70,361,75,221
2020-05-09,2,0,0,0,FR_BFC_70,363,75,221
2020-05-10,1,0,0,0,FR_BFC_70,364,75,221
2020-05-11,3,0,1,2,FR_BFC_70,367,76,223
2020-05-12,1,0,0,5,FR_BFC_70,368,76,228
2020-05-13,0,1,0,2,FR_BFC_70,368,76,230
2020-05-14,1,0,1,0,FR_BFC_70,369,77,230
2020-05-15,0,1,0,2,FR_BFC_70,369,77,232
2020-05-16,0,0,0,0,FR_BFC_70,369,77,232
2020-05-17,0,0,0,0,FR_BFC_70,369,77,232
2020-05-18,1,0,1,2,FR_BFC_70,370,78,234
2020-05-19,0,0,0,5,FR_BFC_70,370,78,239
2020-05-20,0,0,0,1,FR_BFC_70,370,78,240
2020-05-21,0,0,0,0,FR_BFC_70,370,78,240
2020-05-22,0,0,0,0,FR_BFC_70,370,78,240
2020-05-23,0,1,0,0,FR_BFC_70,370,78,240
2020-05-24,0,0,0,0,FR_BFC_70,370,78,240
2020-05-25,0,0,0,10,FR_BFC_70,370,78,250
2020-05-26,1,0,0,15,FR_BFC_70,371,78,265
2020-05-27,0,0,0,1,FR_BFC_70,371,78,266
2020-05-28,0,0,0,1,FR_BFC_70,371,78,267
2020-05-29,0,0,0,0,FR_BFC_70,371,78,267
2020-05-30,0,0,0,0,FR_BFC_70,371,78,267
2020-05-31,0,0,0,0,FR_BFC_70,371,78,267
2020-06-01,0,0,0,0,FR_BFC_70,371,78,267
2020-06-02,0,0,0,4,FR_BFC_70,371,78,271
2020-06-03,0,0,0,7,FR_BFC_70,371,78,278
2020-06-04,0,0,0,2,FR_BFC_70,371,78,280
2020-06-05,0,0,0,1,FR_BFC_70,371,78,281
2020-06-06,0,0,0,4,FR_BFC_70,371,78,285
2020-06-07,0,0,0,0,FR_BFC_70,371,78,285
2020-06-08,0,0,0,3,FR_BFC_70,371,78,288
2020-06-09,0,0,0,7,FR_BFC_70,371,78,295
2020-06-10,0,0,0,7,FR_BFC_70,371,78,302
2020-06-11,0,0,0,0,FR_BFC_70,371,78,302
2020-06-12,0,0,0,0,FR_BFC_70,371,78,302
2020-06-13,0,0,0,0,FR_BFC_70,371,78,302
2020-06-14,0,0,0,0,FR_BFC_70,371,78,302
2020-06-15,0,0,0,0,FR_BFC_70,371,78,302
2020-06-16,0,0,0,1,FR_BFC_70,371,78,303
2020-06-17,0,0,0,0,FR_BFC_70,371,78,303
2020-06-18,0,0,0,0,FR_BFC_70,371,78,303
2020-06-19,0,0,0,0,FR_BFC_70,371,78,303
2020-06-20,0,0,0,0,FR_BFC_70,371,78,303
2020-06-21,0,0,0,0,FR_BFC_70,371,78,303
2020-06-22,0,0,0,0,FR_BFC_70,371,78,303
2020-06-23,0,0,0,0,FR_BFC_70,371,78,303
2020-06-24,0,0,0,0,FR_BFC_70,371,78,303
2020-03-19,18,3,2,5,FR_BFC_71,18,2,5
2020-03-20,10,2,1,3,FR_BFC_71,28,3,8
2020-03-21,11,1,2,10,FR_BFC_71,39,5,18
2020-03-22,42,0,2,27,FR_BFC_71,81,7,45
2020-03-23,22,1,1,3,FR_BFC_71,103,8,48
2020-03-24,63,5,7,49,FR_BFC_71,166,15,97
2020-03-25,43,4,5,21,FR_BFC_71,209,20,118
2020-03-26,66,3,4,21,FR_BFC_71,275,24,139
2020-03-27,23,5,3,5,FR_BFC_71,298,27,144
2020-03-28,37,5,2,17,FR_BFC_71,335,29,161
2020-03-29,14,1,2,6,FR_BFC_71,349,31,167
2020-03-30,11,11,7,1,FR_BFC_71,360,38,168
2020-03-31,28,3,5,14,FR_BFC_71,388,43,182
2020-04-01,24,8,3,17,FR_BFC_71,412,46,199
2020-04-02,19,4,3,21,FR_BFC_71,431,49,220
2020-04-03,21,3,7,22,FR_BFC_71,452,56,242
2020-04-04,14,3,3,10,FR_BFC_71,466,59,252
2020-04-05,13,0,2,2,FR_BFC_71,479,61,254
2020-04-06,46,3,4,22,FR_BFC_71,525,65,276
2020-04-07,27,4,5,22,FR_BFC_71,552,70,298
2020-04-08,23,5,1,19,FR_BFC_71,575,71,317
2020-04-09,23,3,6,13,FR_BFC_71,598,77,330
2020-04-10,17,2,8,12,FR_BFC_71,615,85,342
2020-04-11,19,1,2,23,FR_BFC_71,634,87,365
2020-04-12,6,3,1,4,FR_BFC_71,640,88,369
2020-04-13,2,2,0,1,FR_BFC_71,642,88,370
2020-04-14,14,0,5,5,FR_BFC_71,656,93,375
2020-04-15,28,1,7,12,FR_BFC_71,684,100,387
2020-04-16,30,1,9,19,FR_BFC_71,714,109,406
2020-04-17,27,1,2,12,FR_BFC_71,741,111,418
2020-04-18,7,2,1,5,FR_BFC_71,748,112,423
2020-04-19,9,3,4,8,FR_BFC_71,757,116,431
2020-04-20,13,1,3,2,FR_BFC_71,770,119,433
2020-04-21,29,3,12,23,FR_BFC_71,799,131,456
2020-04-22,43,2,2,25,FR_BFC_71,842,133,481
2020-04-23,12,0,4,4,FR_BFC_71,854,137,485
2020-04-24,13,1,5,22,FR_BFC_71,867,142,507
2020-04-25,15,0,1,6,FR_BFC_71,882,143,513
2020-04-26,5,1,2,2,FR_BFC_71,887,145,515
2020-04-27,16,1,5,3,FR_BFC_71,903,150,518
2020-04-28,31,2,3,14,FR_BFC_71,934,153,532
2020-04-29,30,0,3,17,FR_BFC_71,964,156,549
2020-04-30,28,2,1,24,FR_BFC_71,992,157,573
2020-05-01,5,0,0,12,FR_BFC_71,997,157,585
2020-05-02,1,0,1,0,FR_BFC_71,998,158,585
2020-05-03,6,3,3,3,FR_BFC_71,1004,161,588
2020-05-04,4,0,3,7,FR_BFC_71,1008,164,595
2020-05-05,12,0,0,11,FR_BFC_71,1020,164,606
2020-05-06,9,0,1,8,FR_BFC_71,1029,165,614
2020-05-07,5,0,1,8,FR_BFC_71,1034,166,622
2020-05-08,6,3,4,12,FR_BFC_71,1040,170,634
2020-05-09,2,0,1,2,FR_BFC_71,1042,171,636
2020-05-10,3,0,2,2,FR_BFC_71,1045,173,638
2020-05-11,4,1,4,5,FR_BFC_71,1049,177,643
2020-05-12,1,0,3,14,FR_BFC_71,1050,180,657
2020-05-13,11,0,3,12,FR_BFC_71,1061,183,669
2020-05-14,5,1,0,4,FR_BFC_71,1066,183,673
2020-05-15,5,2,1,9,FR_BFC_71,1071,184,682
2020-05-16,1,1,0,2,FR_BFC_71,1072,184,684
2020-05-17,0,0,0,0,FR_BFC_71,1072,184,684
2020-05-18,8,0,2,3,FR_BFC_71,1080,186,687
2020-05-19,9,1,4,11,FR_BFC_71,1089,190,698
2020-05-20,3,0,0,11,FR_BFC_71,1092,190,709
2020-05-21,0,0,0,2,FR_BFC_71,1092,190,711
2020-05-22,3,1,0,10,FR_BFC_71,1095,190,721
2020-05-23,1,0,0,0,FR_BFC_71,1096,190,721
2020-05-24,0,0,0,1,FR_BFC_71,1096,190,722
2020-05-25,10,2,2,11,FR_BFC_71,1106,192,733
2020-05-26,4,0,0,15,FR_BFC_71,1110,192,748
2020-05-27,2,0,0,6,FR_BFC_71,1112,192,754
2020-05-28,3,0,0,6,FR_BFC_71,1115,192,760
2020-05-29,3,0,2,10,FR_BFC_71,1118,194,770
2020-05-30,0,0,0,0,FR_BFC_71,1118,194,770
2020-05-31,0,0,0,0,FR_BFC_71,1118,194,770
2020-06-01,0,0,0,0,FR_BFC_71,1118,194,770
2020-06-02,3,0,0,13,FR_BFC_71,1121,194,783
2020-06-03,5,1,2,21,FR_BFC_71,1126,196,804
2020-06-04,0,0,0,2,FR_BFC_71,1126,196,806
2020-06-05,1,0,0,4,FR_BFC_71,1127,196,810
2020-06-06,0,0,0,0,FR_BFC_71,1127,196,810
2020-06-07,0,0,0,0,FR_BFC_71,1127,196,810
2020-06-08,5,1,1,2,FR_BFC_71,1132,197,812
2020-06-09,3,1,0,9,FR_BFC_71,1135,197,821
2020-06-10,2,0,1,14,FR_BFC_71,1137,198,835
2020-06-11,0,0,0,5,FR_BFC_71,1137,198,840
2020-06-12,0,0,0,14,FR_BFC_71,1137,198,854
2020-06-13,0,0,0,1,FR_BFC_71,1137,198,855
2020-06-14,0,0,0,0,FR_BFC_71,1137,198,855
2020-06-15,1,0,0,0,FR_BFC_71,1138,198,855
2020-06-16,0,0,0,5,FR_BFC_71,1138,198,860
2020-06-17,0,0,0,0,FR_BFC_71,1138,198,860
2020-06-18,0,0,0,0,FR_BFC_71,1138,198,860
2020-06-19,0,0,0,16,FR_BFC_71,1138,198,876
2020-06-20,0,0,0,0,FR_BFC_71,1138,198,876
2020-06-21,0,0,0,0,FR_BFC_71,1138,198,876
2020-06-22,2,0,0,6,FR_BFC_71,1140,198,882
2020-06-23,0,1,0,6,FR_BFC_71,1140,198,888
2020-06-24,0,0,0,1,FR_BFC_71,1140,198,889
2020-03-19,3,0,0,4,FR_PDL_72,3,0,4
2020-03-20,0,0,0,0,FR_PDL_72,3,0,4
2020-03-21,3,0,0,0,FR_PDL_72,6,0,4
2020-03-22,5,1,0,1,FR_PDL_72,11,0,5
2020-03-23,6,1,1,0,FR_PDL_72,17,1,5
2020-03-24,9,1,0,6,FR_PDL_72,26,1,11
2020-03-25,4,1,0,1,FR_PDL_72,30,1,12
2020-03-26,24,3,1,7,FR_PDL_72,54,2,19
2020-03-27,16,6,1,2,FR_PDL_72,70,3,21
2020-03-28,33,6,1,3,FR_PDL_72,103,4,24
2020-03-29,26,1,1,7,FR_PDL_72,129,5,31
2020-03-30,23,6,1,5,FR_PDL_72,152,6,36
2020-03-31,20,3,4,12,FR_PDL_72,172,10,48
2020-04-01,18,5,4,12,FR_PDL_72,190,14,60
2020-04-02,18,1,3,8,FR_PDL_72,208,17,68
2020-04-03,14,2,2,12,FR_PDL_72,222,19,80
2020-04-04,5,0,0,8,FR_PDL_72,227,19,88
2020-04-05,9,2,1,4,FR_PDL_72,236,20,92
2020-04-06,5,0,2,5,FR_PDL_72,241,22,97
2020-04-07,14,3,0,8,FR_PDL_72,255,22,105
2020-04-08,15,1,1,10,FR_PDL_72,270,23,115
2020-04-09,26,0,1,10,FR_PDL_72,296,24,125
2020-04-10,7,1,1,2,FR_PDL_72,303,25,127
2020-04-11,13,4,1,8,FR_PDL_72,316,26,135
2020-04-12,9,1,2,3,FR_PDL_72,325,28,138
2020-04-13,5,0,0,1,FR_PDL_72,330,28,139
2020-04-14,11,2,6,14,FR_PDL_72,341,34,153
2020-04-15,20,0,0,20,FR_PDL_72,361,34,173
2020-04-16,12,0,1,12,FR_PDL_72,373,35,185
2020-04-17,6,0,1,7,FR_PDL_72,379,36,192
2020-04-18,9,3,1,7,FR_PDL_72,388,37,199
2020-04-19,4,0,2,1,FR_PDL_72,392,39,200
2020-04-20,9,0,3,2,FR_PDL_72,401,42,202
2020-04-21,5,0,1,8,FR_PDL_72,406,43,210
2020-04-22,7,0,1,4,FR_PDL_72,413,44,214
2020-04-23,14,2,1,8,FR_PDL_72,427,45,222
2020-04-24,9,0,3,4,FR_PDL_72,436,48,226
2020-04-25,7,1,1,5,FR_PDL_72,443,49,231
2020-04-26,5,1,0,0,FR_PDL_72,448,49,231
2020-04-27,5,0,2,10,FR_PDL_72,453,51,241
2020-04-28,5,0,3,7,FR_PDL_72,458,54,248
2020-04-29,4,0,2,9,FR_PDL_72,462,56,257
2020-04-30,3,0,0,9,FR_PDL_72,465,56,266
2020-05-01,11,0,0,3,FR_PDL_72,476,56,269
2020-05-02,2,1,0,0,FR_PDL_72,478,56,269
2020-05-03,3,0,2,1,FR_PDL_72,481,58,270
2020-05-04,1,0,4,0,FR_PDL_72,482,62,270
2020-05-05,7,1,1,9,FR_PDL_72,489,63,279
2020-05-06,6,0,2,3,FR_PDL_72,495,65,282
2020-05-07,2,0,0,0,FR_PDL_72,497,65,282
2020-05-08,4,0,0,5,FR_PDL_72,501,65,287
2020-05-09,3,0,3,1,FR_PDL_72,504,68,288
2020-05-10,4,0,1,0,FR_PDL_72,508,69,288
2020-05-11,0,0,1,2,FR_PDL_72,508,70,290
2020-05-12,4,0,1,6,FR_PDL_72,512,71,296
2020-05-13,6,0,0,4,FR_PDL_72,518,71,300
2020-05-14,5,0,1,4,FR_PDL_72,523,72,304
2020-05-15,2,0,0,5,FR_PDL_72,525,72,309
2020-05-16,1,0,2,2,FR_PDL_72,526,74,311
2020-05-17,1,0,0,1,FR_PDL_72,527,74,312
2020-05-18,1,0,2,4,FR_PDL_72,528,76,316
2020-05-19,0,0,0,5,FR_PDL_72,528,76,321
2020-05-20,1,0,0,3,FR_PDL_72,529,76,324
2020-05-21,1,0,0,4,FR_PDL_72,530,76,328
2020-05-22,3,0,0,1,FR_PDL_72,533,76,329
2020-05-23,0,0,1,3,FR_PDL_72,533,77,332
2020-05-24,1,0,0,1,FR_PDL_72,534,77,333
2020-05-25,0,0,0,1,FR_PDL_72,534,77,334
2020-05-26,0,0,0,1,FR_PDL_72,534,77,335
2020-05-27,1,0,2,3,FR_PDL_72,535,79,338
2020-05-28,0,0,0,1,FR_PDL_72,535,79,339
2020-05-29,0,0,1,6,FR_PDL_72,535,80,345
2020-05-30,0,0,0,3,FR_PDL_72,535,80,348
2020-05-31,0,0,0,0,FR_PDL_72,535,80,348
2020-06-01,0,0,0,0,FR_PDL_72,535,80,348
2020-06-02,3,0,0,3,FR_PDL_72,538,80,351
2020-06-03,2,0,2,11,FR_PDL_72,540,82,362
2020-06-04,1,0,1,7,FR_PDL_72,541,83,369
2020-06-05,0,0,0,0,FR_PDL_72,541,83,369
2020-06-06,0,0,0,0,FR_PDL_72,541,83,369
2020-06-07,0,0,1,2,FR_PDL_72,541,84,371
2020-06-08,0,0,0,0,FR_PDL_72,541,84,371
2020-06-09,0,0,0,1,FR_PDL_72,541,84,372
2020-06-10,1,0,0,2,FR_PDL_72,542,84,374
2020-06-11,1,0,0,0,FR_PDL_72,543,84,374
2020-06-12,0,0,0,0,FR_PDL_72,543,84,374
2020-06-13,0,0,0,0,FR_PDL_72,543,84,374
2020-06-14,1,0,0,0,FR_PDL_72,544,84,374
2020-06-15,0,0,0,1,FR_PDL_72,544,84,375
2020-06-16,0,0,0,0,FR_PDL_72,544,84,375
2020-06-17,0,0,1,15,FR_PDL_72,544,85,390
2020-06-18,0,0,0,2,FR_PDL_72,544,85,392
2020-06-19,0,0,0,0,FR_PDL_72,544,85,392
2020-06-20,1,0,0,1,FR_PDL_72,545,85,393
2020-06-21,0,0,0,0,FR_PDL_72,545,85,393
2020-06-22,0,0,0,1,FR_PDL_72,545,85,394
2020-06-23,0,0,0,0,FR_PDL_72,545,85,394
2020-06-24,0,0,0,1,FR_PDL_72,545,85,395
2020-03-19,9,2,0,4,FR_ARA_73,9,0,4
2020-03-20,5,0,0,1,FR_ARA_73,14,0,5
2020-03-21,2,0,0,0,FR_ARA_73,16,0,5
2020-03-22,8,1,0,0,FR_ARA_73,24,0,5
2020-03-23,6,2,1,5,FR_ARA_73,30,1,10
2020-03-24,6,1,0,3,FR_ARA_73,36,1,13
2020-03-25,17,2,1,2,FR_ARA_73,53,2,15
2020-03-26,11,6,0,1,FR_ARA_73,64,2,16
2020-03-27,13,2,1,5,FR_ARA_73,77,3,21
2020-03-28,7,2,0,1,FR_ARA_73,84,3,22
2020-03-29,20,1,1,2,FR_ARA_73,104,4,24
2020-03-30,13,7,1,8,FR_ARA_73,117,5,32
2020-03-31,34,6,0,19,FR_ARA_73,151,5,51
2020-04-01,44,3,1,33,FR_ARA_73,195,6,84
2020-04-02,34,4,8,22,FR_ARA_73,229,14,106
2020-04-03,5,2,1,11,FR_ARA_73,234,15,117
2020-04-04,6,0,0,2,FR_ARA_73,240,15,119
2020-04-05,6,0,1,2,FR_ARA_73,246,16,121
2020-04-06,9,2,3,6,FR_ARA_73,255,19,127
2020-04-07,21,2,1,13,FR_ARA_73,276,20,140
2020-04-08,9,0,1,8,FR_ARA_73,285,21,148
2020-04-09,18,2,0,19,FR_ARA_73,303,21,167
2020-04-10,12,0,3,10,FR_ARA_73,315,24,177
2020-04-11,8,0,0,13,FR_ARA_73,323,24,190
2020-04-12,6,1,0,6,FR_ARA_73,329,24,196
2020-04-13,5,2,1,1,FR_ARA_73,334,25,197
2020-04-14,6,0,4,17,FR_ARA_73,340,29,214
2020-04-15,7,4,0,10,FR_ARA_73,347,29,224
2020-04-16,6,1,2,4,FR_ARA_73,353,31,228
2020-04-17,14,0,1,15,FR_ARA_73,367,32,243
2020-04-18,7,1,1,10,FR_ARA_73,374,33,253
2020-04-19,6,0,0,4,FR_ARA_73,380,33,257
2020-04-20,4,2,4,1,FR_ARA_73,384,37,258
2020-04-21,12,1,2,8,FR_ARA_73,396,39,266
2020-04-22,2,0,1,4,FR_ARA_73,398,40,270
2020-04-23,10,1,1,12,FR_ARA_73,408,41,282
2020-04-24,6,0,1,2,FR_ARA_73,414,42,284
2020-04-25,10,0,0,9,FR_ARA_73,424,42,293
2020-04-26,2,0,0,3,FR_ARA_73,426,42,296
2020-04-27,4,0,0,4,FR_ARA_73,430,42,300
2020-04-28,6,2,0,11,FR_ARA_73,436,42,311
2020-04-29,1,0,0,5,FR_ARA_73,437,42,316
2020-04-30,3,0,1,6,FR_ARA_73,440,43,322
2020-05-01,2,0,2,4,FR_ARA_73,442,45,326
2020-05-02,0,0,1,0,FR_ARA_73,442,46,326
2020-05-03,1,0,0,0,FR_ARA_73,443,46,326
2020-05-04,3,0,3,2,FR_ARA_73,446,49,328
2020-05-05,8,1,4,4,FR_ARA_73,454,53,332
2020-05-06,1,0,1,1,FR_ARA_73,455,54,333
2020-05-07,2,0,3,9,FR_ARA_73,457,57,342
2020-05-08,1,0,0,1,FR_ARA_73,458,57,343
2020-05-09,1,0,0,1,FR_ARA_73,459,57,344
2020-05-10,0,1,1,0,FR_ARA_73,459,58,344
2020-05-11,3,1,0,1,FR_ARA_73,462,58,345
2020-05-12,2,0,1,3,FR_ARA_73,464,59,348
2020-05-13,1,0,0,2,FR_ARA_73,465,59,350
2020-05-14,3,0,1,5,FR_ARA_73,468,60,355
2020-05-15,2,0,0,0,FR_ARA_73,470,60,355
2020-05-16,1,0,0,3,FR_ARA_73,471,60,358
2020-05-17,1,0,1,0,FR_ARA_73,472,61,358
2020-05-18,0,0,0,1,FR_ARA_73,472,61,359
2020-05-19,2,1,0,4,FR_ARA_73,474,61,363
2020-05-20,3,1,2,3,FR_ARA_73,477,63,366
2020-05-21,0,0,0,0,FR_ARA_73,477,63,366
2020-05-22,1,0,0,3,FR_ARA_73,478,63,369
2020-05-23,2,0,2,0,FR_ARA_73,480,65,369
2020-05-24,0,0,0,0,FR_ARA_73,480,65,369
2020-05-25,0,0,0,1,FR_ARA_73,480,65,370
2020-05-26,1,0,1,2,FR_ARA_73,481,66,372
2020-05-27,3,0,2,5,FR_ARA_73,484,68,377
2020-05-28,0,0,0,0,FR_ARA_73,484,68,377
2020-05-29,1,0,2,1,FR_ARA_73,485,70,378
2020-05-30,1,1,0,3,FR_ARA_73,486,70,381
2020-05-31,0,0,0,0,FR_ARA_73,486,70,381
2020-06-01,1,0,0,0,FR_ARA_73,487,70,381
2020-06-02,0,0,0,0,FR_ARA_73,487,70,381
2020-06-03,1,0,0,0,FR_ARA_73,488,70,381
2020-06-04,2,0,0,4,FR_ARA_73,490,70,385
2020-06-05,1,0,0,1,FR_ARA_73,491,70,386
2020-06-06,0,0,0,1,FR_ARA_73,491,70,387
2020-06-07,0,0,1,0,FR_ARA_73,491,71,387
2020-06-08,2,0,0,6,FR_ARA_73,493,71,393
2020-06-09,0,0,0,2,FR_ARA_73,493,71,395
2020-06-10,1,0,0,2,FR_ARA_73,494,71,397
2020-06-11,0,0,0,0,FR_ARA_73,494,71,397
2020-06-12,2,0,0,2,FR_ARA_73,496,71,399
2020-06-13,0,0,0,1,FR_ARA_73,496,71,400
2020-06-14,0,0,0,0,FR_ARA_73,496,71,400
2020-06-15,0,0,0,0,FR_ARA_73,496,71,400
2020-06-16,0,0,0,1,FR_ARA_73,496,71,401
2020-06-17,2,0,0,1,FR_ARA_73,498,71,402
2020-06-18,0,0,0,0,FR_ARA_73,498,71,402
2020-06-19,2,0,0,0,FR_ARA_73,500,71,402
2020-06-20,0,0,0,0,FR_ARA_73,500,71,402
2020-06-21,0,0,0,0,FR_ARA_73,500,71,402
2020-06-22,0,0,0,3,FR_ARA_73,500,71,405
2020-06-23,1,0,0,0,FR_ARA_73,501,71,405
2020-06-24,0,0,0,0,FR_ARA_73,501,71,405
2020-03-19,13,2,1,6,FR_ARA_74,13,1,6
2020-03-20,23,0,0,4,FR_ARA_74,36,1,10
2020-03-21,15,1,1,6,FR_ARA_74,51,2,16
2020-03-22,16,3,2,2,FR_ARA_74,67,4,18
2020-03-23,26,8,3,3,FR_ARA_74,93,7,21
2020-03-24,14,7,2,10,FR_ARA_74,107,9,31
2020-03-25,36,6,1,11,FR_ARA_74,143,10,42
2020-03-26,35,7,1,13,FR_ARA_74,178,11,55
2020-03-27,40,7,3,10,FR_ARA_74,218,14,65
2020-03-28,37,5,4,17,FR_ARA_74,255,18,82
2020-03-29,45,12,3,7,FR_ARA_74,300,21,89
2020-03-30,46,9,1,14,FR_ARA_74,346,22,103
2020-03-31,24,9,3,15,FR_ARA_74,370,25,118
2020-04-01,39,11,9,25,FR_ARA_74,409,34,143
2020-04-02,44,8,7,34,FR_ARA_74,453,41,177
2020-04-03,39,5,6,13,FR_ARA_74,492,47,190
2020-04-04,16,3,3,23,FR_ARA_74,508,50,213
2020-04-05,38,10,1,7,FR_ARA_74,546,51,220
2020-04-06,15,5,8,10,FR_ARA_74,561,59,230
2020-04-07,25,7,4,27,FR_ARA_74,586,63,257
2020-04-08,29,3,5,29,FR_ARA_74,615,68,286
2020-04-09,26,3,4,19,FR_ARA_74,641,72,305
2020-04-10,15,1,2,14,FR_ARA_74,656,74,319
2020-04-11,39,2,6,33,FR_ARA_74,695,80,352
2020-04-12,14,0,3,8,FR_ARA_74,709,83,360
2020-04-13,11,2,1,7,FR_ARA_74,720,84,367
2020-04-14,14,0,0,9,FR_ARA_74,734,84,376
2020-04-15,23,1,2,20,FR_ARA_74,757,86,396
2020-04-16,17,3,9,30,FR_ARA_74,774,95,426
2020-04-17,18,1,4,26,FR_ARA_74,792,99,452
2020-04-18,28,2,2,11,FR_ARA_74,820,101,463
2020-04-19,12,0,5,6,FR_ARA_74,832,106,469
2020-04-20,6,1,8,12,FR_ARA_74,838,114,481
2020-04-21,16,4,3,17,FR_ARA_74,854,117,498
2020-04-22,9,0,1,12,FR_ARA_74,863,118,510
2020-04-23,4,0,4,16,FR_ARA_74,867,122,526
2020-04-24,12,1,0,24,FR_ARA_74,879,122,550
2020-04-25,8,0,3,11,FR_ARA_74,887,125,561
2020-04-26,7,0,2,5,FR_ARA_74,894,127,566
2020-04-27,9,0,3,9,FR_ARA_74,903,130,575
2020-04-28,15,1,4,14,FR_ARA_74,918,134,589
2020-04-29,12,1,3,19,FR_ARA_74,930,137,608
2020-04-30,10,1,0,9,FR_ARA_74,940,137,617
2020-05-01,7,0,1,6,FR_ARA_74,947,138,623
2020-05-02,6,0,0,6,FR_ARA_74,953,138,629
2020-05-03,4,0,3,5,FR_ARA_74,957,141,634
2020-05-04,6,1,2,2,FR_ARA_74,963,143,636
2020-05-05,9,0,4,7,FR_ARA_74,972,147,643
2020-05-06,3,0,2,9,FR_ARA_74,975,149,652
2020-05-07,9,0,3,14,FR_ARA_74,984,152,666
2020-05-08,2,0,0,14,FR_ARA_74,986,152,680
2020-05-09,9,0,0,1,FR_ARA_74,995,152,681
2020-05-10,2,0,0,1,FR_ARA_74,997,152,682
2020-05-11,2,0,1,6,FR_ARA_74,999,153,688
2020-05-12,2,0,1,16,FR_ARA_74,1001,154,704
2020-05-13,6,0,0,7,FR_ARA_74,1007,154,711
2020-05-14,8,1,0,11,FR_ARA_74,1015,154,722
2020-05-15,4,0,1,9,FR_ARA_74,1019,155,731
2020-05-16,4,1,0,4,FR_ARA_74,1023,155,735
2020-05-17,3,1,0,2,FR_ARA_74,1026,155,737
2020-05-18,3,0,0,4,FR_ARA_74,1029,155,741
2020-05-19,3,0,1,10,FR_ARA_74,1032,156,751
2020-05-20,1,0,2,7,FR_ARA_74,1033,158,758
2020-05-21,1,0,0,4,FR_ARA_74,1034,158,762
2020-05-22,1,0,0,4,FR_ARA_74,1035,158,766
2020-05-23,1,1,0,3,FR_ARA_74,1036,158,769
2020-05-24,2,0,0,1,FR_ARA_74,1038,158,770
2020-05-25,3,0,0,5,FR_ARA_74,1041,158,775
2020-05-26,1,0,2,5,FR_ARA_74,1042,160,780
2020-05-27,1,0,0,1,FR_ARA_74,1043,160,781
2020-05-28,1,0,0,2,FR_ARA_74,1044,160,783
2020-05-29,0,0,0,4,FR_ARA_74,1044,160,787
2020-05-30,1,0,0,1,FR_ARA_74,1045,160,788
2020-05-31,0,0,0,7,FR_ARA_74,1045,160,795
2020-06-01,1,0,0,0,FR_ARA_74,1046,160,795
2020-06-02,1,1,0,2,FR_ARA_74,1047,160,797
2020-06-03,2,0,1,1,FR_ARA_74,1049,161,798
2020-06-04,0,1,1,3,FR_ARA_74,1049,162,801
2020-06-05,0,0,0,3,FR_ARA_74,1049,162,804
2020-06-06,1,0,0,0,FR_ARA_74,1050,162,804
2020-06-07,0,0,0,0,FR_ARA_74,1050,162,804
2020-06-08,0,0,0,1,FR_ARA_74,1050,162,805
2020-06-09,1,0,0,4,FR_ARA_74,1051,162,809
2020-06-10,1,0,0,1,FR_ARA_74,1052,162,810
2020-06-11,0,0,0,0,FR_ARA_74,1052,162,810
2020-06-12,1,0,0,0,FR_ARA_74,1053,162,810
2020-06-13,0,0,0,0,FR_ARA_74,1053,162,810
2020-06-14,0,0,0,2,FR_ARA_74,1053,162,812
2020-06-15,0,0,0,2,FR_ARA_74,1053,162,814
2020-06-16,1,1,1,0,FR_ARA_74,1054,163,814
2020-06-17,0,0,0,2,FR_ARA_74,1054,163,816
2020-06-18,1,0,0,0,FR_ARA_74,1055,163,816
2020-06-19,1,1,0,0,FR_ARA_74,1056,163,816
2020-06-20,0,0,0,0,FR_ARA_74,1056,163,816
2020-06-21,0,0,0,0,FR_ARA_74,1056,163,816
2020-06-22,2,0,0,1,FR_ARA_74,1058,163,817
2020-06-23,3,0,0,3,FR_ARA_74,1061,163,820
2020-06-24,0,0,0,0,FR_ARA_74,1061,163,820
2020-03-19,168,42,11,31,FR_IDF_75,168,11,31
2020-03-20,120,21,5,28,FR_IDF_75,288,16,59
2020-03-21,140,35,7,35,FR_IDF_75,428,23,94
2020-03-22,150,33,4,33,FR_IDF_75,578,27,127
2020-03-23,188,31,18,33,FR_IDF_75,766,45,160
2020-03-24,209,70,21,35,FR_IDF_75,975,66,195
2020-03-25,314,66,32,62,FR_IDF_75,1289,98,257
2020-03-26,277,66,28,65,FR_IDF_75,1566,126,322
2020-03-27,270,77,42,82,FR_IDF_75,1836,168,404
2020-03-28,346,76,31,66,FR_IDF_75,2182,199,470
2020-03-29,242,69,25,17,FR_IDF_75,2424,224,487
2020-03-30,253,53,69,96,FR_IDF_75,2677,293,583
2020-03-31,407,84,57,125,FR_IDF_75,3084,350,708
2020-04-01,381,87,42,137,FR_IDF_75,3465,392,845
2020-04-02,344,96,51,115,FR_IDF_75,3809,443,960
2020-04-03,296,65,58,139,FR_IDF_75,4105,501,1099
2020-04-04,287,77,36,121,FR_IDF_75,4392,537,1220
2020-04-05,233,55,45,98,FR_IDF_75,4625,582,1318
2020-04-06,227,67,54,79,FR_IDF_75,4852,636,1397
2020-04-07,236,55,38,128,FR_IDF_75,5088,674,1525
2020-04-08,241,60,50,156,FR_IDF_75,5329,724,1681
2020-04-09,238,40,38,172,FR_IDF_75,5567,762,1853
2020-04-10,293,63,69,193,FR_IDF_75,5860,831,2046
2020-04-11,220,32,32,129,FR_IDF_75,6080,863,2175
2020-04-12,169,41,45,99,FR_IDF_75,6249,908,2274
2020-04-13,131,29,48,66,FR_IDF_75,6380,956,2340
2020-04-14,127,32,45,53,FR_IDF_75,6507,1001,2393
2020-04-15,153,36,52,148,FR_IDF_75,6660,1053,2541
2020-04-16,154,23,36,169,FR_IDF_75,6814,1089,2710
2020-04-17,203,36,43,156,FR_IDF_75,7017,1132,2866
2020-04-18,131,28,28,140,FR_IDF_75,7148,1160,3006
2020-04-19,60,7,34,93,FR_IDF_75,7208,1194,3099
2020-04-20,110,14,47,55,FR_IDF_75,7318,1241,3154
2020-04-21,131,29,35,144,FR_IDF_75,7449,1276,3298
2020-04-22,92,15,17,133,FR_IDF_75,7541,1293,3431
2020-04-23,82,15,22,136,FR_IDF_75,7623,1315,3567
2020-04-24,64,23,17,107,FR_IDF_75,7687,1332,3674
2020-04-25,69,20,19,97,FR_IDF_75,7756,1351,3771
2020-04-26,51,5,21,41,FR_IDF_75,7807,1372,3812
2020-04-27,53,18,21,73,FR_IDF_75,7860,1393,3885
2020-04-28,84,14,35,101,FR_IDF_75,7944,1428,3986
2020-04-29,104,12,26,153,FR_IDF_75,8048,1454,4139
2020-04-30,75,12,21,104,FR_IDF_75,8123,1475,4243
2020-05-01,42,5,5,76,FR_IDF_75,8165,1480,4319
2020-05-02,32,6,15,64,FR_IDF_75,8197,1495,4383
2020-05-03,24,15,8,27,FR_IDF_75,8221,1503,4410
2020-05-04,42,15,24,32,FR_IDF_75,8263,1527,4442
2020-05-05,79,13,25,95,FR_IDF_75,8342,1552,4537
2020-05-06,48,7,13,130,FR_IDF_75,8390,1565,4667
2020-05-07,47,13,8,131,FR_IDF_75,8437,1573,4798
2020-05-08,35,13,2,69,FR_IDF_75,8472,1575,4867
2020-05-09,22,7,13,25,FR_IDF_75,8494,1588,4892
2020-05-10,21,5,4,11,FR_IDF_75,8515,1592,4903
2020-05-11,43,13,18,45,FR_IDF_75,8558,1610,4948
2020-05-12,54,11,6,82,FR_IDF_75,8612,1616,5030
2020-05-13,31,8,4,59,FR_IDF_75,8643,1620,5089
2020-05-14,18,3,4,79,FR_IDF_75,8661,1624,5168
2020-05-15,28,9,5,68,FR_IDF_75,8689,1629,5236
2020-05-16,22,8,1,23,FR_IDF_75,8711,1630,5259
2020-05-17,10,3,1,13,FR_IDF_75,8721,1631,5272
2020-05-18,17,5,12,34,FR_IDF_75,8738,1643,5306
2020-05-19,30,14,13,105,FR_IDF_75,8768,1656,5411
2020-05-20,25,6,4,69,FR_IDF_75,8793,1660,5480
2020-05-21,14,7,8,49,FR_IDF_75,8807,1668,5529
2020-05-22,12,8,11,23,FR_IDF_75,8819,1679,5552
2020-05-23,12,2,3,52,FR_IDF_75,8831,1682,5604
2020-05-24,4,3,3,6,FR_IDF_75,8835,1685,5610
2020-05-25,10,2,6,31,FR_IDF_75,8845,1691,5641
2020-05-26,22,1,4,43,FR_IDF_75,8867,1695,5684
2020-05-27,8,2,5,105,FR_IDF_75,8875,1700,5789
2020-05-28,16,3,10,50,FR_IDF_75,8891,1710,5839
2020-05-29,14,2,3,33,FR_IDF_75,8905,1713,5872
2020-05-30,12,3,0,28,FR_IDF_75,8917,1713,5900
2020-05-31,5,3,2,10,FR_IDF_75,8922,1715,5910
2020-06-01,7,0,1,14,FR_IDF_75,8929,1716,5924
2020-06-02,6,2,0,16,FR_IDF_75,8935,1716,5940
2020-06-03,7,2,2,30,FR_IDF_75,8942,1718,5970
2020-06-04,10,0,2,17,FR_IDF_75,8952,1720,5987
2020-06-05,11,2,2,41,FR_IDF_75,8963,1722,6028
2020-06-06,7,2,3,21,FR_IDF_75,8970,1725,6049
2020-06-07,4,2,0,4,FR_IDF_75,8974,1725,6053
2020-06-08,6,2,0,21,FR_IDF_75,8980,1725,6074
2020-06-09,5,2,6,18,FR_IDF_75,8985,1731,6092
2020-06-10,17,6,1,10,FR_IDF_75,9002,1732,6102
2020-06-11,8,2,4,30,FR_IDF_75,9010,1736,6132
2020-06-12,5,2,7,7,FR_IDF_75,9015,1743,6139
2020-06-13,0,1,7,16,FR_IDF_75,9015,1750,6155
2020-06-14,1,0,0,0,FR_IDF_75,9016,1750,6155
2020-06-15,4,2,2,14,FR_IDF_75,9020,1752,6169
2020-06-16,5,3,0,29,FR_IDF_75,9025,1752,6198
2020-06-17,4,1,5,38,FR_IDF_75,9029,1757,6236
2020-06-18,9,0,2,12,FR_IDF_75,9038,1759,6248
2020-06-19,3,2,0,9,FR_IDF_75,9041,1759,6257
2020-06-20,3,1,1,5,FR_IDF_75,9044,1760,6262
2020-06-21,1,0,0,2,FR_IDF_75,9045,1760,6264
2020-06-22,1,1,1,12,FR_IDF_75,9046,1761,6276
2020-06-23,6,2,1,1,FR_IDF_75,9052,1762,6277
2020-06-24,2,0,0,13,FR_IDF_75,9054,1762,6290
2020-03-19,12,4,1,1,FR_NOR_76,12,1,1
2020-03-20,14,1,1,1,FR_NOR_76,26,2,2
2020-03-21,17,4,0,1,FR_NOR_76,43,2,3
2020-03-22,14,3,2,2,FR_NOR_76,57,4,5
2020-03-23,14,3,1,0,FR_NOR_76,71,5,5
2020-03-24,24,6,4,3,FR_NOR_76,95,9,8
2020-03-25,36,11,1,4,FR_NOR_76,131,10,12
2020-03-26,31,15,1,3,FR_NOR_76,162,11,15
2020-03-27,33,14,2,7,FR_NOR_76,195,13,22
2020-03-28,61,14,2,14,FR_NOR_76,256,15,36
2020-03-29,58,13,4,5,FR_NOR_76,314,19,41
2020-03-30,14,10,2,5,FR_NOR_76,328,21,46
2020-03-31,70,20,10,17,FR_NOR_76,398,31,63
2020-04-01,31,9,4,27,FR_NOR_76,429,35,90
2020-04-02,57,15,6,21,FR_NOR_76,486,41,111
2020-04-03,28,7,9,17,FR_NOR_76,514,50,128
2020-04-04,32,8,2,18,FR_NOR_76,546,52,146
2020-04-05,23,5,5,10,FR_NOR_76,569,57,156
2020-04-06,23,6,5,11,FR_NOR_76,592,62,167
2020-04-07,35,7,6,29,FR_NOR_76,627,68,196
2020-04-08,18,3,9,30,FR_NOR_76,645,77,226
2020-04-09,14,7,5,16,FR_NOR_76,659,82,242
2020-04-10,32,5,6,20,FR_NOR_76,691,88,262
2020-04-11,13,5,3,16,FR_NOR_76,704,91,278
2020-04-12,13,1,3,19,FR_NOR_76,717,94,297
2020-04-13,16,6,5,6,FR_NOR_76,733,99,303
2020-04-14,14,4,4,14,FR_NOR_76,747,103,317
2020-04-15,18,0,1,21,FR_NOR_76,765,104,338
2020-04-16,17,3,5,14,FR_NOR_76,782,109,352
2020-04-17,18,5,4,21,FR_NOR_76,800,113,373
2020-04-18,28,2,2,26,FR_NOR_76,828,115,399
2020-04-19,16,5,5,15,FR_NOR_76,844,120,414
2020-04-20,13,3,0,3,FR_NOR_76,857,120,417
2020-04-21,14,1,6,22,FR_NOR_76,871,126,439
2020-04-22,14,2,2,16,FR_NOR_76,885,128,455
2020-04-23,11,1,3,17,FR_NOR_76,896,131,472
2020-04-24,30,0,3,28,FR_NOR_76,926,134,500
2020-04-25,5,1,1,7,FR_NOR_76,931,135,507
2020-04-26,6,3,5,11,FR_NOR_76,937,140,518
2020-04-27,3,2,2,4,FR_NOR_76,940,142,522
2020-04-28,27,4,6,16,FR_NOR_76,967,148,538
2020-04-29,3,0,5,20,FR_NOR_76,970,153,558
2020-04-30,7,0,2,2,FR_NOR_76,977,155,560
2020-05-01,4,0,1,14,FR_NOR_76,981,156,574
2020-05-02,1,0,1,2,FR_NOR_76,982,157,576
2020-05-03,0,0,0,0,FR_NOR_76,982,157,576
2020-05-04,5,1,1,7,FR_NOR_76,987,158,583
2020-05-05,4,1,2,6,FR_NOR_76,991,160,589
2020-05-06,1,1,0,10,FR_NOR_76,992,160,599
2020-05-07,2,0,1,7,FR_NOR_76,994,161,606
2020-05-08,8,1,1,15,FR_NOR_76,1002,162,621
2020-05-09,3,0,0,1,FR_NOR_76,1005,162,622
2020-05-10,3,0,0,2,FR_NOR_76,1008,162,624
2020-05-11,7,0,2,3,FR_NOR_76,1015,164,627
2020-05-12,2,1,0,4,FR_NOR_76,1017,164,631
2020-05-13,2,0,2,5,FR_NOR_76,1019,166,636
2020-05-14,4,1,0,3,FR_NOR_76,1023,166,639
2020-05-15,4,2,2,4,FR_NOR_76,1027,168,643
2020-05-16,4,0,1,5,FR_NOR_76,1031,169,648
2020-05-17,3,0,0,1,FR_NOR_76,1034,169,649
2020-05-18,5,1,1,3,FR_NOR_76,1039,170,652
2020-05-19,7,1,5,4,FR_NOR_76,1046,175,656
2020-05-20,6,0,1,8,FR_NOR_76,1052,176,664
2020-05-21,1,0,0,9,FR_NOR_76,1053,176,673
2020-05-22,1,2,0,1,FR_NOR_76,1054,176,674
2020-05-23,2,0,0,1,FR_NOR_76,1056,176,675
2020-05-24,2,0,0,2,FR_NOR_76,1058,176,677
2020-05-25,4,2,0,1,FR_NOR_76,1062,176,678
2020-05-26,2,0,0,9,FR_NOR_76,1064,176,687
2020-05-27,0,0,1,6,FR_NOR_76,1064,177,693
2020-05-28,1,1,0,6,FR_NOR_76,1065,177,699
2020-05-29,1,0,1,8,FR_NOR_76,1066,178,707
2020-05-30,0,0,0,3,FR_NOR_76,1066,178,710
2020-05-31,0,0,0,0,FR_NOR_76,1066,178,710
2020-06-01,1,0,0,0,FR_NOR_76,1067,178,710
2020-06-02,3,1,0,5,FR_NOR_76,1070,178,715
2020-06-03,1,0,1,3,FR_NOR_76,1071,179,718
2020-06-04,0,0,0,1,FR_NOR_76,1071,179,719
2020-06-05,0,0,0,0,FR_NOR_76,1071,179,719
2020-06-06,0,0,0,1,FR_NOR_76,1071,179,720
2020-06-07,0,0,0,1,FR_NOR_76,1071,179,721
2020-06-08,0,0,1,0,FR_NOR_76,1071,180,721
2020-06-09,0,0,0,5,FR_NOR_76,1071,180,726
2020-06-10,0,0,0,1,FR_NOR_76,1071,180,727
2020-06-11,0,0,0,0,FR_NOR_76,1071,180,727
2020-06-12,0,0,0,0,FR_NOR_76,1071,180,727
2020-06-13,0,0,0,0,FR_NOR_76,1071,180,727
2020-06-14,0,0,0,0,FR_NOR_76,1071,180,727
2020-06-15,0,0,0,0,FR_NOR_76,1071,180,727
2020-06-16,2,0,1,1,FR_NOR_76,1073,181,728
2020-06-17,2,0,0,3,FR_NOR_76,1075,181,731
2020-06-18,1,0,0,1,FR_NOR_76,1076,181,732
2020-06-19,0,0,0,0,FR_NOR_76,1076,181,732
2020-06-20,5,1,0,2,FR_NOR_76,1081,181,734
2020-06-21,0,0,0,0,FR_NOR_76,1081,181,734
2020-06-22,0,0,1,4,FR_NOR_76,1081,182,738
2020-06-23,0,0,0,0,FR_NOR_76,1081,182,738
2020-06-24,1,0,0,0,FR_NOR_76,1082,182,738
2020-03-19,44,13,1,9,FR_IDF_77,44,1,9
2020-03-20,30,10,1,2,FR_IDF_77,74,2,11
2020-03-21,31,9,3,2,FR_IDF_77,105,5,13
2020-03-22,37,9,0,3,FR_IDF_77,142,5,16
2020-03-23,42,16,0,14,FR_IDF_77,184,5,30
2020-03-24,49,19,8,17,FR_IDF_77,233,13,47
2020-03-25,68,21,4,13,FR_IDF_77,301,17,60
2020-03-26,76,28,5,16,FR_IDF_77,377,22,76
2020-03-27,84,24,2,24,FR_IDF_77,461,24,100
2020-03-28,98,15,10,17,FR_IDF_77,559,34,117
2020-03-29,53,7,2,15,FR_IDF_77,612,36,132
2020-03-30,85,27,12,21,FR_IDF_77,697,48,153
2020-03-31,130,26,18,42,FR_IDF_77,827,66,195
2020-04-01,114,25,18,60,FR_IDF_77,941,84,255
2020-04-02,112,28,14,45,FR_IDF_77,1053,98,300
2020-04-03,132,23,12,45,FR_IDF_77,1185,110,345
2020-04-04,68,18,14,71,FR_IDF_77,1253,124,416
2020-04-05,56,9,5,15,FR_IDF_77,1309,129,431
2020-04-06,64,18,23,55,FR_IDF_77,1373,152,486
2020-04-07,115,19,12,60,FR_IDF_77,1488,164,546
2020-04-08,94,18,18,88,FR_IDF_77,1582,182,634
2020-04-09,132,13,20,95,FR_IDF_77,1714,202,729
2020-04-10,107,16,16,62,FR_IDF_77,1821,218,791
2020-04-11,62,5,10,32,FR_IDF_77,1883,228,823
2020-04-12,45,7,7,24,FR_IDF_77,1928,235,847
2020-04-13,46,7,10,21,FR_IDF_77,1974,245,868
2020-04-14,80,14,29,48,FR_IDF_77,2054,274,916
2020-04-15,100,7,18,73,FR_IDF_77,2154,292,989
2020-04-16,116,10,20,82,FR_IDF_77,2270,312,1071
2020-04-17,101,10,19,77,FR_IDF_77,2371,331,1148
2020-04-18,73,6,27,127,FR_IDF_77,2444,358,1275
2020-04-19,45,2,11,26,FR_IDF_77,2489,369,1301
2020-04-20,45,6,18,49,FR_IDF_77,2534,387,1350
2020-04-21,57,4,19,64,FR_IDF_77,2591,406,1414
2020-04-22,53,10,21,46,FR_IDF_77,2644,427,1460
2020-04-23,35,5,9,54,FR_IDF_77,2679,436,1514
2020-04-24,62,6,11,52,FR_IDF_77,2741,447,1566
2020-04-25,47,4,4,36,FR_IDF_77,2788,451,1602
2020-04-26,16,5,7,23,FR_IDF_77,2804,458,1625
2020-04-27,21,3,10,17,FR_IDF_77,2825,468,1642
2020-04-28,39,4,13,41,FR_IDF_77,2864,481,1683
2020-04-29,63,5,15,56,FR_IDF_77,2927,496,1739
2020-04-30,45,12,4,35,FR_IDF_77,2972,500,1774
2020-05-01,22,0,6,17,FR_IDF_77,2994,506,1791
2020-05-02,19,4,6,18,FR_IDF_77,3013,512,1809
2020-05-03,4,0,4,8,FR_IDF_77,3017,516,1817
2020-05-04,29,2,17,23,FR_IDF_77,3046,533,1840
2020-05-05,51,3,5,59,FR_IDF_77,3097,538,1899
2020-05-06,50,2,7,37,FR_IDF_77,3147,545,1936
2020-05-07,18,5,10,88,FR_IDF_77,3165,555,2024
2020-05-08,12,3,0,17,FR_IDF_77,3177,555,2041
2020-05-09,32,2,6,18,FR_IDF_77,3209,561,2059
2020-05-10,1,1,1,5,FR_IDF_77,3210,562,2064
2020-05-11,16,0,8,7,FR_IDF_77,3226,570,2071
2020-05-12,37,3,5,36,FR_IDF_77,3263,575,2107
2020-05-13,21,3,1,29,FR_IDF_77,3284,576,2136
2020-05-14,20,3,7,22,FR_IDF_77,3304,583,2158
2020-05-15,10,1,8,21,FR_IDF_77,3314,591,2179
2020-05-16,23,2,0,30,FR_IDF_77,3337,591,2209
2020-05-17,7,1,1,15,FR_IDF_77,3344,592,2224
2020-05-18,6,1,4,14,FR_IDF_77,3350,596,2238
2020-05-19,6,1,6,14,FR_IDF_77,3356,602,2252
2020-05-20,26,2,3,26,FR_IDF_77,3382,605,2278
2020-05-21,13,0,6,20,FR_IDF_77,3395,611,2298
2020-05-22,3,0,0,1,FR_IDF_77,3398,611,2299
2020-05-23,8,1,2,17,FR_IDF_77,3406,613,2316
2020-05-24,2,1,2,6,FR_IDF_77,3408,615,2322
2020-05-25,28,2,10,12,FR_IDF_77,3436,625,2334
2020-05-26,16,0,9,16,FR_IDF_77,3452,634,2350
2020-05-27,10,1,5,22,FR_IDF_77,3462,639,2372
2020-05-28,12,1,2,19,FR_IDF_77,3474,641,2391
2020-05-29,18,1,2,27,FR_IDF_77,3492,643,2418
2020-05-30,18,2,5,24,FR_IDF_77,3510,648,2442
2020-05-31,0,0,0,1,FR_IDF_77,3510,648,2443
2020-06-01,2,0,2,1,FR_IDF_77,3512,650,2444
2020-06-02,16,6,5,8,FR_IDF_77,3528,655,2452
2020-06-03,16,2,6,13,FR_IDF_77,3544,661,2465
2020-06-04,17,2,1,15,FR_IDF_77,3561,662,2480
2020-06-05,13,2,0,14,FR_IDF_77,3574,662,2494
2020-06-06,9,2,4,17,FR_IDF_77,3583,666,2511
2020-06-07,2,0,2,0,FR_IDF_77,3585,668,2511
2020-06-08,2,2,5,12,FR_IDF_77,3587,673,2523
2020-06-09,1,0,2,1,FR_IDF_77,3588,675,2524
2020-06-10,6,3,4,23,FR_IDF_77,3594,679,2547
2020-06-11,5,2,1,8,FR_IDF_77,3599,680,2555
2020-06-12,5,1,2,19,FR_IDF_77,3604,682,2574
2020-06-13,0,0,0,4,FR_IDF_77,3604,682,2578
2020-06-14,0,0,0,3,FR_IDF_77,3604,682,2581
2020-06-15,0,1,0,3,FR_IDF_77,3604,682,2584
2020-06-16,12,0,2,15,FR_IDF_77,3616,684,2599
2020-06-17,1,0,1,5,FR_IDF_77,3617,685,2604
2020-06-18,2,2,0,6,FR_IDF_77,3619,685,2610
2020-06-19,4,0,2,19,FR_IDF_77,3623,687,2629
2020-06-20,0,0,1,7,FR_IDF_77,3623,688,2636
2020-06-21,0,0,0,0,FR_IDF_77,3623,688,2636
2020-06-22,7,3,1,0,FR_IDF_77,3630,689,2636
2020-06-23,7,1,2,7,FR_IDF_77,3637,691,2643
2020-06-24,3,0,0,11,FR_IDF_77,3640,691,2654
2020-03-19,54,7,2,3,FR_IDF_78,54,2,3
2020-03-20,32,6,5,9,FR_IDF_78,86,7,12
2020-03-21,57,10,2,14,FR_IDF_78,143,9,26
2020-03-22,37,3,0,4,FR_IDF_78,180,9,30
2020-03-23,34,9,3,7,FR_IDF_78,214,12,37
2020-03-24,98,23,8,19,FR_IDF_78,312,20,56
2020-03-25,81,17,12,28,FR_IDF_78,393,32,84
2020-03-26,110,16,6,26,FR_IDF_78,503,38,110
2020-03-27,74,10,10,23,FR_IDF_78,577,48,133
2020-03-28,101,18,8,35,FR_IDF_78,678,56,168
2020-03-29,74,9,8,18,FR_IDF_78,752,64,186
2020-03-30,98,18,11,45,FR_IDF_78,850,75,231
2020-03-31,192,22,19,59,FR_IDF_78,1042,94,290
2020-04-01,191,20,21,63,FR_IDF_78,1233,115,353
2020-04-02,100,15,18,48,FR_IDF_78,1333,133,401
2020-04-03,86,16,18,42,FR_IDF_78,1419,151,443
2020-04-04,91,11,13,18,FR_IDF_78,1510,164,461
2020-04-05,24,0,7,17,FR_IDF_78,1534,171,478
2020-04-06,126,8,20,44,FR_IDF_78,1660,191,522
2020-04-07,86,10,14,38,FR_IDF_78,1746,205,560
2020-04-08,96,11,10,47,FR_IDF_78,1842,215,607
2020-04-09,54,5,16,50,FR_IDF_78,1896,231,657
2020-04-10,61,12,15,39,FR_IDF_78,1957,246,696
2020-04-11,66,3,9,40,FR_IDF_78,2023,255,736
2020-04-12,33,5,10,17,FR_IDF_78,2056,265,753
2020-04-13,49,1,9,36,FR_IDF_78,2105,274,789
2020-04-14,41,4,17,42,FR_IDF_78,2146,291,831
2020-04-15,70,2,14,72,FR_IDF_78,2216,305,903
2020-04-16,56,3,11,65,FR_IDF_78,2272,316,968
2020-04-17,46,2,11,47,FR_IDF_78,2318,327,1015
2020-04-18,32,5,6,109,FR_IDF_78,2350,333,1124
2020-04-19,21,3,0,9,FR_IDF_78,2371,333,1133
2020-04-20,57,5,23,30,FR_IDF_78,2428,356,1163
2020-04-21,40,9,14,40,FR_IDF_78,2468,370,1203
2020-04-22,45,0,7,34,FR_IDF_78,2513,377,1237
2020-04-23,18,4,9,41,FR_IDF_78,2531,386,1278
2020-04-24,52,4,12,42,FR_IDF_78,2583,398,1320
2020-04-25,21,2,2,30,FR_IDF_78,2604,400,1350
2020-04-26,15,4,1,6,FR_IDF_78,2619,401,1356
2020-04-27,16,2,7,14,FR_IDF_78,2635,408,1370
2020-04-28,59,2,14,32,FR_IDF_78,2694,422,1402
2020-04-29,19,0,3,21,FR_IDF_78,2713,425,1423
2020-04-30,30,2,3,50,FR_IDF_78,2743,428,1473
2020-05-01,19,1,3,24,FR_IDF_78,2762,431,1497
2020-05-02,21,1,1,10,FR_IDF_78,2783,432,1507
2020-05-03,6,2,1,2,FR_IDF_78,2789,433,1509
2020-05-04,13,0,5,11,FR_IDF_78,2802,438,1520
2020-05-05,12,1,5,36,FR_IDF_78,2814,443,1556
2020-05-06,16,0,2,13,FR_IDF_78,2830,445,1569
2020-05-07,14,1,3,24,FR_IDF_78,2844,448,1593
2020-05-08,7,1,1,11,FR_IDF_78,2851,449,1604
2020-05-09,5,1,0,10,FR_IDF_78,2856,449,1614
2020-05-10,6,0,0,7,FR_IDF_78,2862,449,1621
2020-05-11,9,1,7,19,FR_IDF_78,2871,456,1640
2020-05-12,27,1,3,50,FR_IDF_78,2898,459,1690
2020-05-13,13,1,1,25,FR_IDF_78,2911,460,1715
2020-05-14,18,0,2,24,FR_IDF_78,2929,462,1739
2020-05-15,16,0,2,34,FR_IDF_78,2945,464,1773
2020-05-16,5,0,2,26,FR_IDF_78,2950,466,1799
2020-05-17,2,0,1,0,FR_IDF_78,2952,467,1799
2020-05-18,10,0,2,6,FR_IDF_78,2962,469,1805
2020-05-19,34,1,3,25,FR_IDF_78,2996,472,1830
2020-05-20,14,2,3,16,FR_IDF_78,3010,475,1846
2020-05-21,8,0,1,1,FR_IDF_78,3018,476,1847
2020-05-22,7,0,3,25,FR_IDF_78,3025,479,1872
2020-05-23,4,0,1,3,FR_IDF_78,3029,480,1875
2020-05-24,0,0,0,0,FR_IDF_78,3029,480,1875
2020-05-25,2,2,2,20,FR_IDF_78,3031,482,1895
2020-05-26,18,2,8,8,FR_IDF_78,3049,490,1903
2020-05-27,8,0,2,9,FR_IDF_78,3057,492,1912
2020-05-28,10,1,1,18,FR_IDF_78,3067,493,1930
2020-05-29,2,0,3,7,FR_IDF_78,3069,496,1937
2020-05-30,1,0,1,3,FR_IDF_78,3070,497,1940
2020-05-31,0,0,1,2,FR_IDF_78,3070,498,1942
2020-06-01,0,0,0,1,FR_IDF_78,3070,498,1943
2020-06-02,8,1,2,7,FR_IDF_78,3078,500,1950
2020-06-03,6,0,1,35,FR_IDF_78,3084,501,1985
2020-06-04,2,0,1,16,FR_IDF_78,3086,502,2001
2020-06-05,1,0,0,14,FR_IDF_78,3087,502,2015
2020-06-06,10,0,4,15,FR_IDF_78,3097,506,2030
2020-06-07,0,0,0,0,FR_IDF_78,3097,506,2030
2020-06-08,7,0,2,6,FR_IDF_78,3104,508,2036
2020-06-09,2,1,3,15,FR_IDF_78,3106,511,2051
2020-06-10,1,0,0,3,FR_IDF_78,3107,511,2054
2020-06-11,7,0,1,11,FR_IDF_78,3114,512,2065
2020-06-12,0,0,0,7,FR_IDF_78,3114,512,2072
2020-06-13,4,0,1,2,FR_IDF_78,3118,513,2074
2020-06-14,0,0,0,0,FR_IDF_78,3118,513,2074
2020-06-15,0,0,0,4,FR_IDF_78,3118,513,2078
2020-06-16,0,0,1,4,FR_IDF_78,3118,514,2082
2020-06-17,3,0,1,1,FR_IDF_78,3121,515,2083
2020-06-18,1,0,0,3,FR_IDF_78,3122,515,2086
2020-06-19,0,0,0,4,FR_IDF_78,3122,515,2090
2020-06-20,1,0,0,1,FR_IDF_78,3123,515,2091
2020-06-21,6,0,2,13,FR_IDF_78,3129,517,2104
2020-06-22,14,0,1,26,FR_IDF_78,3143,518,2130
2020-06-23,5,1,2,24,FR_IDF_78,3148,520,2154
2020-06-24,6,0,0,4,FR_IDF_78,3154,520,2158
2020-03-19,4,1,0,1,FR_NAQ_79,4,0,1
2020-03-20,8,0,0,5,FR_NAQ_79,12,0,6
2020-03-21,3,0,0,1,FR_NAQ_79,15,0,7
2020-03-22,4,0,1,2,FR_NAQ_79,19,1,9
2020-03-23,1,0,0,1,FR_NAQ_79,20,1,10
2020-03-24,1,0,0,0,FR_NAQ_79,21,1,10
2020-03-25,3,0,0,1,FR_NAQ_79,24,1,11
2020-03-26,4,0,0,0,FR_NAQ_79,28,1,11
2020-03-27,2,0,1,0,FR_NAQ_79,30,2,11
2020-03-28,2,0,0,1,FR_NAQ_79,32,2,12
2020-03-29,6,3,0,1,FR_NAQ_79,38,2,13
2020-03-30,4,0,0,4,FR_NAQ_79,42,2,17
2020-03-31,4,2,0,1,FR_NAQ_79,46,2,18
2020-04-01,6,0,0,3,FR_NAQ_79,52,2,21
2020-04-02,4,0,3,5,FR_NAQ_79,56,5,26
2020-04-03,2,1,1,2,FR_NAQ_79,58,6,28
2020-04-04,1,0,2,2,FR_NAQ_79,59,8,30
2020-04-05,2,0,0,0,FR_NAQ_79,61,8,30
2020-04-06,3,1,0,1,FR_NAQ_79,64,8,31
2020-04-07,7,0,0,3,FR_NAQ_79,71,8,34
2020-04-08,5,1,1,3,FR_NAQ_79,76,9,37
2020-04-09,4,1,0,1,FR_NAQ_79,80,9,38
2020-04-10,3,2,0,2,FR_NAQ_79,83,9,40
2020-04-11,1,0,0,1,FR_NAQ_79,84,9,41
2020-04-12,1,0,1,3,FR_NAQ_79,85,10,44
2020-04-13,2,2,0,0,FR_NAQ_79,87,10,44
2020-04-14,2,0,0,1,FR_NAQ_79,89,10,45
2020-04-15,3,0,2,4,FR_NAQ_79,92,12,49
2020-04-16,2,0,0,1,FR_NAQ_79,94,12,50
2020-04-17,2,0,0,1,FR_NAQ_79,96,12,51
2020-04-18,1,0,0,0,FR_NAQ_79,97,12,51
2020-04-19,0,0,1,0,FR_NAQ_79,97,13,51
2020-04-20,0,0,0,0,FR_NAQ_79,97,13,51
2020-04-21,1,0,1,2,FR_NAQ_79,98,14,53
2020-04-22,1,0,0,3,FR_NAQ_79,99,14,56
2020-04-23,0,1,0,2,FR_NAQ_79,99,14,58
2020-04-24,0,0,0,1,FR_NAQ_79,99,14,59
2020-04-25,2,0,0,0,FR_NAQ_79,101,14,59
2020-04-26,2,1,0,0,FR_NAQ_79,103,14,59
2020-04-27,1,0,1,1,FR_NAQ_79,104,15,60
2020-04-28,1,0,0,0,FR_NAQ_79,105,15,60
2020-04-29,0,0,1,0,FR_NAQ_79,105,16,60
2020-04-30,1,0,1,5,FR_NAQ_79,106,17,65
2020-05-01,0,0,0,2,FR_NAQ_79,106,17,67
2020-05-02,1,0,2,0,FR_NAQ_79,107,19,67
2020-05-03,0,0,0,0,FR_NAQ_79,107,19,67
2020-05-04,0,0,0,0,FR_NAQ_79,107,19,67
2020-05-05,1,0,0,0,FR_NAQ_79,108,19,67
2020-05-06,0,0,0,1,FR_NAQ_79,108,19,68
2020-05-07,0,0,0,2,FR_NAQ_79,108,19,70
2020-05-08,0,0,0,0,FR_NAQ_79,108,19,70
2020-05-09,0,0,0,1,FR_NAQ_79,108,19,71
2020-05-10,0,0,0,0,FR_NAQ_79,108,19,71
2020-05-11,1,0,0,0,FR_NAQ_79,109,19,71
2020-05-12,0,0,0,1,FR_NAQ_79,109,19,72
2020-05-13,0,0,0,2,FR_NAQ_79,109,19,74
2020-05-14,1,0,0,1,FR_NAQ_79,110,19,75
2020-05-15,0,0,0,0,FR_NAQ_79,110,19,75
2020-05-16,0,0,0,1,FR_NAQ_79,110,19,76
2020-05-17,1,0,1,0,FR_NAQ_79,111,20,76
2020-05-18,0,0,0,0,FR_NAQ_79,111,20,76
2020-05-19,0,0,0,0,FR_NAQ_79,111,20,76
2020-05-20,0,0,0,0,FR_NAQ_79,111,20,76
2020-05-21,1,0,0,0,FR_NAQ_79,112,20,76
2020-05-22,1,0,0,0,FR_NAQ_79,113,20,76
2020-05-23,0,0,0,0,FR_NAQ_79,113,20,76
2020-05-24,1,0,0,0,FR_NAQ_79,114,20,76
2020-05-25,0,0,0,0,FR_NAQ_79,114,20,76
2020-05-26,0,0,0,1,FR_NAQ_79,114,20,77
2020-05-27,0,0,0,1,FR_NAQ_79,114,20,78
2020-05-28,0,0,0,1,FR_NAQ_79,114,20,79
2020-05-29,0,0,0,2,FR_NAQ_79,114,20,81
2020-05-30,0,0,0,0,FR_NAQ_79,114,20,81
2020-05-31,1,0,1,0,FR_NAQ_79,115,21,81
2020-06-01,0,0,0,0,FR_NAQ_79,115,21,81
2020-06-02,0,0,0,3,FR_NAQ_79,115,21,84
2020-06-03,0,0,0,0,FR_NAQ_79,115,21,84
2020-06-04,0,0,0,0,FR_NAQ_79,115,21,84
2020-06-05,0,0,0,1,FR_NAQ_79,115,21,85
2020-06-06,0,0,0,0,FR_NAQ_79,115,21,85
2020-06-07,0,0,0,0,FR_NAQ_79,115,21,85
2020-06-08,1,0,0,0,FR_NAQ_79,116,21,85
2020-06-09,0,0,0,0,FR_NAQ_79,116,21,85
2020-06-10,0,0,0,0,FR_NAQ_79,116,21,85
2020-06-11,0,0,0,0,FR_NAQ_79,116,21,85
2020-06-12,0,0,0,0,FR_NAQ_79,116,21,85
2020-06-13,0,0,0,1,FR_NAQ_79,116,21,86
2020-06-14,0,0,0,0,FR_NAQ_79,116,21,86
2020-06-15,0,0,0,0,FR_NAQ_79,116,21,86
2020-06-16,0,0,0,0,FR_NAQ_79,116,21,86
2020-06-17,0,0,0,0,FR_NAQ_79,116,21,86
2020-06-18,0,0,0,0,FR_NAQ_79,116,21,86
2020-06-19,0,0,0,0,FR_NAQ_79,116,21,86
2020-06-20,0,0,0,0,FR_NAQ_79,116,21,86
2020-06-21,0,0,0,0,FR_NAQ_79,116,21,86
2020-06-22,0,0,0,0,FR_NAQ_79,116,21,86
2020-06-23,0,0,0,0,FR_NAQ_79,116,21,86
2020-06-24,0,0,0,0,FR_NAQ_79,116,21,86
2020-03-19,29,7,1,3,FR_HDF_80,29,1,3
2020-03-20,26,8,1,4,FR_HDF_80,55,2,7
2020-03-21,29,5,5,5,FR_HDF_80,84,7,12
2020-03-22,18,4,0,0,FR_HDF_80,102,7,12
2020-03-23,14,2,1,1,FR_HDF_80,116,8,13
2020-03-24,24,3,4,6,FR_HDF_80,140,12,19
2020-03-25,34,4,3,11,FR_HDF_80,174,15,30
2020-03-26,19,6,4,8,FR_HDF_80,193,19,38
2020-03-27,17,1,2,6,FR_HDF_80,210,21,44
2020-03-28,57,7,4,15,FR_HDF_80,267,25,59
2020-03-29,35,5,5,9,FR_HDF_80,302,30,68
2020-03-30,28,9,5,8,FR_HDF_80,330,35,76
2020-03-31,47,9,9,25,FR_HDF_80,377,44,101
2020-04-01,24,3,3,3,FR_HDF_80,401,47,104
2020-04-02,32,4,1,9,FR_HDF_80,433,48,113
2020-04-03,58,4,6,13,FR_HDF_80,491,54,126
2020-04-04,60,10,14,34,FR_HDF_80,551,68,160
2020-04-05,24,5,8,1,FR_HDF_80,575,76,161
2020-04-06,29,3,13,2,FR_HDF_80,604,89,163
2020-04-07,22,5,6,29,FR_HDF_80,626,95,192
2020-04-08,25,4,6,17,FR_HDF_80,651,101,209
2020-04-09,24,6,3,9,FR_HDF_80,675,104,218
2020-04-10,23,2,6,23,FR_HDF_80,698,110,241
2020-04-11,42,6,8,40,FR_HDF_80,740,118,281
2020-04-12,12,0,4,11,FR_HDF_80,752,122,292
2020-04-13,21,2,4,4,FR_HDF_80,773,126,296
2020-04-14,23,4,3,14,FR_HDF_80,796,129,310
2020-04-15,13,2,5,17,FR_HDF_80,809,134,327
2020-04-16,16,1,2,15,FR_HDF_80,825,136,342
2020-04-17,29,0,3,26,FR_HDF_80,854,139,368
2020-04-18,10,2,6,8,FR_HDF_80,864,145,376
2020-04-19,12,1,3,4,FR_HDF_80,876,148,380
2020-04-20,7,0,3,10,FR_HDF_80,883,151,390
2020-04-21,11,1,1,25,FR_HDF_80,894,152,415
2020-04-22,29,2,7,19,FR_HDF_80,923,159,434
2020-04-23,16,2,2,16,FR_HDF_80,939,161,450
2020-04-24,10,2,3,24,FR_HDF_80,949,164,474
2020-04-25,15,2,2,11,FR_HDF_80,964,166,485
2020-04-26,7,4,2,0,FR_HDF_80,971,168,485
2020-04-27,9,0,4,2,FR_HDF_80,980,172,487
2020-04-28,9,0,3,17,FR_HDF_80,989,175,504
2020-04-29,3,1,0,17,FR_HDF_80,992,175,521
2020-04-30,7,1,2,8,FR_HDF_80,999,177,529
2020-05-01,3,1,1,12,FR_HDF_80,1002,178,541
2020-05-02,2,0,1,6,FR_HDF_80,1004,179,547
2020-05-03,3,0,3,1,FR_HDF_80,1007,182,548
2020-05-04,3,0,1,5,FR_HDF_80,1010,183,553
2020-05-05,11,0,3,11,FR_HDF_80,1021,186,564
2020-05-06,8,2,1,10,FR_HDF_80,1029,187,574
2020-05-07,3,3,5,11,FR_HDF_80,1032,192,585
2020-05-08,4,0,1,2,FR_HDF_80,1036,193,587
2020-05-09,2,0,1,6,FR_HDF_80,1038,194,593
2020-05-10,1,1,2,1,FR_HDF_80,1039,196,594
2020-05-11,6,2,3,6,FR_HDF_80,1045,199,600
2020-05-12,2,3,0,8,FR_HDF_80,1047,199,608
2020-05-13,1,0,2,3,FR_HDF_80,1048,201,611
2020-05-14,3,1,1,15,FR_HDF_80,1051,202,626
2020-05-15,1,0,0,7,FR_HDF_80,1052,202,633
2020-05-16,7,2,1,6,FR_HDF_80,1059,203,639
2020-05-17,0,0,2,2,FR_HDF_80,1059,205,641
2020-05-18,0,0,1,7,FR_HDF_80,1059,206,648
2020-05-19,1,1,1,8,FR_HDF_80,1060,207,656
2020-05-20,0,0,2,8,FR_HDF_80,1060,209,664
2020-05-21,0,0,0,10,FR_HDF_80,1060,209,674
2020-05-22,1,0,0,0,FR_HDF_80,1061,209,674
2020-05-23,2,0,0,1,FR_HDF_80,1063,209,675
2020-05-24,0,0,0,0,FR_HDF_80,1063,209,675
2020-05-25,3,1,4,7,FR_HDF_80,1066,213,682
2020-05-26,0,0,0,12,FR_HDF_80,1066,213,694
2020-05-27,0,0,1,1,FR_HDF_80,1066,214,695
2020-05-28,0,0,2,0,FR_HDF_80,1066,216,695
2020-05-29,2,0,0,4,FR_HDF_80,1068,216,699
2020-05-30,1,1,0,1,FR_HDF_80,1069,216,700
2020-05-31,1,0,2,4,FR_HDF_80,1070,218,704
2020-06-01,0,0,0,0,FR_HDF_80,1070,218,704
2020-06-02,0,0,0,1,FR_HDF_80,1070,218,705
2020-06-03,2,0,1,1,FR_HDF_80,1072,219,706
2020-06-04,1,0,0,1,FR_HDF_80,1073,219,707
2020-06-05,0,0,0,6,FR_HDF_80,1073,219,713
2020-06-06,0,0,0,2,FR_HDF_80,1073,219,715
2020-06-07,0,0,0,0,FR_HDF_80,1073,219,715
2020-06-08,0,0,0,3,FR_HDF_80,1073,219,718
2020-06-09,2,0,0,1,FR_HDF_80,1075,219,719
2020-06-10,1,0,1,11,FR_HDF_80,1076,220,730
2020-06-11,1,0,0,1,FR_HDF_80,1077,220,731
2020-06-12,0,2,0,3,FR_HDF_80,1077,220,734
2020-06-13,0,0,0,7,FR_HDF_80,1077,220,741
2020-06-14,0,0,0,0,FR_HDF_80,1077,220,741
2020-06-15,1,0,0,3,FR_HDF_80,1078,220,744
2020-06-16,0,0,1,3,FR_HDF_80,1078,221,747
2020-06-17,0,0,1,0,FR_HDF_80,1078,222,747
2020-06-18,0,0,1,0,FR_HDF_80,1078,223,747
2020-06-19,0,0,0,2,FR_HDF_80,1078,223,749
2020-06-20,0,0,0,0,FR_HDF_80,1078,223,749
2020-06-21,0,0,0,0,FR_HDF_80,1078,223,749
2020-06-22,0,0,0,1,FR_HDF_80,1078,223,750
2020-06-23,1,0,0,0,FR_HDF_80,1079,223,750
2020-06-24,0,0,0,0,FR_HDF_80,1079,223,750
2020-03-19,2,1,0,0,FR_OCC_81,2,0,0
2020-03-20,3,0,0,2,FR_OCC_81,5,0,2
2020-03-21,1,0,1,0,FR_OCC_81,6,1,2
2020-03-22,2,0,0,1,FR_OCC_81,8,1,3
2020-03-23,0,2,0,0,FR_OCC_81,8,1,3
2020-03-24,1,0,0,0,FR_OCC_81,9,1,3
2020-03-25,8,4,0,1,FR_OCC_81,17,1,4
2020-03-26,10,3,0,3,FR_OCC_81,27,1,7
2020-03-27,4,2,0,2,FR_OCC_81,31,1,9
2020-03-28,5,2,0,0,FR_OCC_81,36,1,9
2020-03-29,7,4,0,0,FR_OCC_81,43,1,9
2020-03-30,5,1,1,3,FR_OCC_81,48,2,12
2020-03-31,5,0,0,1,FR_OCC_81,53,2,13
2020-04-01,11,3,1,1,FR_OCC_81,64,3,14
2020-04-02,10,5,0,5,FR_OCC_81,74,3,19
2020-04-03,4,0,0,1,FR_OCC_81,78,3,20
2020-04-04,2,1,0,1,FR_OCC_81,80,3,21
2020-04-05,3,2,1,2,FR_OCC_81,83,4,23
2020-04-06,3,2,1,7,FR_OCC_81,86,5,30
2020-04-07,10,4,0,7,FR_OCC_81,96,5,37
2020-04-08,3,1,1,2,FR_OCC_81,99,6,39
2020-04-09,4,1,1,7,FR_OCC_81,103,7,46
2020-04-10,2,1,2,6,FR_OCC_81,105,9,52
2020-04-11,2,0,1,4,FR_OCC_81,107,10,56
2020-04-12,2,0,0,0,FR_OCC_81,109,10,56
2020-04-13,3,1,1,1,FR_OCC_81,112,11,57
2020-04-14,3,1,2,2,FR_OCC_81,115,13,59
2020-04-15,3,0,1,4,FR_OCC_81,118,14,63
2020-04-16,2,0,1,0,FR_OCC_81,120,15,63
2020-04-17,1,0,0,0,FR_OCC_81,121,15,63
2020-04-18,2,0,0,2,FR_OCC_81,123,15,65
2020-04-19,0,0,0,0,FR_OCC_81,123,15,65
2020-04-20,0,0,2,2,FR_OCC_81,123,17,67
2020-04-21,0,1,0,2,FR_OCC_81,123,17,69
2020-04-22,1,0,0,1,FR_OCC_81,124,17,70
2020-04-23,0,0,0,1,FR_OCC_81,124,17,71
2020-04-24,2,0,1,2,FR_OCC_81,126,18,73
2020-04-25,1,0,0,0,FR_OCC_81,127,18,73
2020-04-26,0,0,0,0,FR_OCC_81,127,18,73
2020-04-27,4,0,1,2,FR_OCC_81,131,19,75
2020-04-28,3,1,0,2,FR_OCC_81,134,19,77
2020-04-29,1,0,0,1,FR_OCC_81,135,19,78
2020-04-30,6,0,0,0,FR_OCC_81,141,19,78
2020-05-01,0,1,0,9,FR_OCC_81,141,19,87
2020-05-02,1,0,1,0,FR_OCC_81,142,20,87
2020-05-03,0,0,0,0,FR_OCC_81,142,20,87
2020-05-04,0,0,0,1,FR_OCC_81,142,20,88
2020-05-05,0,0,1,2,FR_OCC_81,142,21,90
2020-05-06,1,0,0,8,FR_OCC_81,143,21,98
2020-05-07,0,0,0,1,FR_OCC_81,143,21,99
2020-05-08,0,0,0,0,FR_OCC_81,143,21,99
2020-05-09,3,0,0,0,FR_OCC_81,146,21,99
2020-05-10,1,0,0,1,FR_OCC_81,147,21,100
2020-05-11,0,0,0,1,FR_OCC_81,147,21,101
2020-05-12,5,0,1,1,FR_OCC_81,152,22,102
2020-05-13,1,0,0,1,FR_OCC_81,153,22,103
2020-05-14,0,0,0,3,FR_OCC_81,153,22,106
2020-05-15,0,0,0,2,FR_OCC_81,153,22,108
2020-05-16,0,0,0,0,FR_OCC_81,153,22,108
2020-05-17,0,0,0,1,FR_OCC_81,153,22,109
2020-05-18,0,0,0,0,FR_OCC_81,153,22,109
2020-05-19,0,0,0,0,FR_OCC_81,153,22,109
2020-05-20,0,0,0,0,FR_OCC_81,153,22,109
2020-05-21,0,0,0,1,FR_OCC_81,153,22,110
2020-05-22,0,0,0,0,FR_OCC_81,153,22,110
2020-05-23,1,0,0,1,FR_OCC_81,154,22,111
2020-05-24,0,0,0,0,FR_OCC_81,154,22,111
2020-05-25,0,0,0,0,FR_OCC_81,154,22,111
2020-05-26,0,0,0,6,FR_OCC_81,154,22,117
2020-05-27,0,0,0,2,FR_OCC_81,154,22,119
2020-05-28,0,0,0,0,FR_OCC_81,154,22,119
2020-05-29,0,0,0,1,FR_OCC_81,154,22,120
2020-05-30,0,0,0,0,FR_OCC_81,154,22,120
2020-05-31,0,0,0,0,FR_OCC_81,154,22,120
2020-06-01,0,0,0,0,FR_OCC_81,154,22,120
2020-06-02,0,0,0,1,FR_OCC_81,154,22,121
2020-06-03,0,0,0,2,FR_OCC_81,154,22,123
2020-06-04,0,0,0,4,FR_OCC_81,154,22,127
2020-06-05,0,0,0,0,FR_OCC_81,154,22,127
2020-06-06,0,0,0,0,FR_OCC_81,154,22,127
2020-06-07,0,0,0,0,FR_OCC_81,154,22,127
2020-06-08,0,0,0,0,FR_OCC_81,154,22,127
2020-06-09,0,0,1,0,FR_OCC_81,154,23,127
2020-06-10,1,1,0,0,FR_OCC_81,155,23,127
2020-06-11,0,0,0,0,FR_OCC_81,155,23,127
2020-06-12,0,0,0,0,FR_OCC_81,155,23,127
2020-06-13,0,0,0,0,FR_OCC_81,155,23,127
2020-06-14,0,0,0,0,FR_OCC_81,155,23,127
2020-06-15,0,0,0,0,FR_OCC_81,155,23,127
2020-06-16,0,0,0,0,FR_OCC_81,155,23,127
2020-06-17,0,0,0,0,FR_OCC_81,155,23,127
2020-06-18,0,0,0,2,FR_OCC_81,155,23,129
2020-06-19,0,0,0,0,FR_OCC_81,155,23,129
2020-06-20,0,0,0,0,FR_OCC_81,155,23,129
2020-06-21,0,0,0,0,FR_OCC_81,155,23,129
2020-06-22,0,0,0,0,FR_OCC_81,155,23,129
2020-06-23,0,0,0,0,FR_OCC_81,155,23,129
2020-06-24,0,0,0,0,FR_OCC_81,155,23,129
2020-03-19,0,0,0,0,FR_OCC_82,0,0,0
2020-03-20,0,0,0,0,FR_OCC_82,0,0,0
2020-03-21,2,1,0,0,FR_OCC_82,2,0,0
2020-03-22,1,1,0,0,FR_OCC_82,3,0,0
2020-03-23,0,0,0,1,FR_OCC_82,3,0,1
2020-03-24,1,0,0,1,FR_OCC_82,4,0,2
2020-03-25,0,0,0,0,FR_OCC_82,4,0,2
2020-03-26,0,0,0,0,FR_OCC_82,4,0,2
2020-03-27,1,0,0,0,FR_OCC_82,5,0,2
2020-03-28,0,0,0,0,FR_OCC_82,5,0,2
2020-03-29,0,0,0,0,FR_OCC_82,5,0,2
2020-03-30,4,3,0,1,FR_OCC_82,9,0,3
2020-03-31,2,0,0,0,FR_OCC_82,11,0,3
2020-04-01,4,1,1,0,FR_OCC_82,15,1,3
2020-04-02,0,0,0,0,FR_OCC_82,15,1,3
2020-04-03,2,1,0,0,FR_OCC_82,17,1,3
2020-04-04,0,0,0,0,FR_OCC_82,17,1,3
2020-04-05,6,2,0,3,FR_OCC_82,23,1,6
2020-04-06,2,1,1,0,FR_OCC_82,25,2,6
2020-04-07,0,0,0,0,FR_OCC_82,25,2,6
2020-04-08,2,2,0,0,FR_OCC_82,27,2,6
2020-04-09,2,0,0,2,FR_OCC_82,29,2,8
2020-04-10,2,0,0,3,FR_OCC_82,31,2,11
2020-04-11,1,0,0,2,FR_OCC_82,32,2,13
2020-04-12,0,0,0,0,FR_OCC_82,32,2,13
2020-04-13,0,0,0,0,FR_OCC_82,32,2,13
2020-04-14,2,1,0,2,FR_OCC_82,34,2,15
2020-04-15,4,1,0,2,FR_OCC_82,38,2,17
2020-04-16,2,1,0,4,FR_OCC_82,40,2,21
2020-04-17,3,0,0,5,FR_OCC_82,43,2,26
2020-04-18,0,0,0,0,FR_OCC_82,43,2,26
2020-04-19,1,1,0,0,FR_OCC_82,44,2,26
2020-04-20,2,1,0,1,FR_OCC_82,46,2,27
2020-04-21,0,0,0,0,FR_OCC_82,46,2,27
2020-04-22,0,0,0,0,FR_OCC_82,46,2,27
2020-04-23,0,0,0,2,FR_OCC_82,46,2,29
2020-04-24,0,0,0,1,FR_OCC_82,46,2,30
2020-04-25,0,0,0,0,FR_OCC_82,46,2,30
2020-04-26,0,0,0,0,FR_OCC_82,46,2,30
2020-04-27,4,1,1,1,FR_OCC_82,50,3,31
2020-04-28,0,0,0,0,FR_OCC_82,50,3,31
2020-04-29,0,0,0,1,FR_OCC_82,50,3,32
2020-04-30,0,0,0,0,FR_OCC_82,50,3,32
2020-05-01,0,0,0,0,FR_OCC_82,50,3,32
2020-05-02,0,0,0,0,FR_OCC_82,50,3,32
2020-05-03,0,0,0,0,FR_OCC_82,50,3,32
2020-05-04,0,0,0,0,FR_OCC_82,50,3,32
2020-05-05,1,0,0,1,FR_OCC_82,51,3,33
2020-05-06,0,0,0,0,FR_OCC_82,51,3,33
2020-05-07,0,0,0,0,FR_OCC_82,51,3,33
2020-05-08,0,1,0,3,FR_OCC_82,51,3,36
2020-05-09,0,0,0,0,FR_OCC_82,51,3,36
2020-05-10,0,0,0,0,FR_OCC_82,51,3,36
2020-05-11,0,0,0,0,FR_OCC_82,51,3,36
2020-05-12,0,0,0,1,FR_OCC_82,51,3,37
2020-05-13,1,0,0,0,FR_OCC_82,52,3,37
2020-05-14,0,0,0,0,FR_OCC_82,52,3,37
2020-05-15,0,0,0,0,FR_OCC_82,52,3,37
2020-05-16,0,0,1,0,FR_OCC_82,52,4,37
2020-05-17,0,0,0,0,FR_OCC_82,52,4,37
2020-05-18,0,0,0,0,FR_OCC_82,52,4,37
2020-05-19,0,0,0,0,FR_OCC_82,52,4,37
2020-05-20,0,0,0,0,FR_OCC_82,52,4,37
2020-05-21,1,0,0,0,FR_OCC_82,53,4,37
2020-05-22,0,0,0,0,FR_OCC_82,53,4,37
2020-05-23,0,0,0,1,FR_OCC_82,53,4,38
2020-05-24,1,1,0,0,FR_OCC_82,54,4,38
2020-05-25,0,0,0,0,FR_OCC_82,54,4,38
2020-05-26,0,0,0,0,FR_OCC_82,54,4,38
2020-05-27,1,0,0,1,FR_OCC_82,55,4,39
2020-05-28,0,0,0,1,FR_OCC_82,55,4,40
2020-05-29,0,0,0,0,FR_OCC_82,55,4,40
2020-05-30,0,0,0,0,FR_OCC_82,55,4,40
2020-05-31,0,0,0,0,FR_OCC_82,55,4,40
2020-06-01,0,0,0,0,FR_OCC_82,55,4,40
2020-06-02,0,0,0,0,FR_OCC_82,55,4,40
2020-06-03,0,0,0,0,FR_OCC_82,55,4,40
2020-06-04,0,0,0,1,FR_OCC_82,55,4,41
2020-06-05,0,0,1,0,FR_OCC_82,55,5,41
2020-06-06,0,0,0,0,FR_OCC_82,55,5,41
2020-06-07,0,0,0,0,FR_OCC_82,55,5,41
2020-06-08,0,0,0,0,FR_OCC_82,55,5,41
2020-06-09,0,0,0,0,FR_OCC_82,55,5,41
2020-06-10,0,0,0,0,FR_OCC_82,55,5,41
2020-06-11,0,0,0,1,FR_OCC_82,55,5,42
2020-06-12,0,0,0,0,FR_OCC_82,55,5,42
2020-06-13,0,0,0,0,FR_OCC_82,55,5,42
2020-06-14,0,0,0,0,FR_OCC_82,55,5,42
2020-06-15,0,0,0,0,FR_OCC_82,55,5,42
2020-06-16,0,0,0,0,FR_OCC_82,55,5,42
2020-06-17,0,0,0,0,FR_OCC_82,55,5,42
2020-06-18,0,0,0,0,FR_OCC_82,55,5,42
2020-06-19,0,0,0,0,FR_OCC_82,55,5,42
2020-06-20,0,0,0,0,FR_OCC_82,55,5,42
2020-06-21,0,0,0,0,FR_OCC_82,55,5,42
2020-06-22,0,0,0,0,FR_OCC_82,55,5,42
2020-06-23,0,0,0,0,FR_OCC_82,55,5,42
2020-06-24,0,0,0,0,FR_OCC_82,55,5,42
2020-03-19,10,4,2,8,FR_PAC_83,10,2,8
2020-03-20,8,3,0,2,FR_PAC_83,18,2,10
2020-03-21,19,3,0,12,FR_PAC_83,37,2,22
2020-03-22,22,4,0,11,FR_PAC_83,59,2,33
2020-03-23,8,1,3,5,FR_PAC_83,67,5,38
2020-03-24,19,3,2,5,FR_PAC_83,86,7,43
2020-03-25,31,5,1,8,FR_PAC_83,117,8,51
2020-03-26,24,3,4,8,FR_PAC_83,141,12,59
2020-03-27,16,2,0,6,FR_PAC_83,157,12,65
2020-03-28,27,4,0,1,FR_PAC_83,184,12,66
2020-03-29,24,6,1,5,FR_PAC_83,208,13,71
2020-03-30,30,5,5,12,FR_PAC_83,238,18,83
2020-03-31,38,12,6,23,FR_PAC_83,276,24,106
2020-04-01,14,4,3,14,FR_PAC_83,290,27,120
2020-04-02,26,6,1,3,FR_PAC_83,316,28,123
2020-04-03,22,3,2,20,FR_PAC_83,338,30,143
2020-04-04,30,5,2,10,FR_PAC_83,368,32,153
2020-04-05,31,6,4,5,FR_PAC_83,399,36,158
2020-04-06,24,3,5,16,FR_PAC_83,423,41,174
2020-04-07,20,5,5,18,FR_PAC_83,443,46,192
2020-04-08,41,4,0,14,FR_PAC_83,484,46,206
2020-04-09,35,0,2,18,FR_PAC_83,519,48,224
2020-04-10,25,3,3,20,FR_PAC_83,544,51,244
2020-04-11,23,3,1,17,FR_PAC_83,567,52,261
2020-04-12,26,3,5,30,FR_PAC_83,593,57,291
2020-04-13,20,2,6,0,FR_PAC_83,613,63,291
2020-04-14,57,3,3,14,FR_PAC_83,670,66,305
2020-04-15,39,2,3,28,FR_PAC_83,709,69,333
2020-04-16,17,3,5,20,FR_PAC_83,726,74,353
2020-04-17,17,4,8,17,FR_PAC_83,743,82,370
2020-04-18,16,3,3,12,FR_PAC_83,759,85,382
2020-04-19,9,2,1,4,FR_PAC_83,768,86,386
2020-04-20,10,6,3,4,FR_PAC_83,778,89,390
2020-04-21,12,3,3,13,FR_PAC_83,790,92,403
2020-04-22,28,8,3,8,FR_PAC_83,818,95,411
2020-04-23,21,3,4,17,FR_PAC_83,839,99,428
2020-04-24,10,1,3,9,FR_PAC_83,849,102,437
2020-04-25,12,3,2,39,FR_PAC_83,861,104,476
2020-04-26,1,1,1,2,FR_PAC_83,862,105,478
2020-04-27,31,2,5,38,FR_PAC_83,893,110,516
2020-04-28,16,6,2,18,FR_PAC_83,909,112,534
2020-04-29,36,0,2,60,FR_PAC_83,945,114,594
2020-04-30,19,0,0,24,FR_PAC_83,964,114,618
2020-05-01,7,2,0,8,FR_PAC_83,971,114,626
2020-05-02,1,0,1,0,FR_PAC_83,972,115,626
2020-05-03,1,1,0,2,FR_PAC_83,973,115,628
2020-05-04,12,1,2,13,FR_PAC_83,985,117,641
2020-05-05,7,2,1,16,FR_PAC_83,992,118,657
2020-05-06,6,1,2,11,FR_PAC_83,998,120,668
2020-05-07,7,1,0,7,FR_PAC_83,1005,120,675
2020-05-08,3,0,0,5,FR_PAC_83,1008,120,680
2020-05-09,1,0,0,1,FR_PAC_83,1009,120,681
2020-05-10,1,0,0,0,FR_PAC_83,1010,120,681
2020-05-11,1,0,5,8,FR_PAC_83,1011,125,689
2020-05-12,11,1,0,15,FR_PAC_83,1022,125,704
2020-05-13,4,0,1,20,FR_PAC_83,1026,126,724
2020-05-14,3,0,0,10,FR_PAC_83,1029,126,734
2020-05-15,5,0,0,9,FR_PAC_83,1034,126,743
2020-05-16,4,0,0,18,FR_PAC_83,1038,126,761
2020-05-17,0,0,0,1,FR_PAC_83,1038,126,762
2020-05-18,7,0,1,2,FR_PAC_83,1045,127,764
2020-05-19,3,0,0,5,FR_PAC_83,1048,127,769
2020-05-20,0,0,0,4,FR_PAC_83,1048,127,773
2020-05-21,2,0,0,1,FR_PAC_83,1050,127,774
2020-05-22,0,0,0,4,FR_PAC_83,1050,127,778
2020-05-23,0,0,1,0,FR_PAC_83,1050,128,778
2020-05-24,2,0,0,0,FR_PAC_83,1052,128,778
2020-05-25,2,0,1,11,FR_PAC_83,1054,129,789
2020-05-26,2,0,0,5,FR_PAC_83,1056,129,794
2020-05-27,2,0,0,2,FR_PAC_83,1058,129,796
2020-05-28,2,0,0,1,FR_PAC_83,1060,129,797
2020-05-29,2,0,1,6,FR_PAC_83,1062,130,803
2020-05-30,2,0,0,2,FR_PAC_83,1064,130,805
2020-05-31,0,0,0,0,FR_PAC_83,1064,130,805
2020-06-01,0,0,0,0,FR_PAC_83,1064,130,805
2020-06-02,4,0,3,3,FR_PAC_83,1068,133,808
2020-06-03,5,0,0,8,FR_PAC_83,1073,133,816
2020-06-04,1,0,0,9,FR_PAC_83,1074,133,825
2020-06-05,1,0,0,4,FR_PAC_83,1075,133,829
2020-06-06,0,0,0,3,FR_PAC_83,1075,133,832
2020-06-07,0,0,0,0,FR_PAC_83,1075,133,832
2020-06-08,0,0,0,3,FR_PAC_83,1075,133,835
2020-06-09,1,0,0,4,FR_PAC_83,1076,133,839
2020-06-10,2,0,0,6,FR_PAC_83,1078,133,845
2020-06-11,1,0,1,3,FR_PAC_83,1079,134,848
2020-06-12,1,0,0,3,FR_PAC_83,1080,134,851
2020-06-13,1,0,0,0,FR_PAC_83,1081,134,851
2020-06-14,0,0,0,0,FR_PAC_83,1081,134,851
2020-06-15,2,0,0,2,FR_PAC_83,1083,134,853
2020-06-16,1,0,0,0,FR_PAC_83,1084,134,853
2020-06-17,0,0,0,3,FR_PAC_83,1084,134,856
2020-06-18,1,0,0,0,FR_PAC_83,1085,134,856
2020-06-19,0,0,1,1,FR_PAC_83,1085,135,857
2020-06-20,1,0,0,0,FR_PAC_83,1086,135,857
2020-06-21,3,0,0,2,FR_PAC_83,1089,135,859
2020-06-22,0,0,0,0,FR_PAC_83,1089,135,859
2020-06-23,0,0,0,1,FR_PAC_83,1089,135,860
2020-06-24,1,0,0,3,FR_PAC_83,1090,135,863
2020-03-19,6,1,0,2,FR_PAC_84,6,0,2
2020-03-20,2,0,0,1,FR_PAC_84,8,0,3
2020-03-21,7,2,0,1,FR_PAC_84,15,0,4
2020-03-22,3,0,0,1,FR_PAC_84,18,0,5
2020-03-23,9,3,2,5,FR_PAC_84,27,2,10
2020-03-24,1,0,0,0,FR_PAC_84,28,2,10
2020-03-25,13,2,0,5,FR_PAC_84,41,2,15
2020-03-26,8,1,0,6,FR_PAC_84,49,2,21
2020-03-27,10,4,0,4,FR_PAC_84,59,2,25
2020-03-28,11,6,1,7,FR_PAC_84,70,3,32
2020-03-29,4,0,0,0,FR_PAC_84,74,3,32
2020-03-30,18,3,1,2,FR_PAC_84,92,4,34
2020-03-31,5,2,1,6,FR_PAC_84,97,5,40
2020-04-01,19,1,4,5,FR_PAC_84,116,9,45
2020-04-02,17,2,2,3,FR_PAC_84,133,11,48
2020-04-03,9,1,1,9,FR_PAC_84,142,12,57
2020-04-04,6,0,1,4,FR_PAC_84,148,13,61
2020-04-05,6,3,2,2,FR_PAC_84,154,15,63
2020-04-06,10,0,0,4,FR_PAC_84,164,15,67
2020-04-07,16,2,0,17,FR_PAC_84,180,15,84
2020-04-08,11,0,3,11,FR_PAC_84,191,18,95
2020-04-09,7,2,0,4,FR_PAC_84,198,18,99
2020-04-10,7,0,2,8,FR_PAC_84,205,20,107
2020-04-11,8,0,0,10,FR_PAC_84,213,20,117
2020-04-12,6,1,1,3,FR_PAC_84,219,21,120
2020-04-13,1,1,0,3,FR_PAC_84,220,21,123
2020-04-14,4,0,0,2,FR_PAC_84,224,21,125
2020-04-15,2,0,1,4,FR_PAC_84,226,22,129
2020-04-16,2,0,0,0,FR_PAC_84,228,22,129
2020-04-17,2,1,0,6,FR_PAC_84,230,22,135
2020-04-18,8,0,1,6,FR_PAC_84,238,23,141
2020-04-19,3,1,1,0,FR_PAC_84,241,24,141
2020-04-20,2,0,0,2,FR_PAC_84,243,24,143
2020-04-21,8,1,2,2,FR_PAC_84,251,26,145
2020-04-22,4,0,0,2,FR_PAC_84,255,26,147
2020-04-23,3,0,0,2,FR_PAC_84,258,26,149
2020-04-24,15,3,0,3,FR_PAC_84,273,26,152
2020-04-25,2,0,0,4,FR_PAC_84,275,26,156
2020-04-26,3,1,0,0,FR_PAC_84,278,26,156
2020-04-27,8,2,1,0,FR_PAC_84,286,27,156
2020-04-28,3,2,0,6,FR_PAC_84,289,27,162
2020-04-29,4,0,0,4,FR_PAC_84,293,27,166
2020-04-30,3,0,0,5,FR_PAC_84,296,27,171
2020-05-01,4,0,0,2,FR_PAC_84,300,27,173
2020-05-02,4,0,0,6,FR_PAC_84,304,27,179
2020-05-03,4,0,1,3,FR_PAC_84,308,28,182
2020-05-04,5,0,0,5,FR_PAC_84,313,28,187
2020-05-05,3,0,1,12,FR_PAC_84,316,29,199
2020-05-06,3,0,1,0,FR_PAC_84,319,30,199
2020-05-07,1,0,0,5,FR_PAC_84,320,30,204
2020-05-08,1,0,0,4,FR_PAC_84,321,30,208
2020-05-09,0,0,0,0,FR_PAC_84,321,30,208
2020-05-10,0,0,0,1,FR_PAC_84,321,30,209
2020-05-11,0,0,1,2,FR_PAC_84,321,31,211
2020-05-12,0,0,0,3,FR_PAC_84,321,31,214
2020-05-13,2,0,2,9,FR_PAC_84,323,33,223
2020-05-14,0,0,0,2,FR_PAC_84,323,33,225
2020-05-15,0,0,0,2,FR_PAC_84,323,33,227
2020-05-16,1,0,0,0,FR_PAC_84,324,33,227
2020-05-17,0,0,0,0,FR_PAC_84,324,33,227
2020-05-18,1,0,1,0,FR_PAC_84,325,34,227
2020-05-19,0,0,1,0,FR_PAC_84,325,35,227
2020-05-20,1,0,0,1,FR_PAC_84,326,35,228
2020-05-21,1,0,0,1,FR_PAC_84,327,35,229
2020-05-22,0,0,0,0,FR_PAC_84,327,35,229
2020-05-23,2,0,0,0,FR_PAC_84,329,35,229
2020-05-24,1,0,0,0,FR_PAC_84,330,35,229
2020-05-25,3,0,0,0,FR_PAC_84,333,35,229
2020-05-26,0,0,0,0,FR_PAC_84,333,35,229
2020-05-27,1,1,0,1,FR_PAC_84,334,35,230
2020-05-28,3,0,0,3,FR_PAC_84,337,35,233
2020-05-29,0,0,1,0,FR_PAC_84,337,36,233
2020-05-30,0,0,0,0,FR_PAC_84,337,36,233
2020-05-31,2,0,0,0,FR_PAC_84,339,36,233
2020-06-01,0,0,0,0,FR_PAC_84,339,36,233
2020-06-02,4,0,0,1,FR_PAC_84,343,36,234
2020-06-03,3,0,0,1,FR_PAC_84,346,36,235
2020-06-04,1,0,0,1,FR_PAC_84,347,36,236
2020-06-05,0,0,0,1,FR_PAC_84,347,36,237
2020-06-06,0,0,0,0,FR_PAC_84,347,36,237
2020-06-07,0,0,0,0,FR_PAC_84,347,36,237
2020-06-08,0,0,0,0,FR_PAC_84,347,36,237
2020-06-09,1,0,0,0,FR_PAC_84,348,36,237
2020-06-10,1,0,0,0,FR_PAC_84,349,36,237
2020-06-11,0,0,0,0,FR_PAC_84,349,36,237
2020-06-12,1,0,0,0,FR_PAC_84,350,36,237
2020-06-13,0,0,0,0,FR_PAC_84,350,36,237
2020-06-14,0,0,0,0,FR_PAC_84,350,36,237
2020-06-15,1,0,1,0,FR_PAC_84,351,37,237
2020-06-16,0,0,0,2,FR_PAC_84,351,37,239
2020-06-17,0,0,0,0,FR_PAC_84,351,37,239
2020-06-18,0,0,0,0,FR_PAC_84,351,37,239
2020-06-19,0,0,0,0,FR_PAC_84,351,37,239
2020-06-20,0,0,0,0,FR_PAC_84,351,37,239
2020-06-21,0,0,0,0,FR_PAC_84,351,37,239
2020-06-22,0,0,0,0,FR_PAC_84,351,37,239
2020-06-23,0,0,0,1,FR_PAC_84,351,37,240
2020-06-24,0,0,0,0,FR_PAC_84,351,37,240
2020-03-19,9,2,0,5,FR_PDL_85,9,0,5
2020-03-20,1,0,0,0,FR_PDL_85,10,0,5
2020-03-21,0,1,0,2,FR_PDL_85,10,0,7
2020-03-22,4,3,0,1,FR_PDL_85,14,0,8
2020-03-23,3,2,0,0,FR_PDL_85,17,0,8
2020-03-24,4,0,0,0,FR_PDL_85,21,0,8
2020-03-25,20,1,1,1,FR_PDL_85,41,1,9
2020-03-26,16,2,1,2,FR_PDL_85,57,2,11
2020-03-27,8,1,1,0,FR_PDL_85,65,3,11
2020-03-28,14,1,1,3,FR_PDL_85,79,4,14
2020-03-29,10,5,0,1,FR_PDL_85,89,4,15
2020-03-30,2,1,0,0,FR_PDL_85,91,4,15
2020-03-31,7,0,1,10,FR_PDL_85,98,5,25
2020-04-01,11,3,2,4,FR_PDL_85,109,7,29
2020-04-02,3,1,0,2,FR_PDL_85,112,7,31
2020-04-03,13,1,5,2,FR_PDL_85,125,12,33
2020-04-04,13,3,3,7,FR_PDL_85,138,15,40
2020-04-05,7,2,0,0,FR_PDL_85,145,15,40
2020-04-06,5,2,1,0,FR_PDL_85,150,16,40
2020-04-07,1,0,0,6,FR_PDL_85,151,16,46
2020-04-08,5,0,1,11,FR_PDL_85,156,17,57
2020-04-09,7,2,0,2,FR_PDL_85,163,17,59
2020-04-10,5,1,2,5,FR_PDL_85,168,19,64
2020-04-11,9,0,1,4,FR_PDL_85,177,20,68
2020-04-12,1,1,0,3,FR_PDL_85,178,20,71
2020-04-13,7,0,1,2,FR_PDL_85,185,21,73
2020-04-14,12,0,3,3,FR_PDL_85,197,24,76
2020-04-15,2,1,1,8,FR_PDL_85,199,25,84
2020-04-16,14,0,1,17,FR_PDL_85,213,26,101
2020-04-17,14,0,0,6,FR_PDL_85,227,26,107
2020-04-18,1,0,0,3,FR_PDL_85,228,26,110
2020-04-19,1,0,0,1,FR_PDL_85,229,26,111
2020-04-20,1,0,2,1,FR_PDL_85,230,28,112
2020-04-21,8,0,2,6,FR_PDL_85,238,30,118
2020-04-22,2,0,0,6,FR_PDL_85,240,30,124
2020-04-23,3,0,1,7,FR_PDL_85,243,31,131
2020-04-24,1,0,1,4,FR_PDL_85,244,32,135
2020-04-25,0,0,0,3,FR_PDL_85,244,32,138
2020-04-26,0,0,0,0,FR_PDL_85,244,32,138
2020-04-27,4,0,1,2,FR_PDL_85,248,33,140
2020-04-28,0,0,0,5,FR_PDL_85,248,33,145
2020-04-29,1,0,0,2,FR_PDL_85,249,33,147
2020-04-30,0,0,0,3,FR_PDL_85,249,33,150
2020-05-01,2,0,0,1,FR_PDL_85,251,33,151
2020-05-02,3,0,0,0,FR_PDL_85,254,33,151
2020-05-03,3,3,0,0,FR_PDL_85,257,33,151
2020-05-04,0,0,1,0,FR_PDL_85,257,34,151
2020-05-05,1,0,0,2,FR_PDL_85,258,34,153
2020-05-06,1,0,0,0,FR_PDL_85,259,34,153
2020-05-07,2,0,0,3,FR_PDL_85,261,34,156
2020-05-08,1,1,0,2,FR_PDL_85,262,34,158
2020-05-09,0,0,0,1,FR_PDL_85,262,34,159
2020-05-10,0,0,0,2,FR_PDL_85,262,34,161
2020-05-11,0,0,0,0,FR_PDL_85,262,34,161
2020-05-12,9,0,0,7,FR_PDL_85,271,34,168
2020-05-13,3,1,0,1,FR_PDL_85,274,34,169
2020-05-14,6,0,1,2,FR_PDL_85,280,35,171
2020-05-15,4,0,0,2,FR_PDL_85,284,35,173
2020-05-16,4,0,1,3,FR_PDL_85,288,36,176
2020-05-17,0,0,0,0,FR_PDL_85,288,36,176
2020-05-18,5,0,0,0,FR_PDL_85,293,36,176
2020-05-19,10,3,1,1,FR_PDL_85,303,37,177
2020-05-20,4,0,0,5,FR_PDL_85,307,37,182
2020-05-21,2,0,0,1,FR_PDL_85,309,37,183
2020-05-22,3,0,0,1,FR_PDL_85,312,37,184
2020-05-23,1,0,1,5,FR_PDL_85,313,38,189
2020-05-24,0,0,0,0,FR_PDL_85,313,38,189
2020-05-25,5,0,0,3,FR_PDL_85,318,38,192
2020-05-26,3,0,0,4,FR_PDL_85,321,38,196
2020-05-27,2,1,1,1,FR_PDL_85,323,39,197
2020-05-28,9,0,0,8,FR_PDL_85,332,39,205
2020-05-29,5,0,1,2,FR_PDL_85,337,40,207
2020-05-30,1,0,0,2,FR_PDL_85,338,40,209
2020-05-31,0,0,0,0,FR_PDL_85,338,40,209
2020-06-01,0,0,0,0,FR_PDL_85,338,40,209
2020-06-02,5,0,0,2,FR_PDL_85,343,40,211
2020-06-03,0,0,0,0,FR_PDL_85,343,40,211
2020-06-04,1,1,0,5,FR_PDL_85,344,40,216
2020-06-05,0,0,0,6,FR_PDL_85,344,40,222
2020-06-06,3,0,0,2,FR_PDL_85,347,40,224
2020-06-07,0,0,0,0,FR_PDL_85,347,40,224
2020-06-08,0,0,1,0,FR_PDL_85,347,41,224
2020-06-09,3,0,1,7,FR_PDL_85,350,42,231
2020-06-10,2,0,0,2,FR_PDL_85,352,42,233
2020-06-11,0,0,0,3,FR_PDL_85,352,42,236
2020-06-12,0,0,0,1,FR_PDL_85,352,42,237
2020-06-13,0,0,0,1,FR_PDL_85,352,42,238
2020-06-14,0,0,0,1,FR_PDL_85,352,42,239
2020-06-15,0,0,0,1,FR_PDL_85,352,42,240
2020-06-16,0,0,0,0,FR_PDL_85,352,42,240
2020-06-17,0,0,0,4,FR_PDL_85,352,42,244
2020-06-18,0,0,0,2,FR_PDL_85,352,42,246
2020-06-19,0,0,0,5,FR_PDL_85,352,42,251
2020-06-20,0,0,0,0,FR_PDL_85,352,42,251
2020-06-21,0,0,0,0,FR_PDL_85,352,42,251
2020-06-22,1,1,0,1,FR_PDL_85,353,42,252
2020-06-23,1,0,0,0,FR_PDL_85,354,42,252
2020-06-24,0,0,0,1,FR_PDL_85,354,42,253
2020-03-19,6,1,0,0,FR_NAQ_86,6,0,0
2020-03-20,0,0,0,0,FR_NAQ_86,6,0,0
2020-03-21,3,2,0,1,FR_NAQ_86,9,0,1
2020-03-22,2,0,1,0,FR_NAQ_86,11,1,1
2020-03-23,3,1,1,0,FR_NAQ_86,14,2,1
2020-03-24,6,0,0,4,FR_NAQ_86,20,2,5
2020-03-25,8,3,1,4,FR_NAQ_86,28,3,9
2020-03-26,13,5,0,4,FR_NAQ_86,41,3,13
2020-03-27,10,3,2,2,FR_NAQ_86,51,5,15
2020-03-28,7,3,2,5,FR_NAQ_86,58,7,20
2020-03-29,6,5,1,0,FR_NAQ_86,64,8,20
2020-03-30,8,1,0,1,FR_NAQ_86,72,8,21
2020-03-31,4,4,3,6,FR_NAQ_86,76,11,27
2020-04-01,7,0,0,1,FR_NAQ_86,83,11,28
2020-04-02,4,0,3,3,FR_NAQ_86,87,14,31
2020-04-03,5,1,0,2,FR_NAQ_86,92,14,33
2020-04-04,1,1,1,2,FR_NAQ_86,93,15,35
2020-04-05,7,1,1,2,FR_NAQ_86,100,16,37
2020-04-06,7,0,0,1,FR_NAQ_86,107,16,38
2020-04-07,4,3,2,3,FR_NAQ_86,111,18,41
2020-04-08,5,1,0,3,FR_NAQ_86,116,18,44
2020-04-09,2,1,0,2,FR_NAQ_86,118,18,46
2020-04-10,6,3,0,7,FR_NAQ_86,124,18,53
2020-04-11,4,0,0,4,FR_NAQ_86,128,18,57
2020-04-12,0,0,0,0,FR_NAQ_86,128,18,57
2020-04-13,5,0,2,0,FR_NAQ_86,133,20,57
2020-04-14,5,1,1,7,FR_NAQ_86,138,21,64
2020-04-15,0,0,0,0,FR_NAQ_86,138,21,64
2020-04-16,2,0,3,6,FR_NAQ_86,140,24,70
2020-04-17,0,0,0,4,FR_NAQ_86,140,24,74
2020-04-18,0,0,0,2,FR_NAQ_86,140,24,76
2020-04-19,0,0,0,0,FR_NAQ_86,140,24,76
2020-04-20,9,0,0,1,FR_NAQ_86,149,24,77
2020-04-21,2,0,0,1,FR_NAQ_86,151,24,78
2020-04-22,3,0,0,3,FR_NAQ_86,154,24,81
2020-04-23,1,0,2,0,FR_NAQ_86,155,26,81
2020-04-24,0,0,2,4,FR_NAQ_86,155,28,85
2020-04-25,1,0,0,1,FR_NAQ_86,156,28,86
2020-04-26,0,0,0,0,FR_NAQ_86,156,28,86
2020-04-27,5,0,1,2,FR_NAQ_86,161,29,88
2020-04-28,3,1,1,0,FR_NAQ_86,164,30,88
2020-04-29,3,1,0,3,FR_NAQ_86,167,30,91
2020-04-30,3,0,0,4,FR_NAQ_86,170,30,95
2020-05-01,1,0,0,1,FR_NAQ_86,171,30,96
2020-05-02,0,0,0,0,FR_NAQ_86,171,30,96
2020-05-03,0,0,0,0,FR_NAQ_86,171,30,96
2020-05-04,4,1,2,4,FR_NAQ_86,175,32,100
2020-05-05,0,0,0,0,FR_NAQ_86,175,32,100
2020-05-06,0,0,1,1,FR_NAQ_86,175,33,101
2020-05-07,2,1,0,5,FR_NAQ_86,177,33,106
2020-05-08,3,0,0,11,FR_NAQ_86,180,33,117
2020-05-09,0,0,0,0,FR_NAQ_86,180,33,117
2020-05-10,0,0,0,0,FR_NAQ_86,180,33,117
2020-05-11,4,1,2,1,FR_NAQ_86,184,35,118
2020-05-12,0,0,0,4,FR_NAQ_86,184,35,122
2020-05-13,0,0,0,0,FR_NAQ_86,184,35,122
2020-05-14,1,0,0,0,FR_NAQ_86,185,35,122
2020-05-15,2,0,1,4,FR_NAQ_86,187,36,126
2020-05-16,0,0,0,0,FR_NAQ_86,187,36,126
2020-05-17,0,0,0,0,FR_NAQ_86,187,36,126
2020-05-18,1,0,0,0,FR_NAQ_86,188,36,126
2020-05-19,0,0,0,0,FR_NAQ_86,188,36,126
2020-05-20,0,0,0,2,FR_NAQ_86,188,36,128
2020-05-21,0,0,0,0,FR_NAQ_86,188,36,128
2020-05-22,0,0,0,0,FR_NAQ_86,188,36,128
2020-05-23,5,0,0,0,FR_NAQ_86,193,36,128
2020-05-24,0,0,0,0,FR_NAQ_86,193,36,128
2020-05-25,4,0,0,1,FR_NAQ_86,197,36,129
2020-05-26,0,0,0,0,FR_NAQ_86,197,36,129
2020-05-27,0,0,0,0,FR_NAQ_86,197,36,129
2020-05-28,0,0,1,2,FR_NAQ_86,197,37,131
2020-05-29,0,0,0,6,FR_NAQ_86,197,37,137
2020-05-30,0,0,0,0,FR_NAQ_86,197,37,137
2020-05-31,0,0,0,0,FR_NAQ_86,197,37,137
2020-06-01,0,0,0,0,FR_NAQ_86,197,37,137
2020-06-02,4,0,0,1,FR_NAQ_86,201,37,138
2020-06-03,0,0,1,3,FR_NAQ_86,201,38,141
2020-06-04,0,0,0,0,FR_NAQ_86,201,38,141
2020-06-05,0,0,0,0,FR_NAQ_86,201,38,141
2020-06-06,0,0,0,2,FR_NAQ_86,201,38,143
2020-06-07,0,0,0,0,FR_NAQ_86,201,38,143
2020-06-08,0,0,0,0,FR_NAQ_86,201,38,143
2020-06-09,0,0,0,1,FR_NAQ_86,201,38,144
2020-06-10,1,0,0,0,FR_NAQ_86,202,38,144
2020-06-11,0,0,0,0,FR_NAQ_86,202,38,144
2020-06-12,0,0,0,0,FR_NAQ_86,202,38,144
2020-06-13,0,0,0,2,FR_NAQ_86,202,38,146
2020-06-14,0,0,0,0,FR_NAQ_86,202,38,146
2020-06-15,1,0,0,1,FR_NAQ_86,203,38,147
2020-06-16,0,0,0,0,FR_NAQ_86,203,38,147
2020-06-17,0,0,0,0,FR_NAQ_86,203,38,147
2020-06-18,0,0,0,0,FR_NAQ_86,203,38,147
2020-06-19,0,0,0,0,FR_NAQ_86,203,38,147
2020-06-20,0,0,0,1,FR_NAQ_86,203,38,148
2020-06-21,0,0,0,0,FR_NAQ_86,203,38,148
2020-06-22,0,0,0,0,FR_NAQ_86,203,38,148
2020-06-23,0,0,0,0,FR_NAQ_86,203,38,148
2020-06-24,0,0,0,5,FR_NAQ_86,203,38,153
2020-03-19,4,1,0,0,FR_NAQ_87,4,0,0
2020-03-20,1,1,0,0,FR_NAQ_87,5,0,0
2020-03-21,3,0,1,0,FR_NAQ_87,8,1,0
2020-03-22,3,0,0,0,FR_NAQ_87,11,1,0
2020-03-23,4,1,0,0,FR_NAQ_87,15,1,0
2020-03-24,3,2,1,0,FR_NAQ_87,18,2,0
2020-03-25,3,1,1,0,FR_NAQ_87,21,3,0
2020-03-26,5,0,1,1,FR_NAQ_87,26,4,1
2020-03-27,7,0,0,0,FR_NAQ_87,33,4,1
2020-03-28,7,1,0,2,FR_NAQ_87,40,4,3
2020-03-29,10,6,0,0,FR_NAQ_87,50,4,3
2020-03-30,8,1,1,1,FR_NAQ_87,58,5,4
2020-03-31,8,0,0,3,FR_NAQ_87,66,5,7
2020-04-01,7,2,0,6,FR_NAQ_87,73,5,13
2020-04-02,8,1,1,5,FR_NAQ_87,81,6,18
2020-04-03,5,1,1,5,FR_NAQ_87,86,7,23
2020-04-04,6,1,0,2,FR_NAQ_87,92,7,25
2020-04-05,3,1,1,2,FR_NAQ_87,95,8,27
2020-04-06,3,0,2,1,FR_NAQ_87,98,10,28
2020-04-07,4,0,0,3,FR_NAQ_87,102,10,31
2020-04-08,8,0,1,3,FR_NAQ_87,110,11,34
2020-04-09,5,2,0,2,FR_NAQ_87,115,11,36
2020-04-10,5,0,0,4,FR_NAQ_87,120,11,40
2020-04-11,3,1,0,5,FR_NAQ_87,123,11,45
2020-04-12,9,0,0,2,FR_NAQ_87,132,11,47
2020-04-13,3,0,0,2,FR_NAQ_87,135,11,49
2020-04-14,2,0,2,6,FR_NAQ_87,137,13,55
2020-04-15,3,0,0,6,FR_NAQ_87,140,13,61
2020-04-16,3,0,2,3,FR_NAQ_87,143,15,64
2020-04-17,1,0,1,1,FR_NAQ_87,144,16,65
2020-04-18,0,0,0,1,FR_NAQ_87,144,16,66
2020-04-19,1,0,1,2,FR_NAQ_87,145,17,68
2020-04-20,1,0,3,4,FR_NAQ_87,146,20,72
2020-04-21,5,0,1,3,FR_NAQ_87,151,21,75
2020-04-22,3,0,0,2,FR_NAQ_87,154,21,77
2020-04-23,2,0,0,2,FR_NAQ_87,156,21,79
2020-04-24,0,0,0,3,FR_NAQ_87,156,21,82
2020-04-25,0,0,1,1,FR_NAQ_87,156,22,83
2020-04-26,0,0,0,0,FR_NAQ_87,156,22,83
2020-04-27,1,0,0,3,FR_NAQ_87,157,22,86
2020-04-28,0,0,0,2,FR_NAQ_87,157,22,88
2020-04-29,0,0,1,1,FR_NAQ_87,157,23,89
2020-04-30,1,0,0,4,FR_NAQ_87,158,23,93
2020-05-01,0,0,0,0,FR_NAQ_87,158,23,93
2020-05-02,0,0,0,0,FR_NAQ_87,158,23,93
2020-05-03,1,0,0,1,FR_NAQ_87,159,23,94
2020-05-04,0,0,0,0,FR_NAQ_87,159,23,94
2020-05-05,0,1,0,0,FR_NAQ_87,159,23,94
2020-05-06,1,0,0,3,FR_NAQ_87,160,23,97
2020-05-07,2,0,2,1,FR_NAQ_87,162,25,98
2020-05-08,0,0,0,0,FR_NAQ_87,162,25,98
2020-05-09,2,0,0,0,FR_NAQ_87,164,25,98
2020-05-10,1,1,0,0,FR_NAQ_87,165,25,98
2020-05-11,2,1,0,1,FR_NAQ_87,167,25,99
2020-05-12,0,0,0,0,FR_NAQ_87,167,25,99
2020-05-13,0,0,0,1,FR_NAQ_87,167,25,100
2020-05-14,0,0,0,3,FR_NAQ_87,167,25,103
2020-05-15,0,0,0,0,FR_NAQ_87,167,25,103
2020-05-16,0,0,0,0,FR_NAQ_87,167,25,103
2020-05-17,0,0,0,0,FR_NAQ_87,167,25,103
2020-05-18,1,0,0,6,FR_NAQ_87,168,25,109
2020-05-19,1,0,0,2,FR_NAQ_87,169,25,111
2020-05-20,0,0,0,2,FR_NAQ_87,169,25,113
2020-05-21,0,0,0,0,FR_NAQ_87,169,25,113
2020-05-22,0,0,0,5,FR_NAQ_87,169,25,118
2020-05-23,1,0,0,0,FR_NAQ_87,170,25,118
2020-05-24,0,0,0,0,FR_NAQ_87,170,25,118
2020-05-25,0,0,1,1,FR_NAQ_87,170,26,119
2020-05-26,0,0,0,0,FR_NAQ_87,170,26,119
2020-05-27,0,0,0,0,FR_NAQ_87,170,26,119
2020-05-28,0,0,0,0,FR_NAQ_87,170,26,119
2020-05-29,0,0,0,0,FR_NAQ_87,170,26,119
2020-05-30,0,0,0,0,FR_NAQ_87,170,26,119
2020-05-31,0,0,0,0,FR_NAQ_87,170,26,119
2020-06-01,0,0,0,0,FR_NAQ_87,170,26,119
2020-06-02,0,0,0,0,FR_NAQ_87,170,26,119
2020-06-03,0,0,0,0,FR_NAQ_87,170,26,119
2020-06-04,0,0,0,0,FR_NAQ_87,170,26,119
2020-06-05,0,0,0,1,FR_NAQ_87,170,26,120
2020-06-06,0,0,0,0,FR_NAQ_87,170,26,120
2020-06-07,0,0,0,0,FR_NAQ_87,170,26,120
2020-06-08,0,0,0,0,FR_NAQ_87,170,26,120
2020-06-09,0,0,0,2,FR_NAQ_87,170,26,122
2020-06-10,0,0,0,0,FR_NAQ_87,170,26,122
2020-06-11,0,0,0,0,FR_NAQ_87,170,26,122
2020-06-12,0,0,0,0,FR_NAQ_87,170,26,122
2020-06-13,0,0,0,0,FR_NAQ_87,170,26,122
2020-06-14,0,0,0,0,FR_NAQ_87,170,26,122
2020-06-15,0,0,0,0,FR_NAQ_87,170,26,122
2020-06-16,0,0,0,4,FR_NAQ_87,170,26,126
2020-06-17,1,0,0,1,FR_NAQ_87,171,26,127
2020-06-18,0,0,0,1,FR_NAQ_87,171,26,128
2020-06-19,0,0,0,0,FR_NAQ_87,171,26,128
2020-06-20,0,0,0,0,FR_NAQ_87,171,26,128
2020-06-21,0,0,0,0,FR_NAQ_87,171,26,128
2020-06-22,0,0,0,0,FR_NAQ_87,171,26,128
2020-06-23,0,0,0,0,FR_NAQ_87,171,26,128
2020-06-24,0,0,0,0,FR_NAQ_87,171,26,128
2020-03-19,17,1,5,1,FR_GES_88,17,5,1
2020-03-20,6,1,1,0,FR_GES_88,23,6,1
2020-03-21,23,7,7,7,FR_GES_88,46,13,8
2020-03-22,13,3,4,5,FR_GES_88,59,17,13
2020-03-23,18,2,7,4,FR_GES_88,77,24,17
2020-03-24,33,6,4,12,FR_GES_88,110,28,29
2020-03-25,46,7,5,8,FR_GES_88,156,33,37
2020-03-26,16,6,7,13,FR_GES_88,172,40,50
2020-03-27,44,5,9,10,FR_GES_88,216,49,60
2020-03-28,48,11,12,12,FR_GES_88,264,61,72
2020-03-29,38,2,4,5,FR_GES_88,302,65,77
2020-03-30,39,7,9,9,FR_GES_88,341,74,86
2020-03-31,71,6,8,11,FR_GES_88,412,82,97
2020-04-01,34,4,7,19,FR_GES_88,446,89,116
2020-04-02,39,14,5,20,FR_GES_88,485,94,136
2020-04-03,23,8,8,19,FR_GES_88,508,102,155
2020-04-04,24,5,7,23,FR_GES_88,532,109,178
2020-04-05,36,3,3,11,FR_GES_88,568,112,189
2020-04-06,18,6,8,6,FR_GES_88,586,120,195
2020-04-07,13,4,3,22,FR_GES_88,599,123,217
2020-04-08,17,4,3,18,FR_GES_88,616,126,235
2020-04-09,39,2,8,21,FR_GES_88,655,134,256
2020-04-10,29,2,18,17,FR_GES_88,684,152,273
2020-04-11,3,0,1,13,FR_GES_88,687,153,286
2020-04-12,11,0,6,6,FR_GES_88,698,159,292
2020-04-13,12,3,4,6,FR_GES_88,710,163,298
2020-04-14,10,4,5,4,FR_GES_88,720,168,302
2020-04-15,32,1,10,20,FR_GES_88,752,178,322
2020-04-16,17,1,4,12,FR_GES_88,769,182,334
2020-04-17,7,4,2,12,FR_GES_88,776,184,346
2020-04-18,10,0,2,8,FR_GES_88,786,186,354
2020-04-19,14,2,12,3,FR_GES_88,800,198,357
2020-04-20,14,1,6,31,FR_GES_88,814,204,388
2020-04-21,21,1,6,18,FR_GES_88,835,210,406
2020-04-22,11,1,3,7,FR_GES_88,846,213,413
2020-04-23,7,3,2,8,FR_GES_88,853,215,421
2020-04-24,9,2,2,13,FR_GES_88,862,217,434
2020-04-25,5,0,2,8,FR_GES_88,867,219,442
2020-04-26,3,0,1,0,FR_GES_88,870,220,442
2020-04-27,2,0,3,2,FR_GES_88,872,223,444
2020-04-28,18,2,4,17,FR_GES_88,890,227,461
2020-04-29,6,0,2,5,FR_GES_88,896,229,466
2020-04-30,13,0,0,18,FR_GES_88,909,229,484
2020-05-01,4,1,0,4,FR_GES_88,913,229,488
2020-05-02,2,0,1,3,FR_GES_88,915,230,491
2020-05-03,2,1,2,14,FR_GES_88,917,232,505
2020-05-04,7,0,4,5,FR_GES_88,924,236,510
2020-05-05,5,1,2,14,FR_GES_88,929,238,524
2020-05-06,3,0,0,7,FR_GES_88,932,238,531
2020-05-07,6,1,2,30,FR_GES_88,938,240,561
2020-05-08,3,1,0,13,FR_GES_88,941,240,574
2020-05-09,1,0,3,11,FR_GES_88,942,243,585
2020-05-10,1,0,0,10,FR_GES_88,943,243,595
2020-05-11,2,0,0,1,FR_GES_88,945,243,596
2020-05-12,1,1,1,8,FR_GES_88,946,244,604
2020-05-13,4,0,0,4,FR_GES_88,950,244,608
2020-05-14,2,0,0,17,FR_GES_88,952,244,625
2020-05-15,2,0,0,4,FR_GES_88,954,244,629
2020-05-16,1,1,2,27,FR_GES_88,955,246,656
2020-05-17,0,0,0,0,FR_GES_88,955,246,656
2020-05-18,0,0,0,4,FR_GES_88,955,246,660
2020-05-19,1,0,0,8,FR_GES_88,956,246,668
2020-05-20,1,0,1,4,FR_GES_88,957,247,672
2020-05-21,0,0,0,6,FR_GES_88,957,247,678
2020-05-22,1,0,0,6,FR_GES_88,958,247,684
2020-05-23,3,0,0,0,FR_GES_88,961,247,684
2020-05-24,0,0,1,0,FR_GES_88,961,248,684
2020-05-25,2,0,0,2,FR_GES_88,963,248,686
2020-05-26,3,1,0,6,FR_GES_88,966,248,692
2020-05-27,0,0,1,2,FR_GES_88,966,249,694
2020-05-28,3,0,0,4,FR_GES_88,969,249,698
2020-05-29,1,0,1,0,FR_GES_88,970,250,698
2020-05-30,3,1,0,6,FR_GES_88,973,250,704
2020-05-31,0,0,0,0,FR_GES_88,973,250,704
2020-06-01,0,0,0,0,FR_GES_88,973,250,704
2020-06-02,1,0,0,0,FR_GES_88,974,250,704
2020-06-03,8,0,1,11,FR_GES_88,982,251,715
2020-06-04,3,0,1,2,FR_GES_88,985,252,717
2020-06-05,0,0,2,7,FR_GES_88,985,254,724
2020-06-06,2,0,0,2,FR_GES_88,987,254,726
2020-06-07,1,0,0,0,FR_GES_88,988,254,726
2020-06-08,0,0,0,0,FR_GES_88,988,254,726
2020-06-09,1,1,0,5,FR_GES_88,989,254,731
2020-06-10,1,0,0,1,FR_GES_88,990,254,732
2020-06-11,0,0,1,7,FR_GES_88,990,255,739
2020-06-12,1,1,0,1,FR_GES_88,991,255,740
2020-06-13,0,0,0,0,FR_GES_88,991,255,740
2020-06-14,0,0,0,0,FR_GES_88,991,255,740
2020-06-15,0,0,2,0,FR_GES_88,991,257,740
2020-06-16,1,0,0,3,FR_GES_88,992,257,743
2020-06-17,0,0,0,1,FR_GES_88,992,257,744
2020-06-18,1,0,1,1,FR_GES_88,993,258,745
2020-06-19,1,0,0,0,FR_GES_88,994,258,745
2020-06-20,0,0,0,0,FR_GES_88,994,258,745
2020-06-21,0,0,0,0,FR_GES_88,994,258,745
2020-06-22,0,0,0,1,FR_GES_88,994,258,746
2020-06-23,0,0,0,1,FR_GES_88,994,258,747
2020-06-24,0,0,0,0,FR_GES_88,994,258,747
2020-03-19,2,2,2,0,FR_BFC_89,2,2,0
2020-03-20,2,0,0,0,FR_BFC_89,4,2,0
2020-03-21,2,0,0,0,FR_BFC_89,6,2,0
2020-03-22,1,0,0,0,FR_BFC_89,7,2,0
2020-03-23,3,4,0,0,FR_BFC_89,10,2,0
2020-03-24,2,0,0,0,FR_BFC_89,12,2,0
2020-03-25,13,2,0,0,FR_BFC_89,25,2,0
2020-03-26,5,1,1,1,FR_BFC_89,30,3,1
2020-03-27,2,0,0,0,FR_BFC_89,32,3,1
2020-03-28,1,0,0,0,FR_BFC_89,33,3,1
2020-03-29,7,2,1,4,FR_BFC_89,40,4,5
2020-03-30,14,2,0,2,FR_BFC_89,54,4,7
2020-03-31,27,2,1,1,FR_BFC_89,81,5,8
2020-04-01,15,5,3,4,FR_BFC_89,96,8,12
2020-04-02,18,1,1,2,FR_BFC_89,114,9,14
2020-04-03,16,2,1,10,FR_BFC_89,130,10,24
2020-04-04,8,0,1,6,FR_BFC_89,138,11,30
2020-04-05,0,0,1,0,FR_BFC_89,138,12,30
2020-04-06,12,1,3,6,FR_BFC_89,150,15,36
2020-04-07,5,2,2,11,FR_BFC_89,155,17,47
2020-04-08,11,0,0,10,FR_BFC_89,166,17,57
2020-04-09,1,0,1,3,FR_BFC_89,167,18,60
2020-04-10,16,3,5,13,FR_BFC_89,183,23,73
2020-04-11,10,0,2,11,FR_BFC_89,193,25,84
2020-04-12,4,0,1,0,FR_BFC_89,197,26,84
2020-04-13,1,0,2,0,FR_BFC_89,198,28,84
2020-04-14,18,2,4,5,FR_BFC_89,216,32,89
2020-04-15,11,0,1,15,FR_BFC_89,227,33,104
2020-04-16,14,1,1,2,FR_BFC_89,241,34,106
2020-04-17,10,0,0,3,FR_BFC_89,251,34,109
2020-04-18,1,0,4,4,FR_BFC_89,252,38,113
2020-04-19,7,0,1,1,FR_BFC_89,259,39,114
2020-04-20,5,1,3,3,FR_BFC_89,264,42,117
2020-04-21,15,0,0,4,FR_BFC_89,279,42,121
2020-04-22,28,5,2,13,FR_BFC_89,307,44,134
2020-04-23,9,2,6,5,FR_BFC_89,316,50,139
2020-04-24,4,0,1,8,FR_BFC_89,320,51,147
2020-04-25,7,0,1,1,FR_BFC_89,327,52,148
2020-04-26,2,0,2,2,FR_BFC_89,329,54,150
2020-04-27,2,0,1,1,FR_BFC_89,331,55,151
2020-04-28,6,1,1,5,FR_BFC_89,337,56,156
2020-04-29,7,3,4,4,FR_BFC_89,344,60,160
2020-04-30,2,1,0,2,FR_BFC_89,346,60,162
2020-05-01,4,0,3,8,FR_BFC_89,350,63,170
2020-05-02,3,0,2,3,FR_BFC_89,353,65,173
2020-05-03,6,0,0,0,FR_BFC_89,359,65,173
2020-05-04,8,0,1,0,FR_BFC_89,367,66,173
2020-05-05,2,0,2,4,FR_BFC_89,369,68,177
2020-05-06,4,0,2,3,FR_BFC_89,373,70,180
2020-05-07,3,1,1,5,FR_BFC_89,376,71,185
2020-05-08,4,0,1,2,FR_BFC_89,380,72,187
2020-05-09,2,0,1,0,FR_BFC_89,382,73,187
2020-05-10,4,0,0,0,FR_BFC_89,386,73,187
2020-05-11,2,0,2,0,FR_BFC_89,388,75,187
2020-05-12,2,0,0,4,FR_BFC_89,390,75,191
2020-05-13,5,0,0,5,FR_BFC_89,395,75,196
2020-05-14,2,0,0,0,FR_BFC_89,397,75,196
2020-05-15,1,0,0,5,FR_BFC_89,398,75,201
2020-05-16,4,0,0,3,FR_BFC_89,402,75,204
2020-05-17,0,0,0,0,FR_BFC_89,402,75,204
2020-05-18,6,0,3,6,FR_BFC_89,408,78,210
2020-05-19,2,0,1,4,FR_BFC_89,410,79,214
2020-05-20,4,0,1,6,FR_BFC_89,414,80,220
2020-05-21,4,0,2,2,FR_BFC_89,418,82,222
2020-05-22,0,0,1,6,FR_BFC_89,418,83,228
2020-05-23,5,0,0,1,FR_BFC_89,423,83,229
2020-05-24,2,0,0,1,FR_BFC_89,425,83,230
2020-05-25,1,0,1,5,FR_BFC_89,426,84,235
2020-05-26,3,0,0,17,FR_BFC_89,429,84,252
2020-05-27,6,0,1,4,FR_BFC_89,435,85,256
2020-05-28,0,0,0,2,FR_BFC_89,435,85,258
2020-05-29,0,0,0,8,FR_BFC_89,435,85,266
2020-05-30,0,0,0,2,FR_BFC_89,435,85,268
2020-05-31,1,0,0,6,FR_BFC_89,436,85,274
2020-06-01,0,0,1,0,FR_BFC_89,436,86,274
2020-06-02,0,0,1,0,FR_BFC_89,436,87,274
2020-06-03,0,0,1,7,FR_BFC_89,436,88,281
2020-06-04,4,0,2,5,FR_BFC_89,440,90,286
2020-06-05,1,0,0,0,FR_BFC_89,441,90,286
2020-06-06,3,0,0,2,FR_BFC_89,444,90,288
2020-06-07,0,0,0,0,FR_BFC_89,444,90,288
2020-06-08,1,0,0,0,FR_BFC_89,445,90,288
2020-06-09,1,0,0,2,FR_BFC_89,446,90,290
2020-06-10,0,0,1,2,FR_BFC_89,446,91,292
2020-06-11,1,0,0,0,FR_BFC_89,447,91,292
2020-06-12,17,0,0,35,FR_BFC_89,464,91,327
2020-06-13,1,0,0,0,FR_BFC_89,465,91,327
2020-06-14,0,0,0,5,FR_BFC_89,465,91,332
2020-06-15,0,0,0,0,FR_BFC_89,465,91,332
2020-06-16,1,0,0,4,FR_BFC_89,466,91,336
2020-06-17,0,0,0,1,FR_BFC_89,466,91,337
2020-06-18,0,0,0,1,FR_BFC_89,466,91,338
2020-06-19,5,0,0,7,FR_BFC_89,471,91,345
2020-06-20,0,0,0,1,FR_BFC_89,471,91,346
2020-06-21,0,0,0,0,FR_BFC_89,471,91,346
2020-06-22,2,0,0,0,FR_BFC_89,473,91,346
2020-06-23,1,0,0,0,FR_BFC_89,474,91,346
2020-06-24,1,0,0,0,FR_BFC_89,475,91,346
2020-03-19,28,3,5,0,FR_BFC_90,28,5,0
2020-03-20,1,1,0,0,FR_BFC_90,29,5,0
2020-03-21,34,2,9,10,FR_BFC_90,63,14,10
2020-03-22,18,0,5,19,FR_BFC_90,81,19,29
2020-03-23,34,3,6,2,FR_BFC_90,115,25,31
2020-03-24,24,1,3,7,FR_BFC_90,139,28,38
2020-03-25,35,2,3,6,FR_BFC_90,174,31,44
2020-03-26,12,2,5,10,FR_BFC_90,186,36,54
2020-03-27,25,1,8,10,FR_BFC_90,211,44,64
2020-03-28,17,2,1,0,FR_BFC_90,228,45,64
2020-03-29,16,3,7,6,FR_BFC_90,244,52,70
2020-03-30,21,2,10,8,FR_BFC_90,265,62,78
2020-03-31,44,5,0,18,FR_BFC_90,309,62,96
2020-04-01,22,0,4,0,FR_BFC_90,331,66,96
2020-04-02,39,6,11,32,FR_BFC_90,370,77,128
2020-04-03,16,1,3,10,FR_BFC_90,386,80,138
2020-04-04,17,1,5,24,FR_BFC_90,403,85,162
2020-04-05,14,2,3,5,FR_BFC_90,417,88,167
2020-04-06,15,0,3,4,FR_BFC_90,432,91,171
2020-04-07,24,2,5,25,FR_BFC_90,456,96,196
2020-04-08,11,0,2,17,FR_BFC_90,467,98,213
2020-04-09,9,0,2,6,FR_BFC_90,476,100,219
2020-04-10,34,0,4,16,FR_BFC_90,510,104,235
2020-04-11,13,0,5,14,FR_BFC_90,523,109,249
2020-04-12,11,1,4,4,FR_BFC_90,534,113,253
2020-04-13,17,2,4,4,FR_BFC_90,551,117,257
2020-04-14,3,0,1,2,FR_BFC_90,554,118,259
2020-04-15,4,0,7,21,FR_BFC_90,558,125,280
2020-04-16,10,2,2,14,FR_BFC_90,568,127,294
2020-04-17,11,0,5,10,FR_BFC_90,579,132,304
2020-04-18,7,1,1,14,FR_BFC_90,586,133,318
2020-04-19,3,1,0,3,FR_BFC_90,589,133,321
2020-04-20,6,0,2,0,FR_BFC_90,595,135,321
2020-04-21,5,1,2,15,FR_BFC_90,600,137,336
2020-04-22,6,1,6,7,FR_BFC_90,606,143,343
2020-04-23,2,0,1,4,FR_BFC_90,608,144,347
2020-04-24,6,0,0,8,FR_BFC_90,614,144,355
2020-04-25,1,0,1,9,FR_BFC_90,615,145,364
2020-04-26,3,0,1,1,FR_BFC_90,618,146,365
2020-04-27,0,0,2,1,FR_BFC_90,618,148,366
2020-04-28,0,0,0,0,FR_BFC_90,618,148,366
2020-04-29,11,2,2,14,FR_BFC_90,629,150,380
2020-04-30,5,0,0,7,FR_BFC_90,634,150,387
2020-05-01,5,0,2,5,FR_BFC_90,639,152,392
2020-05-02,1,0,2,1,FR_BFC_90,640,154,393
2020-05-03,1,0,0,0,FR_BFC_90,641,154,393
2020-05-04,0,0,2,0,FR_BFC_90,641,156,393
2020-05-05,17,0,5,6,FR_BFC_90,658,161,399
2020-05-06,10,0,1,4,FR_BFC_90,668,162,403
2020-05-07,4,0,2,4,FR_BFC_90,672,164,407
2020-05-08,7,1,1,10,FR_BFC_90,679,165,417
2020-05-09,2,0,0,0,FR_BFC_90,681,165,417
2020-05-10,3,0,2,0,FR_BFC_90,684,167,417
2020-05-11,3,1,0,2,FR_BFC_90,687,167,419
2020-05-12,4,1,1,10,FR_BFC_90,691,168,429
2020-05-13,1,0,2,2,FR_BFC_90,692,170,431
2020-05-14,2,0,1,7,FR_BFC_90,694,171,438
2020-05-15,1,0,0,6,FR_BFC_90,695,171,444
2020-05-16,0,0,0,8,FR_BFC_90,695,171,452
2020-05-17,1,0,0,0,FR_BFC_90,696,171,452
2020-05-18,1,0,0,0,FR_BFC_90,697,171,452
2020-05-19,1,0,0,7,FR_BFC_90,698,171,459
2020-05-20,5,0,0,5,FR_BFC_90,703,171,464
2020-05-21,7,0,1,42,FR_BFC_90,710,172,506
2020-05-22,1,0,0,0,FR_BFC_90,711,172,506
2020-05-23,0,0,0,4,FR_BFC_90,711,172,510
2020-05-24,0,0,1,0,FR_BFC_90,711,173,510
2020-05-25,2,0,1,0,FR_BFC_90,713,174,510
2020-05-26,0,0,0,2,FR_BFC_90,713,174,512
2020-05-27,0,0,1,7,FR_BFC_90,713,175,519
2020-05-28,2,0,1,4,FR_BFC_90,715,176,523
2020-05-29,0,0,1,2,FR_BFC_90,715,177,525
2020-05-30,0,0,0,0,FR_BFC_90,715,177,525
2020-05-31,1,0,1,1,FR_BFC_90,716,178,526
2020-06-01,0,0,0,1,FR_BFC_90,716,178,527
2020-06-02,1,0,1,3,FR_BFC_90,717,179,530
2020-06-03,0,0,0,1,FR_BFC_90,717,179,531
2020-06-04,2,0,1,7,FR_BFC_90,719,180,538
2020-06-05,1,0,0,2,FR_BFC_90,720,180,540
2020-06-06,0,0,0,0,FR_BFC_90,720,180,540
2020-06-07,0,0,0,1,FR_BFC_90,720,180,541
2020-06-08,0,0,0,0,FR_BFC_90,720,180,541
2020-06-09,1,0,2,1,FR_BFC_90,721,182,542
2020-06-10,0,0,2,1,FR_BFC_90,721,184,543
2020-06-11,2,0,0,2,FR_BFC_90,723,184,545
2020-06-12,0,0,0,2,FR_BFC_90,723,184,547
2020-06-13,0,0,2,0,FR_BFC_90,723,186,547
2020-06-14,0,0,0,0,FR_BFC_90,723,186,547
2020-06-15,1,0,0,0,FR_BFC_90,724,186,547
2020-06-16,1,0,0,2,FR_BFC_90,725,186,549
2020-06-17,0,0,1,3,FR_BFC_90,725,187,552
2020-06-18,1,0,1,2,FR_BFC_90,726,188,554
2020-06-19,0,0,0,0,FR_BFC_90,726,188,554
2020-06-20,0,0,0,0,FR_BFC_90,726,188,554
2020-06-21,0,0,0,0,FR_BFC_90,726,188,554
2020-06-22,1,1,0,0,FR_BFC_90,727,188,554
2020-06-23,1,0,0,0,FR_BFC_90,728,188,554
2020-06-24,0,0,0,1,FR_BFC_90,728,188,555
2020-03-19,49,14,1,4,FR_IDF_91,49,1,4
2020-03-20,40,6,1,3,FR_IDF_91,89,2,7
2020-03-21,40,7,2,1,FR_IDF_91,129,4,8
2020-03-22,62,17,0,5,FR_IDF_91,191,4,13
2020-03-23,48,22,0,5,FR_IDF_91,239,4,18
2020-03-24,60,7,4,19,FR_IDF_91,299,8,37
2020-03-25,100,16,5,23,FR_IDF_91,399,13,60
2020-03-26,77,19,3,12,FR_IDF_91,476,16,72
2020-03-27,52,11,3,12,FR_IDF_91,528,19,84
2020-03-28,111,34,3,35,FR_IDF_91,639,22,119
2020-03-29,43,8,12,12,FR_IDF_91,682,34,131
2020-03-30,83,19,10,7,FR_IDF_91,765,44,138
2020-03-31,91,29,9,23,FR_IDF_91,856,53,161
2020-04-01,88,17,11,15,FR_IDF_91,944,64,176
2020-04-02,127,24,20,30,FR_IDF_91,1071,84,206
2020-04-03,132,20,13,32,FR_IDF_91,1203,97,238
2020-04-04,116,10,14,24,FR_IDF_91,1319,111,262
2020-04-05,52,15,9,25,FR_IDF_91,1371,120,287
2020-04-06,74,17,24,33,FR_IDF_91,1445,144,320
2020-04-07,89,16,8,58,FR_IDF_91,1534,152,378
2020-04-08,221,19,16,33,FR_IDF_91,1755,168,411
2020-04-09,92,14,13,73,FR_IDF_91,1847,181,484
2020-04-10,122,14,16,52,FR_IDF_91,1969,197,536
2020-04-11,81,13,11,42,FR_IDF_91,2050,208,578
2020-04-12,63,5,10,24,FR_IDF_91,2113,218,602
2020-04-13,18,6,7,6,FR_IDF_91,2131,225,608
2020-04-14,57,12,27,41,FR_IDF_91,2188,252,649
2020-04-15,49,7,14,71,FR_IDF_91,2237,266,720
2020-04-16,67,12,13,53,FR_IDF_91,2304,279,773
2020-04-17,99,6,24,42,FR_IDF_91,2403,303,815
2020-04-18,36,5,8,36,FR_IDF_91,2439,311,851
2020-04-19,30,2,7,4,FR_IDF_91,2469,318,855
2020-04-20,33,9,10,15,FR_IDF_91,2502,328,870
2020-04-21,57,7,19,54,FR_IDF_91,2559,347,924
2020-04-22,33,5,9,24,FR_IDF_91,2592,356,948
2020-04-23,45,13,13,64,FR_IDF_91,2637,369,1012
2020-04-24,78,5,12,45,FR_IDF_91,2715,381,1057
2020-04-25,54,9,3,25,FR_IDF_91,2769,384,1082
2020-04-26,3,1,2,4,FR_IDF_91,2772,386,1086
2020-04-27,27,2,9,28,FR_IDF_91,2799,395,1114
2020-04-28,44,10,9,56,FR_IDF_91,2843,404,1170
2020-04-29,65,4,8,54,FR_IDF_91,2908,412,1224
2020-04-30,57,2,11,41,FR_IDF_91,2965,423,1265
2020-05-01,12,1,3,24,FR_IDF_91,2977,426,1289
2020-05-02,8,1,0,3,FR_IDF_91,2985,426,1292
2020-05-03,11,4,3,2,FR_IDF_91,2996,429,1294
2020-05-04,13,0,5,24,FR_IDF_91,3009,434,1318
2020-05-05,13,0,5,113,FR_IDF_91,3022,439,1431
2020-05-06,21,1,9,89,FR_IDF_91,3043,448,1520
2020-05-07,16,5,3,37,FR_IDF_91,3059,451,1557
2020-05-08,20,3,2,20,FR_IDF_91,3079,453,1577
2020-05-09,10,2,1,1,FR_IDF_91,3089,454,1578
2020-05-10,4,1,4,4,FR_IDF_91,3093,458,1582
2020-05-11,11,4,2,18,FR_IDF_91,3104,460,1600
2020-05-12,14,1,5,17,FR_IDF_91,3118,465,1617
2020-05-13,8,1,7,10,FR_IDF_91,3126,472,1627
2020-05-14,16,0,3,45,FR_IDF_91,3142,475,1672
2020-05-15,9,1,7,40,FR_IDF_91,3151,482,1712
2020-05-16,6,0,0,9,FR_IDF_91,3157,482,1721
2020-05-17,5,0,2,4,FR_IDF_91,3162,484,1725
2020-05-18,4,1,2,36,FR_IDF_91,3166,486,1761
2020-05-19,16,1,4,16,FR_IDF_91,3182,490,1777
2020-05-20,5,1,0,38,FR_IDF_91,3187,490,1815
2020-05-21,18,2,0,33,FR_IDF_91,3205,490,1848
2020-05-22,30,0,4,42,FR_IDF_91,3235,494,1890
2020-05-23,20,1,2,42,FR_IDF_91,3255,496,1932
2020-05-24,0,0,0,0,FR_IDF_91,3255,496,1932
2020-05-25,5,2,2,42,FR_IDF_91,3260,498,1974
2020-05-26,6,0,0,14,FR_IDF_91,3266,498,1988
2020-05-27,3,1,2,20,FR_IDF_91,3269,500,2008
2020-05-28,5,0,1,39,FR_IDF_91,3274,501,2047
2020-05-29,6,2,1,14,FR_IDF_91,3280,502,2061
2020-05-30,6,0,2,5,FR_IDF_91,3286,504,2066
2020-05-31,0,0,0,0,FR_IDF_91,3286,504,2066
2020-06-01,0,0,2,1,FR_IDF_91,3286,506,2067
2020-06-02,9,0,2,2,FR_IDF_91,3295,508,2069
2020-06-03,5,1,3,30,FR_IDF_91,3300,511,2099
2020-06-04,2,2,0,4,FR_IDF_91,3302,511,2103
2020-06-05,5,0,3,8,FR_IDF_91,3307,514,2111
2020-06-06,2,0,1,3,FR_IDF_91,3309,515,2114
2020-06-07,0,0,0,0,FR_IDF_91,3309,515,2114
2020-06-08,2,0,0,4,FR_IDF_91,3311,515,2118
2020-06-09,2,0,4,24,FR_IDF_91,3313,519,2142
2020-06-10,3,0,0,1,FR_IDF_91,3316,519,2143
2020-06-11,4,2,2,6,FR_IDF_91,3320,521,2149
2020-06-12,1,0,2,9,FR_IDF_91,3321,523,2158
2020-06-13,3,1,2,61,FR_IDF_91,3324,525,2219
2020-06-14,1,0,1,5,FR_IDF_91,3325,526,2224
2020-06-15,4,0,0,2,FR_IDF_91,3329,526,2226
2020-06-16,2,1,3,13,FR_IDF_91,3331,529,2239
2020-06-17,1,0,0,11,FR_IDF_91,3332,529,2250
2020-06-18,3,2,1,2,FR_IDF_91,3335,530,2252
2020-06-19,1,0,0,3,FR_IDF_91,3336,530,2255
2020-06-20,0,0,0,1,FR_IDF_91,3336,530,2256
2020-06-21,0,0,0,0,FR_IDF_91,3336,530,2256
2020-06-22,4,0,0,3,FR_IDF_91,3340,530,2259
2020-06-23,1,0,1,14,FR_IDF_91,3341,531,2273
2020-06-24,1,0,0,15,FR_IDF_91,3342,531,2288
2020-03-19,95,19,3,13,FR_IDF_92,95,3,13
2020-03-20,65,14,4,15,FR_IDF_92,160,7,28
2020-03-21,99,17,9,22,FR_IDF_92,259,16,50
2020-03-22,114,25,3,17,FR_IDF_92,373,19,67
2020-03-23,125,22,6,25,FR_IDF_92,498,25,92
2020-03-24,172,41,5,38,FR_IDF_92,670,30,130
2020-03-25,179,37,15,42,FR_IDF_92,849,45,172
2020-03-26,169,49,10,36,FR_IDF_92,1018,55,208
2020-03-27,191,29,18,34,FR_IDF_92,1209,73,242
2020-03-28,209,42,15,54,FR_IDF_92,1418,88,296
2020-03-29,126,34,22,31,FR_IDF_92,1544,110,327
2020-03-30,176,26,17,35,FR_IDF_92,1720,127,362
2020-03-31,290,45,22,81,FR_IDF_92,2010,149,443
2020-04-01,307,47,24,59,FR_IDF_92,2317,173,502
2020-04-02,245,29,38,96,FR_IDF_92,2562,211,598
2020-04-03,233,49,26,97,FR_IDF_92,2795,237,695
2020-04-04,186,29,31,62,FR_IDF_92,2981,268,757
2020-04-05,114,35,25,74,FR_IDF_92,3095,293,831
2020-04-06,156,32,27,86,FR_IDF_92,3251,320,917
2020-04-07,223,43,59,168,FR_IDF_92,3474,379,1085
2020-04-08,172,25,20,91,FR_IDF_92,3646,399,1176
2020-04-09,150,26,23,148,FR_IDF_92,3796,422,1324
2020-04-10,189,33,45,111,FR_IDF_92,3985,467,1435
2020-04-11,129,26,20,80,FR_IDF_92,4114,487,1515
2020-04-12,101,24,22,36,FR_IDF_92,4215,509,1551
2020-04-13,82,20,24,49,FR_IDF_92,4297,533,1600
2020-04-14,102,16,36,73,FR_IDF_92,4399,569,1673
2020-04-15,131,20,36,113,FR_IDF_92,4530,605,1786
2020-04-16,121,22,21,109,FR_IDF_92,4651,626,1895
2020-04-17,85,9,21,89,FR_IDF_92,4736,647,1984
2020-04-18,96,12,21,67,FR_IDF_92,4832,668,2051
2020-04-19,53,10,6,19,FR_IDF_92,4885,674,2070
2020-04-20,111,11,31,67,FR_IDF_92,4996,705,2137
2020-04-21,86,12,18,131,FR_IDF_92,5082,723,2268
2020-04-22,105,11,23,66,FR_IDF_92,5187,746,2334
2020-04-23,102,13,20,73,FR_IDF_92,5289,766,2407
2020-04-24,93,11,20,83,FR_IDF_92,5382,786,2490
2020-04-25,59,5,13,78,FR_IDF_92,5441,799,2568
2020-04-26,25,8,10,31,FR_IDF_92,5466,809,2599
2020-04-27,69,12,17,63,FR_IDF_92,5535,826,2662
2020-04-28,90,4,30,84,FR_IDF_92,5625,856,2746
2020-04-29,43,11,15,76,FR_IDF_92,5668,871,2822
2020-04-30,55,11,10,74,FR_IDF_92,5723,881,2896
2020-05-01,27,8,2,50,FR_IDF_92,5750,883,2946
2020-05-02,18,3,6,13,FR_IDF_92,5768,889,2959
2020-05-03,26,4,10,14,FR_IDF_92,5794,899,2973
2020-05-04,24,7,10,36,FR_IDF_92,5818,909,3009
2020-05-05,42,6,14,92,FR_IDF_92,5860,923,3101
2020-05-06,29,6,11,50,FR_IDF_92,5889,934,3151
2020-05-07,34,5,5,62,FR_IDF_92,5923,939,3213
2020-05-08,18,12,7,51,FR_IDF_92,5941,946,3264
2020-05-09,7,1,2,12,FR_IDF_92,5948,948,3276
2020-05-10,25,4,5,16,FR_IDF_92,5973,953,3292
2020-05-11,24,2,6,25,FR_IDF_92,5997,959,3317
2020-05-12,28,4,13,55,FR_IDF_92,6025,972,3372
2020-05-13,23,3,5,60,FR_IDF_92,6048,977,3432
2020-05-14,45,7,8,63,FR_IDF_92,6093,985,3495
2020-05-15,22,8,2,53,FR_IDF_92,6115,987,3548
2020-05-16,8,2,4,49,FR_IDF_92,6123,991,3597
2020-05-17,6,3,2,14,FR_IDF_92,6129,993,3611
2020-05-18,47,2,3,60,FR_IDF_92,6176,996,3671
2020-05-19,18,2,7,57,FR_IDF_92,6194,1003,3728
2020-05-20,20,0,7,55,FR_IDF_92,6214,1010,3783
2020-05-21,8,2,0,25,FR_IDF_92,6222,1010,3808
2020-05-22,4,0,3,8,FR_IDF_92,6226,1013,3816
2020-05-23,7,2,0,2,FR_IDF_92,6233,1013,3818
2020-05-24,3,0,3,6,FR_IDF_92,6236,1016,3824
2020-05-25,12,5,8,22,FR_IDF_92,6248,1024,3846
2020-05-26,13,2,2,38,FR_IDF_92,6261,1026,3884
2020-05-27,8,1,2,59,FR_IDF_92,6269,1028,3943
2020-05-28,11,3,6,20,FR_IDF_92,6280,1034,3963
2020-05-29,8,2,3,19,FR_IDF_92,6288,1037,3982
2020-05-30,14,3,3,47,FR_IDF_92,6302,1040,4029
2020-05-31,1,0,4,2,FR_IDF_92,6303,1044,4031
2020-06-01,2,0,5,6,FR_IDF_92,6305,1049,4037
2020-06-02,19,1,9,31,FR_IDF_92,6324,1058,4068
2020-06-03,11,2,7,39,FR_IDF_92,6335,1065,4107
2020-06-04,7,0,3,46,FR_IDF_92,6342,1068,4153
2020-06-05,2,0,1,23,FR_IDF_92,6344,1069,4176
2020-06-06,2,0,3,8,FR_IDF_92,6346,1072,4184
2020-06-07,1,1,1,0,FR_IDF_92,6347,1073,4184
2020-06-08,4,0,3,14,FR_IDF_92,6351,1076,4198
2020-06-09,23,3,2,40,FR_IDF_92,6374,1078,4238
2020-06-10,2,0,2,10,FR_IDF_92,6376,1080,4248
2020-06-11,8,2,2,19,FR_IDF_92,6384,1082,4267
2020-06-12,5,1,0,6,FR_IDF_92,6389,1082,4273
2020-06-13,1,0,1,3,FR_IDF_92,6390,1083,4276
2020-06-14,0,1,1,3,FR_IDF_92,6390,1084,4279
2020-06-15,3,1,2,8,FR_IDF_92,6393,1086,4287
2020-06-16,7,2,3,11,FR_IDF_92,6400,1089,4298
2020-06-17,0,0,2,16,FR_IDF_92,6400,1091,4314
2020-06-18,8,1,0,23,FR_IDF_92,6408,1091,4337
2020-06-19,5,2,0,8,FR_IDF_92,6413,1091,4345
2020-06-20,1,0,3,5,FR_IDF_92,6414,1094,4350
2020-06-21,0,0,0,0,FR_IDF_92,6414,1094,4350
2020-06-22,4,1,3,3,FR_IDF_92,6418,1097,4353
2020-06-23,9,1,1,42,FR_IDF_92,6427,1098,4395
2020-06-24,4,1,0,14,FR_IDF_92,6431,1098,4409
2020-03-19,103,30,9,16,FR_IDF_93,103,9,16
2020-03-20,44,6,5,11,FR_IDF_93,147,14,27
2020-03-21,51,10,1,6,FR_IDF_93,198,15,33
2020-03-22,28,9,4,6,FR_IDF_93,226,19,39
2020-03-23,73,15,4,12,FR_IDF_93,299,23,51
2020-03-24,86,23,10,17,FR_IDF_93,385,33,68
2020-03-25,84,10,9,9,FR_IDF_93,469,42,77
2020-03-26,119,20,21,20,FR_IDF_93,588,63,97
2020-03-27,160,17,14,25,FR_IDF_93,748,77,122
2020-03-28,99,21,18,62,FR_IDF_93,847,95,184
2020-03-29,114,4,13,13,FR_IDF_93,961,108,197
2020-03-30,136,19,11,22,FR_IDF_93,1097,119,219
2020-03-31,218,34,38,88,FR_IDF_93,1315,157,307
2020-04-01,278,45,26,47,FR_IDF_93,1593,183,354
2020-04-02,130,15,21,42,FR_IDF_93,1723,204,396
2020-04-03,165,24,35,54,FR_IDF_93,1888,239,450
2020-04-04,145,12,23,56,FR_IDF_93,2033,262,506
2020-04-05,67,12,22,14,FR_IDF_93,2100,284,520
2020-04-06,155,18,12,58,FR_IDF_93,2255,296,578
2020-04-07,214,36,72,65,FR_IDF_93,2469,368,643
2020-04-08,183,18,34,91,FR_IDF_93,2652,402,734
2020-04-09,257,17,44,116,FR_IDF_93,2909,446,850
2020-04-10,183,27,34,100,FR_IDF_93,3092,480,950
2020-04-11,123,10,14,73,FR_IDF_93,3215,494,1023
2020-04-12,95,9,10,55,FR_IDF_93,3310,504,1078
2020-04-13,61,16,24,45,FR_IDF_93,3371,528,1123
2020-04-14,127,15,34,87,FR_IDF_93,3498,562,1210
2020-04-15,126,25,29,108,FR_IDF_93,3624,591,1318
2020-04-16,123,26,25,96,FR_IDF_93,3747,616,1414
2020-04-17,183,9,46,126,FR_IDF_93,3930,662,1540
2020-04-18,94,14,26,43,FR_IDF_93,4024,688,1583
2020-04-19,47,7,12,40,FR_IDF_93,4071,700,1623
2020-04-20,86,10,12,67,FR_IDF_93,4157,712,1690
2020-04-21,82,8,13,72,FR_IDF_93,4239,725,1762
2020-04-22,104,12,18,77,FR_IDF_93,4343,743,1839
2020-04-23,92,3,18,70,FR_IDF_93,4435,761,1909
2020-04-24,61,4,17,69,FR_IDF_93,4496,778,1978
2020-04-25,31,3,7,62,FR_IDF_93,4527,785,2040
2020-04-26,28,2,5,24,FR_IDF_93,4555,790,2064
2020-04-27,97,9,21,44,FR_IDF_93,4652,811,2108
2020-04-28,79,15,20,96,FR_IDF_93,4731,831,2204
2020-04-29,42,8,12,46,FR_IDF_93,4773,843,2250
2020-04-30,21,4,5,39,FR_IDF_93,4794,848,2289
2020-05-01,25,5,8,19,FR_IDF_93,4819,856,2308
2020-05-02,15,1,1,22,FR_IDF_93,4834,857,2330
2020-05-03,11,3,2,12,FR_IDF_93,4845,859,2342
2020-05-04,36,5,10,24,FR_IDF_93,4881,869,2366
2020-05-05,44,3,7,59,FR_IDF_93,4925,876,2425
2020-05-06,81,4,8,80,FR_IDF_93,5006,884,2505
2020-05-07,55,6,9,84,FR_IDF_93,5061,893,2589
2020-05-08,24,2,3,22,FR_IDF_93,5085,896,2611
2020-05-09,17,3,4,23,FR_IDF_93,5102,900,2634
2020-05-10,17,3,2,29,FR_IDF_93,5119,902,2663
2020-05-11,36,4,6,65,FR_IDF_93,5155,908,2728
2020-05-12,60,11,14,98,FR_IDF_93,5215,922,2826
2020-05-13,39,2,3,68,FR_IDF_93,5254,925,2894
2020-05-14,16,3,2,39,FR_IDF_93,5270,927,2933
2020-05-15,17,6,3,42,FR_IDF_93,5287,930,2975
2020-05-16,19,3,2,41,FR_IDF_93,5306,932,3016
2020-05-17,1,0,3,10,FR_IDF_93,5307,935,3026
2020-05-18,18,1,5,40,FR_IDF_93,5325,940,3066
2020-05-19,30,5,6,31,FR_IDF_93,5355,946,3097
2020-05-20,41,2,2,40,FR_IDF_93,5396,948,3137
2020-05-21,14,5,2,7,FR_IDF_93,5410,950,3144
2020-05-22,8,1,2,14,FR_IDF_93,5418,952,3158
2020-05-23,5,3,2,11,FR_IDF_93,5423,954,3169
2020-05-24,4,2,1,1,FR_IDF_93,5427,955,3170
2020-05-25,14,1,2,16,FR_IDF_93,5441,957,3186
2020-05-26,15,1,2,35,FR_IDF_93,5456,959,3221
2020-05-27,10,1,2,28,FR_IDF_93,5466,961,3249
2020-05-28,16,0,1,39,FR_IDF_93,5482,962,3288
2020-05-29,5,1,2,56,FR_IDF_93,5487,964,3344
2020-05-30,5,0,0,20,FR_IDF_93,5492,964,3364
2020-05-31,0,0,0,2,FR_IDF_93,5492,964,3366
2020-06-01,10,3,0,1,FR_IDF_93,5502,964,3367
2020-06-02,13,2,6,18,FR_IDF_93,5515,970,3385
2020-06-03,13,5,3,28,FR_IDF_93,5528,973,3413
2020-06-04,11,1,1,30,FR_IDF_93,5539,974,3443
2020-06-05,7,0,4,31,FR_IDF_93,5546,978,3474
2020-06-06,3,2,2,9,FR_IDF_93,5549,980,3483
2020-06-07,4,0,0,3,FR_IDF_93,5553,980,3486
2020-06-08,5,2,1,10,FR_IDF_93,5558,981,3496
2020-06-09,11,1,2,17,FR_IDF_93,5569,983,3513
2020-06-10,4,1,1,9,FR_IDF_93,5573,984,3522
2020-06-11,6,1,1,20,FR_IDF_93,5579,985,3542
2020-06-12,16,1,0,42,FR_IDF_93,5595,985,3584
2020-06-13,1,0,1,12,FR_IDF_93,5596,986,3596
2020-06-14,2,1,1,2,FR_IDF_93,5598,987,3598
2020-06-15,12,0,2,10,FR_IDF_93,5610,989,3608
2020-06-16,4,0,3,18,FR_IDF_93,5614,992,3626
2020-06-17,3,0,1,6,FR_IDF_93,5617,993,3632
2020-06-18,10,1,1,19,FR_IDF_93,5627,994,3651
2020-06-19,3,0,0,9,FR_IDF_93,5630,994,3660
2020-06-20,13,1,1,3,FR_IDF_93,5643,995,3663
2020-06-21,3,0,0,0,FR_IDF_93,5646,995,3663
2020-06-22,8,0,2,44,FR_IDF_93,5654,997,3707
2020-06-23,7,0,1,9,FR_IDF_93,5661,998,3716
2020-06-24,8,2,0,21,FR_IDF_93,5669,998,3737
2020-03-19,113,17,6,35,FR_IDF_94,113,6,35
2020-03-20,66,14,1,17,FR_IDF_94,179,7,52
2020-03-21,57,6,0,12,FR_IDF_94,236,7,64
2020-03-22,74,17,6,15,FR_IDF_94,310,13,79
2020-03-23,106,25,6,18,FR_IDF_94,416,19,97
2020-03-24,122,30,3,19,FR_IDF_94,538,22,116
2020-03-25,144,36,7,33,FR_IDF_94,682,29,149
2020-03-26,159,15,18,30,FR_IDF_94,841,47,179
2020-03-27,158,12,17,30,FR_IDF_94,999,64,209
2020-03-28,177,26,15,46,FR_IDF_94,1176,79,255
2020-03-29,120,12,17,19,FR_IDF_94,1296,96,274
2020-03-30,112,13,3,28,FR_IDF_94,1408,99,302
2020-03-31,258,27,46,68,FR_IDF_94,1666,145,370
2020-04-01,319,54,39,82,FR_IDF_94,1985,184,452
2020-04-02,208,34,27,54,FR_IDF_94,2193,211,506
2020-04-03,272,45,38,86,FR_IDF_94,2465,249,592
2020-04-04,163,21,32,78,FR_IDF_94,2628,281,670
2020-04-05,128,19,22,25,FR_IDF_94,2756,303,695
2020-04-06,186,23,49,34,FR_IDF_94,2942,352,729
2020-04-07,295,42,49,93,FR_IDF_94,3237,401,822
2020-04-08,250,45,54,91,FR_IDF_94,3487,455,913
2020-04-09,176,22,21,74,FR_IDF_94,3663,476,987
2020-04-10,203,22,37,79,FR_IDF_94,3866,513,1066
2020-04-11,123,14,14,48,FR_IDF_94,3989,527,1114
2020-04-12,85,23,19,54,FR_IDF_94,4074,546,1168
2020-04-13,87,20,32,27,FR_IDF_94,4161,578,1195
2020-04-14,84,36,36,39,FR_IDF_94,4245,614,1234
2020-04-15,193,21,35,116,FR_IDF_94,4438,649,1350
2020-04-16,124,25,41,109,FR_IDF_94,4562,690,1459
2020-04-17,91,20,20,73,FR_IDF_94,4653,710,1532
2020-04-18,80,18,22,76,FR_IDF_94,4733,732,1608
2020-04-19,24,8,10,11,FR_IDF_94,4757,742,1619
2020-04-20,85,14,33,45,FR_IDF_94,4842,775,1664
2020-04-21,129,10,30,87,FR_IDF_94,4971,805,1751
2020-04-22,97,11,25,180,FR_IDF_94,5068,830,1931
2020-04-23,95,14,10,94,FR_IDF_94,5163,840,2025
2020-04-24,72,4,22,136,FR_IDF_94,5235,862,2161
2020-04-25,72,17,14,79,FR_IDF_94,5307,876,2240
2020-04-26,26,2,11,9,FR_IDF_94,5333,887,2249
2020-04-27,28,4,22,27,FR_IDF_94,5361,909,2276
2020-04-28,64,4,19,100,FR_IDF_94,5425,928,2376
2020-04-29,59,4,12,51,FR_IDF_94,5484,940,2427
2020-04-30,39,2,13,71,FR_IDF_94,5523,953,2498
2020-05-01,34,4,8,23,FR_IDF_94,5557,961,2521
2020-05-02,20,9,6,24,FR_IDF_94,5577,967,2545
2020-05-03,15,5,3,23,FR_IDF_94,5592,970,2568
2020-05-04,33,5,10,69,FR_IDF_94,5625,980,2637
2020-05-05,82,3,11,122,FR_IDF_94,5707,991,2759
2020-05-06,66,10,11,91,FR_IDF_94,5773,1002,2850
2020-05-07,40,4,6,91,FR_IDF_94,5813,1008,2941
2020-05-08,23,2,10,28,FR_IDF_94,5836,1018,2969
2020-05-09,6,0,4,6,FR_IDF_94,5842,1022,2975
2020-05-10,11,0,3,12,FR_IDF_94,5853,1025,2987
2020-05-11,25,4,8,59,FR_IDF_94,5878,1033,3046
2020-05-12,18,2,19,92,FR_IDF_94,5896,1052,3138
2020-05-13,34,3,8,30,FR_IDF_94,5930,1060,3168
2020-05-14,21,2,6,50,FR_IDF_94,5951,1066,3218
2020-05-15,17,1,2,36,FR_IDF_94,5968,1068,3254
2020-05-16,16,1,2,28,FR_IDF_94,5984,1070,3282
2020-05-17,9,1,4,5,FR_IDF_94,5993,1074,3287
2020-05-18,12,1,6,49,FR_IDF_94,6005,1080,3336
2020-05-19,24,3,10,50,FR_IDF_94,6029,1090,3386
2020-05-20,30,0,10,22,FR_IDF_94,6059,1100,3408
2020-05-21,28,0,4,18,FR_IDF_94,6087,1104,3426
2020-05-22,4,1,2,9,FR_IDF_94,6091,1106,3435
2020-05-23,2,1,0,10,FR_IDF_94,6093,1106,3445
2020-05-24,6,3,3,1,FR_IDF_94,6099,1109,3446
2020-05-25,21,1,2,44,FR_IDF_94,6120,1111,3490
2020-05-26,17,3,6,36,FR_IDF_94,6137,1117,3526
2020-05-27,19,4,5,19,FR_IDF_94,6156,1122,3545
2020-05-28,17,1,3,10,FR_IDF_94,6173,1125,3555
2020-05-29,5,2,3,12,FR_IDF_94,6178,1128,3567
2020-05-30,16,0,24,64,FR_IDF_94,6194,1152,3631
2020-05-31,1,0,11,9,FR_IDF_94,6195,1163,3640
2020-06-01,3,0,2,21,FR_IDF_94,6198,1165,3661
2020-06-02,7,0,1,7,FR_IDF_94,6205,1166,3668
2020-06-03,10,0,13,88,FR_IDF_94,6215,1179,3756
2020-06-04,16,1,4,28,FR_IDF_94,6231,1183,3784
2020-06-05,4,0,1,13,FR_IDF_94,6235,1184,3797
2020-06-06,15,1,5,73,FR_IDF_94,6250,1189,3870
2020-06-07,0,0,2,5,FR_IDF_94,6250,1191,3875
2020-06-08,4,0,1,6,FR_IDF_94,6254,1192,3881
2020-06-09,10,0,10,32,FR_IDF_94,6264,1202,3913
2020-06-10,2,0,1,7,FR_IDF_94,6266,1203,3920
2020-06-11,8,2,1,17,FR_IDF_94,6274,1204,3937
2020-06-12,1,0,0,18,FR_IDF_94,6275,1204,3955
2020-06-13,0,0,3,17,FR_IDF_94,6275,1207,3972
2020-06-14,0,0,0,0,FR_IDF_94,6275,1207,3972
2020-06-15,3,0,1,34,FR_IDF_94,6278,1208,4006
2020-06-16,5,0,4,31,FR_IDF_94,6283,1212,4037
2020-06-17,5,1,1,3,FR_IDF_94,6288,1213,4040
2020-06-18,5,0,0,5,FR_IDF_94,6293,1213,4045
2020-06-19,13,0,0,29,FR_IDF_94,6306,1213,4074
2020-06-20,4,0,5,30,FR_IDF_94,6310,1218,4104
2020-06-21,1,0,0,3,FR_IDF_94,6311,1218,4107
2020-06-22,19,0,0,8,FR_IDF_94,6330,1218,4115
2020-06-23,2,1,2,12,FR_IDF_94,6332,1220,4127
2020-06-24,1,0,0,6,FR_IDF_94,6333,1220,4133
2020-03-19,80,8,4,15,FR_IDF_95,80,4,15
2020-03-20,60,12,4,21,FR_IDF_95,140,8,36
2020-03-21,74,10,4,18,FR_IDF_95,214,12,54
2020-03-22,87,12,7,9,FR_IDF_95,301,19,63
2020-03-23,72,15,9,13,FR_IDF_95,373,28,76
2020-03-24,63,23,10,35,FR_IDF_95,436,38,111
2020-03-25,103,16,13,30,FR_IDF_95,539,51,141
2020-03-26,106,9,15,29,FR_IDF_95,645,66,170
2020-03-27,133,13,14,63,FR_IDF_95,778,80,233
2020-03-28,75,10,12,30,FR_IDF_95,853,92,263
2020-03-29,115,15,21,52,FR_IDF_95,968,113,315
2020-03-30,118,14,14,37,FR_IDF_95,1086,127,352
2020-03-31,145,21,16,44,FR_IDF_95,1231,143,396
2020-04-01,120,9,13,71,FR_IDF_95,1351,156,467
2020-04-02,146,19,18,55,FR_IDF_95,1497,174,522
2020-04-03,133,16,26,60,FR_IDF_95,1630,200,582
2020-04-04,91,14,14,52,FR_IDF_95,1721,214,634
2020-04-05,40,8,5,27,FR_IDF_95,1761,219,661
2020-04-06,129,13,42,63,FR_IDF_95,1890,261,724
2020-04-07,105,17,24,43,FR_IDF_95,1995,285,767
2020-04-08,113,12,25,69,FR_IDF_95,2108,310,836
2020-04-09,127,32,16,56,FR_IDF_95,2235,326,892
2020-04-10,83,10,30,90,FR_IDF_95,2318,356,982
2020-04-11,89,14,11,60,FR_IDF_95,2407,367,1042
2020-04-12,35,11,11,20,FR_IDF_95,2442,378,1062
2020-04-13,40,3,10,26,FR_IDF_95,2482,388,1088
2020-04-14,79,6,12,33,FR_IDF_95,2561,400,1121
2020-04-15,67,7,11,69,FR_IDF_95,2628,411,1190
2020-04-16,101,5,17,83,FR_IDF_95,2729,428,1273
2020-04-17,60,3,11,63,FR_IDF_95,2789,439,1336
2020-04-18,50,6,17,46,FR_IDF_95,2839,456,1382
2020-04-19,29,4,13,15,FR_IDF_95,2868,469,1397
2020-04-20,51,4,14,23,FR_IDF_95,2919,483,1420
2020-04-21,45,4,9,48,FR_IDF_95,2964,492,1468
2020-04-22,76,4,10,34,FR_IDF_95,3040,502,1502
2020-04-23,56,3,15,40,FR_IDF_95,3096,517,1542
2020-04-24,43,5,15,41,FR_IDF_95,3139,532,1583
2020-04-25,26,4,6,33,FR_IDF_95,3165,538,1616
2020-04-26,11,1,5,10,FR_IDF_95,3176,543,1626
2020-04-27,18,0,8,13,FR_IDF_95,3194,551,1639
2020-04-28,45,4,18,27,FR_IDF_95,3239,569,1666
2020-04-29,21,0,10,37,FR_IDF_95,3260,579,1703
2020-04-30,17,0,5,33,FR_IDF_95,3277,584,1736
2020-05-01,22,1,6,28,FR_IDF_95,3299,590,1764
2020-05-02,5,0,5,5,FR_IDF_95,3304,595,1769
2020-05-03,5,0,1,6,FR_IDF_95,3309,596,1775
2020-05-04,32,3,12,20,FR_IDF_95,3341,608,1795
2020-05-05,26,1,7,32,FR_IDF_95,3367,615,1827
2020-05-06,22,1,3,46,FR_IDF_95,3389,618,1873
2020-05-07,14,3,2,30,FR_IDF_95,3403,620,1903
2020-05-08,15,3,7,16,FR_IDF_95,3418,627,1919
2020-05-09,7,0,0,3,FR_IDF_95,3425,627,1922
2020-05-10,10,1,5,11,FR_IDF_95,3435,632,1933
2020-05-11,4,1,2,9,FR_IDF_95,3439,634,1942
2020-05-12,14,2,6,36,FR_IDF_95,3453,640,1978
2020-05-13,14,5,7,34,FR_IDF_95,3467,647,2012
2020-05-14,17,1,4,17,FR_IDF_95,3484,651,2029
2020-05-15,8,1,2,19,FR_IDF_95,3492,653,2048
2020-05-16,13,1,5,35,FR_IDF_95,3505,658,2083
2020-05-17,2,0,3,6,FR_IDF_95,3507,661,2089
2020-05-18,6,1,5,9,FR_IDF_95,3513,666,2098
2020-05-19,22,2,5,48,FR_IDF_95,3535,671,2146
2020-05-20,13,3,0,33,FR_IDF_95,3548,671,2179
2020-05-21,4,0,2,28,FR_IDF_95,3552,673,2207
2020-05-22,17,1,6,13,FR_IDF_95,3569,679,2220
2020-05-23,4,0,0,17,FR_IDF_95,3573,679,2237
2020-05-24,6,1,0,4,FR_IDF_95,3579,679,2241
2020-05-25,16,1,1,31,FR_IDF_95,3595,680,2272
2020-05-26,4,1,7,23,FR_IDF_95,3599,687,2295
2020-05-27,3,1,4,10,FR_IDF_95,3602,691,2305
2020-05-28,4,0,1,12,FR_IDF_95,3606,692,2317
2020-05-29,19,2,0,24,FR_IDF_95,3625,692,2341
2020-05-30,5,0,3,9,FR_IDF_95,3630,695,2350
2020-05-31,0,0,0,3,FR_IDF_95,3630,695,2353
2020-06-01,8,0,1,5,FR_IDF_95,3638,696,2358
2020-06-02,1,0,4,10,FR_IDF_95,3639,700,2368
2020-06-03,7,0,1,7,FR_IDF_95,3646,701,2375
2020-06-04,3,0,0,11,FR_IDF_95,3649,701,2386
2020-06-05,2,1,1,17,FR_IDF_95,3651,702,2403
2020-06-06,3,0,0,10,FR_IDF_95,3654,702,2413
2020-06-07,0,0,0,0,FR_IDF_95,3654,702,2413
2020-06-08,7,0,2,10,FR_IDF_95,3661,704,2423
2020-06-09,9,0,1,15,FR_IDF_95,3670,705,2438
2020-06-10,1,0,0,12,FR_IDF_95,3671,705,2450
2020-06-11,1,0,0,7,FR_IDF_95,3672,705,2457
2020-06-12,0,0,4,18,FR_IDF_95,3672,709,2475
2020-06-13,2,0,0,9,FR_IDF_95,3674,709,2484
2020-06-14,0,0,0,3,FR_IDF_95,3674,709,2487
2020-06-15,5,0,4,5,FR_IDF_95,3679,713,2492
2020-06-16,1,0,3,4,FR_IDF_95,3680,716,2496
2020-06-17,0,0,0,8,FR_IDF_95,3680,716,2504
2020-06-18,3,0,0,11,FR_IDF_95,3683,716,2515
2020-06-19,2,0,0,7,FR_IDF_95,3685,716,2522
2020-06-20,1,0,0,26,FR_IDF_95,3686,716,2548
2020-06-21,0,0,0,0,FR_IDF_95,3686,716,2548
2020-06-22,2,0,0,4,FR_IDF_95,3688,716,2552
2020-06-23,4,0,4,14,FR_IDF_95,3692,720,2566
2020-06-24,3,0,0,0,FR_IDF_95,3695,720,2566
2020-03-19,58,10,1,9,FR_COR_2A,58,1,9
2020-03-20,8,0,2,1,FR_COR_2A,66,3,10
2020-03-21,4,0,1,3,FR_COR_2A,70,4,13
2020-03-22,7,2,2,1,FR_COR_2A,77,6,14
2020-03-23,8,2,1,1,FR_COR_2A,85,7,15
2020-03-24,8,0,0,4,FR_COR_2A,93,7,19
2020-03-25,21,0,7,3,FR_COR_2A,114,14,22
2020-03-26,18,4,3,2,FR_COR_2A,132,17,24
2020-03-27,10,0,0,2,FR_COR_2A,142,17,26
2020-03-28,9,6,0,2,FR_COR_2A,151,17,28
2020-03-29,15,4,0,6,FR_COR_2A,166,17,34
2020-03-30,14,1,0,12,FR_COR_2A,180,17,46
2020-03-31,3,2,1,4,FR_COR_2A,183,18,50
2020-04-01,3,3,1,0,FR_COR_2A,186,19,50
2020-04-02,6,1,2,2,FR_COR_2A,192,21,52
2020-04-03,3,1,3,2,FR_COR_2A,195,24,54
2020-04-04,7,1,0,0,FR_COR_2A,202,24,54
2020-04-05,0,0,0,2,FR_COR_2A,202,24,56
2020-04-06,1,1,3,0,FR_COR_2A,203,27,56
2020-04-07,5,3,2,0,FR_COR_2A,208,29,56
2020-04-08,4,3,0,1,FR_COR_2A,212,29,57
2020-04-09,1,1,2,2,FR_COR_2A,213,31,59
2020-04-10,0,0,1,4,FR_COR_2A,213,32,63
2020-04-11,1,0,1,2,FR_COR_2A,214,33,65
2020-04-12,3,1,0,2,FR_COR_2A,217,33,67
2020-04-13,3,1,2,0,FR_COR_2A,220,35,67
2020-04-14,2,1,0,2,FR_COR_2A,222,35,69
2020-04-15,1,0,1,2,FR_COR_2A,223,36,71
2020-04-16,0,0,0,1,FR_COR_2A,223,36,72
2020-04-17,2,1,1,0,FR_COR_2A,225,37,72
2020-04-18,2,0,0,8,FR_COR_2A,227,37,80
2020-04-19,4,0,2,2,FR_COR_2A,231,39,82
2020-04-20,0,1,2,0,FR_COR_2A,231,41,82
2020-04-21,1,0,0,4,FR_COR_2A,232,41,86
2020-04-22,3,0,0,5,FR_COR_2A,235,41,91
2020-04-23,1,0,0,4,FR_COR_2A,236,41,95
2020-04-24,4,0,0,2,FR_COR_2A,240,41,97
2020-04-25,0,0,1,3,FR_COR_2A,240,42,100
2020-04-26,0,0,0,0,FR_COR_2A,240,42,100
2020-04-27,0,0,0,0,FR_COR_2A,240,42,100
2020-04-28,1,0,0,5,FR_COR_2A,241,42,105
2020-04-29,1,0,0,5,FR_COR_2A,242,42,110
2020-04-30,2,0,0,3,FR_COR_2A,244,42,113
2020-05-01,3,0,0,1,FR_COR_2A,247,42,114
2020-05-02,0,0,0,0,FR_COR_2A,247,42,114
2020-05-03,0,0,1,0,FR_COR_2A,247,43,114
2020-05-04,0,0,0,0,FR_COR_2A,247,43,114
2020-05-05,0,0,0,0,FR_COR_2A,247,43,114
2020-05-06,0,0,1,1,FR_COR_2A,247,44,115
2020-05-07,0,0,0,0,FR_COR_2A,247,44,115
2020-05-08,0,0,0,2,FR_COR_2A,247,44,117
2020-05-09,1,0,0,0,FR_COR_2A,248,44,117
2020-05-10,0,0,0,0,FR_COR_2A,248,44,117
2020-05-11,1,0,0,0,FR_COR_2A,249,44,117
2020-05-12,0,0,0,5,FR_COR_2A,249,44,122
2020-05-13,0,0,1,0,FR_COR_2A,249,45,122
2020-05-14,0,0,0,1,FR_COR_2A,249,45,123
2020-05-15,0,0,2,2,FR_COR_2A,249,47,125
2020-05-16,0,0,0,0,FR_COR_2A,249,47,125
2020-05-17,0,0,0,0,FR_COR_2A,249,47,125
2020-05-18,0,0,0,2,FR_COR_2A,249,47,127
2020-05-19,0,0,0,2,FR_COR_2A,249,47,129
2020-05-20,0,0,0,3,FR_COR_2A,249,47,132
2020-05-21,0,0,0,0,FR_COR_2A,249,47,132
2020-05-22,0,0,0,0,FR_COR_2A,249,47,132
2020-05-23,0,0,0,0,FR_COR_2A,249,47,132
2020-05-24,0,0,1,0,FR_COR_2A,249,48,132
2020-05-25,0,0,0,0,FR_COR_2A,249,48,132
2020-05-26,1,1,0,0,FR_COR_2A,250,48,132
2020-05-27,0,0,0,6,FR_COR_2A,250,48,138
2020-05-28,0,0,0,1,FR_COR_2A,250,48,139
2020-05-29,1,0,0,0,FR_COR_2A,251,48,139
2020-05-30,0,0,0,0,FR_COR_2A,251,48,139
2020-05-31,0,0,0,0,FR_COR_2A,251,48,139
2020-06-01,0,0,0,0,FR_COR_2A,251,48,139
2020-06-02,0,0,0,0,FR_COR_2A,251,48,139
2020-06-03,0,0,0,1,FR_COR_2A,251,48,140
2020-06-04,0,0,0,3,FR_COR_2A,251,48,143
2020-06-05,0,0,0,0,FR_COR_2A,251,48,143
2020-06-06,0,0,0,0,FR_COR_2A,251,48,143
2020-06-07,0,0,0,0,FR_COR_2A,251,48,143
2020-06-08,2,0,0,0,FR_COR_2A,253,48,143
2020-06-09,0,0,0,0,FR_COR_2A,253,48,143
2020-06-10,0,0,0,1,FR_COR_2A,253,48,144
2020-06-11,0,0,0,0,FR_COR_2A,253,48,144
2020-06-12,0,0,0,2,FR_COR_2A,253,48,146
2020-06-13,0,0,0,4,FR_COR_2A,253,48,150
2020-06-14,0,0,0,0,FR_COR_2A,253,48,150
2020-06-15,0,0,0,1,FR_COR_2A,253,48,151
2020-06-16,0,0,0,0,FR_COR_2A,253,48,151
2020-06-17,0,0,0,0,FR_COR_2A,253,48,151
2020-06-18,0,0,0,0,FR_COR_2A,253,48,151
2020-06-19,0,0,0,0,FR_COR_2A,253,48,151
2020-06-20,0,0,0,0,FR_COR_2A,253,48,151
2020-06-21,0,0,0,0,FR_COR_2A,253,48,151
2020-06-22,0,0,0,0,FR_COR_2A,253,48,151
2020-06-23,0,0,0,2,FR_COR_2A,253,48,153
2020-06-24,0,0,0,0,FR_COR_2A,253,48,153
2020-03-19,1,0,0,1,FR_COR_2B,1,0,1
2020-03-20,28,0,0,22,FR_COR_2B,29,0,23
2020-03-21,0,0,0,0,FR_COR_2B,29,0,23
2020-03-22,0,0,0,0,FR_COR_2B,29,0,23
2020-03-23,8,0,0,8,FR_COR_2B,37,0,31
2020-03-24,4,0,0,3,FR_COR_2B,41,0,34
2020-03-25,1,0,1,0,FR_COR_2B,42,1,34
2020-03-26,9,0,1,8,FR_COR_2B,51,2,42
2020-03-27,5,1,0,5,FR_COR_2B,56,2,47
2020-03-28,1,0,0,0,FR_COR_2B,57,2,47
2020-03-29,1,0,0,2,FR_COR_2B,58,2,49
2020-03-30,0,0,0,0,FR_COR_2B,58,2,49
2020-03-31,10,0,0,8,FR_COR_2B,68,2,57
2020-04-01,0,0,0,3,FR_COR_2B,68,2,60
2020-04-02,14,2,0,6,FR_COR_2B,82,2,66
2020-04-03,6,0,0,5,FR_COR_2B,88,2,71
2020-04-04,20,1,0,2,FR_COR_2B,108,2,73
2020-04-05,0,0,0,0,FR_COR_2B,108,2,73
2020-04-06,0,0,1,0,FR_COR_2B,108,3,73
2020-04-07,0,0,0,1,FR_COR_2B,108,3,74
2020-04-08,2,0,0,2,FR_COR_2B,110,3,76
2020-04-09,1,0,0,0,FR_COR_2B,111,3,76
2020-04-10,0,0,0,4,FR_COR_2B,111,3,80
2020-04-11,0,0,0,0,FR_COR_2B,111,3,80
2020-04-12,0,0,0,2,FR_COR_2B,111,3,82
2020-04-13,0,0,0,0,FR_COR_2B,111,3,82
2020-04-14,0,0,0,1,FR_COR_2B,111,3,83
2020-04-15,13,1,2,0,FR_COR_2B,124,5,83
2020-04-16,3,1,0,2,FR_COR_2B,127,5,85
2020-04-17,0,0,0,1,FR_COR_2B,127,5,86
2020-04-18,2,0,0,3,FR_COR_2B,129,5,89
2020-04-19,0,0,0,2,FR_COR_2B,129,5,91
2020-04-20,0,1,1,2,FR_COR_2B,129,6,93
2020-04-21,1,0,1,1,FR_COR_2B,130,7,94
2020-04-22,5,1,1,0,FR_COR_2B,135,8,94
2020-04-23,0,0,0,0,FR_COR_2B,135,8,94
2020-04-24,2,0,0,0,FR_COR_2B,137,8,94
2020-04-25,0,0,0,2,FR_COR_2B,137,8,96
2020-04-26,0,0,0,0,FR_COR_2B,137,8,96
2020-04-27,0,0,0,0,FR_COR_2B,137,8,96
2020-04-28,4,1,0,2,FR_COR_2B,141,8,98
2020-04-29,1,0,0,2,FR_COR_2B,142,8,100
2020-04-30,1,0,0,0,FR_COR_2B,143,8,100
2020-05-01,0,0,0,0,FR_COR_2B,143,8,100
2020-05-02,0,0,0,2,FR_COR_2B,143,8,102
2020-05-03,0,0,0,0,FR_COR_2B,143,8,102
2020-05-04,1,0,0,2,FR_COR_2B,144,8,104
2020-05-05,1,0,0,2,FR_COR_2B,145,8,106
2020-05-06,0,0,0,1,FR_COR_2B,145,8,107
2020-05-07,0,0,0,2,FR_COR_2B,145,8,109
2020-05-08,0,0,0,0,FR_COR_2B,145,8,109
2020-05-09,0,0,0,0,FR_COR_2B,145,8,109
2020-05-10,0,0,0,0,FR_COR_2B,145,8,109
2020-05-11,0,0,0,0,FR_COR_2B,145,8,109
2020-05-12,5,3,1,0,FR_COR_2B,150,9,109
2020-05-13,1,0,0,2,FR_COR_2B,151,9,111
2020-05-14,0,1,0,0,FR_COR_2B,151,9,111
2020-05-15,0,0,0,2,FR_COR_2B,151,9,113
2020-05-16,0,0,0,0,FR_COR_2B,151,9,113
2020-05-17,0,0,0,0,FR_COR_2B,151,9,113
2020-05-18,2,0,1,0,FR_COR_2B,153,10,113
2020-05-19,1,0,0,0,FR_COR_2B,154,10,113
2020-05-20,0,0,0,0,FR_COR_2B,154,10,113
2020-05-21,0,0,0,0,FR_COR_2B,154,10,113
2020-05-22,0,0,0,1,FR_COR_2B,154,10,114
2020-05-23,0,0,0,0,FR_COR_2B,154,10,114
2020-05-24,0,0,0,0,FR_COR_2B,154,10,114
2020-05-25,0,0,0,0,FR_COR_2B,154,10,114
2020-05-26,0,0,0,0,FR_COR_2B,154,10,114
2020-05-27,1,0,0,0,FR_COR_2B,155,10,114
2020-05-28,0,0,0,0,FR_COR_2B,155,10,114
2020-05-29,0,0,0,3,FR_COR_2B,155,10,117
2020-05-30,0,0,0,0,FR_COR_2B,155,10,117
2020-05-31,0,0,0,0,FR_COR_2B,155,10,117
2020-06-01,0,0,0,0,FR_COR_2B,155,10,117
2020-06-02,0,0,0,0,FR_COR_2B,155,10,117
2020-06-03,0,0,0,0,FR_COR_2B,155,10,117
2020-06-04,0,0,0,0,FR_COR_2B,155,10,117
2020-06-05,0,0,0,0,FR_COR_2B,155,10,117
2020-06-06,1,0,0,0,FR_COR_2B,156,10,117
2020-06-07,0,0,0,0,FR_COR_2B,156,10,117
2020-06-08,0,0,0,1,FR_COR_2B,156,10,118
2020-06-09,0,0,0,0,FR_COR_2B,156,10,118
2020-06-10,0,0,0,0,FR_COR_2B,156,10,118
2020-06-11,0,0,0,0,FR_COR_2B,156,10,118
2020-06-12,0,0,1,0,FR_COR_2B,156,11,118
2020-06-13,0,0,0,0,FR_COR_2B,156,11,118
2020-06-14,0,0,0,0,FR_COR_2B,156,11,118
2020-06-15,0,0,0,1,FR_COR_2B,156,11,119
2020-06-16,0,0,0,0,FR_COR_2B,156,11,119
2020-06-17,0,0,0,0,FR_COR_2B,156,11,119
2020-06-18,0,0,0,0,FR_COR_2B,156,11,119
2020-06-19,0,0,0,0,FR_COR_2B,156,11,119
2020-06-20,0,0,0,0,FR_COR_2B,156,11,119
2020-06-21,0,0,0,0,FR_COR_2B,156,11,119
2020-06-22,0,0,0,0,FR_COR_2B,156,11,119
2020-06-23,0,0,0,0,FR_COR_2B,156,11,119
2020-06-24,0,0,0,0,FR_COR_2B,156,11,119
