date,bkcasecount,bkhospitalizedcount,bkdeathcount,new_confirmed,new_hospitalized,new_deceased,mncasecount,mnhospitalizedcount,mndeathcount,qncasecount,qnhospitalizedcount,qndeathcount,sicasecount,sihospitalizedcount,sideathcount,bxcasecount,bxhospitalizedcount,bxdeathcount,key,total_confirmed,total_hospitalized,total_deceased
2020-02-29,0,4,0,0,3,0,1,2,0,0,2,0,0,0,0,,,,US_NY_36005,0,3,0
2020-03-01,0,0,0,1,1,0,0,0,0,0,2,0,0,1,0,,,,US_NY_36005,1,4,0
2020-03-02,0,4,0,0,9,0,0,4,0,0,5,0,0,0,0,,,,US_NY_36005,1,13,0
2020-03-03,0,5,0,1,7,0,0,2,0,1,5,0,0,1,0,,,,US_NY_36005,2,20,0
2020-03-04,1,5,0,0,6,0,2,6,0,2,3,0,0,2,0,,,,US_NY_36005,2,26,0
2020-03-05,3,5,0,0,2,0,0,6,0,0,6,0,0,1,0,,,,US_NY_36005,2,28,0
2020-03-06,1,3,0,2,5,0,3,3,0,1,5,0,1,2,0,,,,US_NY_36005,4,33,0
2020-03-07,2,6,0,0,2,0,1,4,0,3,3,0,1,0,0,,,,US_NY_36005,4,35,0
2020-03-08,5,9,0,4,2,0,6,1,0,5,5,0,1,0,0,,,,US_NY_36005,8,37,0
2020-03-09,16,15,0,4,11,0,25,12,0,10,8,0,3,3,0,,,,US_NY_36005,12,48,0
2020-03-10,11,13,0,8,8,0,24,13,0,24,23,0,2,5,0,,,,US_NY_36005,20,56,0
2020-03-11,31,15,0,19,20,0,61,21,0,40,30,1,3,3,0,,,,US_NY_36005,39,76,0
2020-03-12,96,26,0,29,16,0,138,11,0,80,29,0,13,5,0,,,,US_NY_36005,68,92,0
2020-03-13,166,36,0,79,34,0,182,27,0,166,48,0,26,3,0,,,,US_NY_36005,147,126,0
2020-03-14,163,36,1,86,26,0,179,28,0,194,57,1,22,8,0,,,,US_NY_36005,233,152,0
2020-03-15,430,43,0,118,34,1,209,30,2,230,64,1,46,16,1,,,,US_NY_36005,351,186,1
2020-03-16,739,83,1,303,65,3,458,40,0,530,106,4,91,17,0,,,,US_NY_36005,654,251,4
2020-03-17,786,98,4,343,65,1,566,57,0,650,108,3,108,21,0,,,,US_NY_36005,997,316,5
2020-03-18,970,111,6,483,100,1,540,76,4,832,152,9,150,23,0,,,,US_NY_36005,1480,416,6
2020-03-19,1209,147,6,620,122,4,554,91,4,1065,160,6,258,32,4,,,,US_NY_36005,2100,538,10
2020-03-20,1140,186,10,719,111,13,657,110,11,1184,223,9,309,30,3,,,,US_NY_36005,2819,649,23
2020-03-21,558,172,12,483,152,12,402,115,5,945,223,14,248,34,1,,,,US_NY_36005,3302,801,35
2020-03-22,757,182,10,491,163,12,322,126,8,695,223,14,316,32,6,,,,US_NY_36005,3793,964,47
2020-03-23,911,276,27,723,207,12,538,174,7,1189,332,28,209,46,8,,,,US_NY_36005,4516,1171,59
2020-03-24,1211,300,23,927,253,14,628,188,17,1389,361,34,349,48,6,,,,US_NY_36005,5443,1424,73
2020-03-25,1232,371,36,1054,289,30,594,185,20,1571,398,30,394,49,4,,,,US_NY_36005,6497,1713,103
2020-03-26,1357,441,49,999,306,37,627,214,34,1640,424,56,403,47,10,,,,US_NY_36005,7496,2019,140
2020-03-27,1406,400,73,1087,306,34,659,202,41,1574,411,56,371,57,7,,,,US_NY_36005,8583,2325,174
2020-03-28,849,354,75,763,301,61,387,204,28,1202,435,89,266,53,13,,,,US_NY_36005,9346,2626,235
2020-03-29,1121,412,87,699,310,54,408,160,35,1075,452,92,230,57,17,,,,US_NY_36005,10045,2936,289
2020-03-30,1747,496,106,1310,322,74,826,265,35,1838,548,96,397,68,10,,,,US_NY_36005,11355,3258,363
2020-03-31,1494,472,122,1285,357,93,642,224,43,1790,552,93,234,69,21,,,,US_NY_36005,12640,3615,456
2020-04-01,1593,468,131,1237,340,90,588,176,60,1765,522,135,263,73,16,,,,US_NY_36005,13877,3955,546
2020-04-02,1639,404,163,1284,339,95,659,230,63,1811,562,134,370,79,30,,,,US_NY_36005,15161,4294,641
2020-04-03,1443,403,136,1445,354,114,688,259,52,1752,517,154,344,64,29,,,,US_NY_36005,16606,4648,755
2020-04-04,917,342,152,1007,283,106,391,198,63,1199,465,148,347,51,20,,,,US_NY_36005,17613,4931,861
2020-04-05,1150,373,162,818,318,122,358,183,86,1136,387,177,323,65,22,,,,US_NY_36005,18431,5249,983
2020-04-06,1501,466,164,1512,383,109,719,260,69,1914,530,199,730,81,24,,,,US_NY_36005,19943,5632,1092
2020-04-07,1417,480,177,1466,333,114,607,195,90,1943,521,180,629,70,28,,,,US_NY_36005,21409,5965,1206
2020-04-08,1323,421,170,1295,370,106,557,177,65,1846,509,172,560,56,34,,,,US_NY_36005,22704,6335,1312
2020-04-09,1369,413,186,1280,302,108,567,201,64,1557,455,156,297,56,25,,,,US_NY_36005,23984,6637,1420
2020-04-10,1153,339,168,1232,304,118,505,195,68,1326,444,146,300,54,19,,,,US_NY_36005,25216,6941,1538
2020-04-11,1126,300,155,993,266,132,315,134,59,982,352,155,312,48,27,,,,US_NY_36005,26209,7207,1670
2020-04-12,701,260,199,758,237,106,254,143,63,920,307,163,252,45,26,,,,US_NY_36005,26967,7444,1776
2020-04-13,1063,340,157,693,279,118,394,187,73,974,350,178,185,56,25,,,,US_NY_36005,27660,7723,1894
2020-04-14,1035,274,153,1074,216,109,445,161,59,1299,382,160,290,52,24,,,,US_NY_36005,28734,7939,2003
2020-04-15,883,282,128,1063,222,92,435,146,55,1177,300,139,317,33,24,,,,US_NY_36005,29797,8161,2095
2020-04-16,884,247,123,932,199,84,360,110,58,1139,287,121,210,38,14,,,,US_NY_36005,30729,8360,2179
2020-04-17,958,258,116,910,194,85,333,125,42,1097,285,110,280,38,15,,,,US_NY_36005,31639,8554,2264
2020-04-18,574,175,113,548,156,58,188,89,56,704,213,116,153,25,19,,,,US_NY_36005,32187,8710,2322
2020-04-19,635,140,114,530,150,74,178,84,48,867,187,120,134,30,19,,,,US_NY_36005,32717,8860,2396
2020-04-20,980,213,94,975,164,77,384,94,50,1220,221,113,224,29,16,,,,US_NY_36005,33692,9024,2473
2020-04-21,899,174,91,637,148,68,374,100,47,934,210,87,216,27,11,,,,US_NY_36005,34329,9172,2541
2020-04-22,854,161,104,922,131,67,387,110,38,1109,177,76,173,20,14,,,,US_NY_36005,35251,9303,2608
2020-04-23,790,160,106,732,130,57,402,69,47,787,152,86,128,19,13,,,,US_NY_36005,35983,9433,2665
2020-04-24,628,141,93,579,115,61,413,94,50,774,165,81,143,34,13,,,,US_NY_36005,36562,9548,2726
2020-04-25,404,105,75,412,101,53,149,52,42,540,116,65,88,26,9,,,,US_NY_36005,36974,9649,2779
2020-04-26,332,88,60,194,87,52,99,51,33,332,126,78,46,23,7,,,,US_NY_36005,37168,9736,2831
2020-04-27,610,117,87,545,114,53,304,72,29,721,122,80,107,20,9,,,,US_NY_36005,37713,9850,2884
2020-04-28,715,123,57,668,109,55,324,72,36,893,119,63,129,19,8,,,,US_NY_36005,38381,9959,2939
2020-04-29,682,120,72,556,97,40,286,53,33,692,118,74,124,19,14,,,,US_NY_36005,38937,10056,2979
2020-04-30,599,96,65,478,70,45,218,42,34,592,112,57,130,19,11,,,,US_NY_36005,39415,10126,3024
2020-05-01,496,88,56,441,92,45,245,49,24,620,108,73,77,12,8,,,,US_NY_36005,39856,10218,3069
2020-05-02,264,63,46,259,63,49,141,29,23,333,88,58,60,18,12,,,,US_NY_36005,40115,10281,3118
2020-05-03,248,62,46,150,57,27,104,43,35,248,79,48,35,15,15,,,,US_NY_36005,40265,10338,3145
2020-05-04,463,90,42,347,68,35,214,54,19,432,82,49,90,15,8,,,,US_NY_36005,40612,10406,3180
2020-05-05,434,77,49,294,85,27,243,42,18,462,66,43,78,12,12,,,,US_NY_36005,40906,10491,3207
2020-05-06,451,76,38,281,71,28,166,36,17,443,66,53,60,7,8,,,,US_NY_36005,41187,10562,3235
2020-05-07,401,87,45,294,59,27,118,34,22,356,65,36,60,7,3,,,,US_NY_36005,41481,10621,3262
2020-05-08,349,79,42,252,71,21,100,41,13,342,53,45,42,10,5,,,,US_NY_36005,41733,10692,3283
2020-05-09,121,57,28,177,47,21,74,29,16,256,42,30,32,7,3,,,,US_NY_36005,41910,10739,3304
2020-05-10,191,43,25,75,36,13,94,28,20,85,38,30,14,5,8,,,,US_NY_36005,41985,10775,3317
2020-05-11,409,77,32,227,53,27,192,40,13,376,71,24,27,4,3,,,,US_NY_36005,42212,10828,3344
2020-05-12,400,57,33,354,52,20,163,30,14,314,54,15,53,8,6,,,,US_NY_36005,42566,10880,3364
2020-05-13,364,68,22,454,49,15,155,42,8,304,51,24,48,9,6,,,,US_NY_36005,43020,10929,3379
2020-05-14,332,61,14,255,47,9,149,32,16,333,63,21,41,13,6,,,,US_NY_36005,43275,10976,3388
2020-05-15,260,60,26,177,54,16,137,43,12,265,64,25,33,7,6,,,,US_NY_36005,43452,11030,3404
2020-05-16,164,48,23,110,30,27,56,18,9,135,60,20,25,9,2,,,,US_NY_36005,43562,11060,3431
2020-05-17,138,37,18,56,25,19,50,19,11,107,38,24,10,4,2,,,,US_NY_36005,43618,11085,3450
2020-05-18,270,59,15,185,35,11,133,31,10,274,49,17,38,4,2,,,,US_NY_36005,43803,11120,3461
2020-05-19,331,65,16,177,42,11,168,39,10,288,50,11,42,8,5,,,,US_NY_36005,43980,11162,3472
2020-05-20,326,49,20,276,39,15,165,25,12,247,45,22,56,6,7,,,,US_NY_36005,44256,11201,3487
2020-05-21,345,66,15,192,32,12,146,26,6,307,38,9,77,10,3,,,,US_NY_36005,44448,11233,3499
2020-05-22,387,61,13,259,42,12,156,35,5,226,51,28,32,7,5,,,,US_NY_36005,44707,11275,3511
2020-05-23,163,34,20,87,25,17,47,21,7,130,44,14,37,6,2,,,,US_NY_36005,44794,11300,3528
2020-05-24,181,35,12,96,26,13,70,28,6,118,28,11,14,4,5,,,,US_NY_36005,44890,11326,3541
2020-05-25,174,33,14,97,31,8,71,26,12,106,46,12,17,5,3,,,,US_NY_36005,44987,11357,3549
2020-05-26,338,34,10,270,41,10,126,27,7,261,45,9,56,3,1,,,,US_NY_36005,45257,11398,3559
2020-05-27,260,53,11,172,25,9,111,28,9,164,53,18,44,3,2,,,,US_NY_36005,45429,11423,3568
2020-05-28,227,48,13,110,23,12,95,29,3,172,33,9,26,8,1,,,,US_NY_36005,45539,11446,3580
2020-05-29,177,31,16,158,44,6,79,30,5,209,46,14,26,9,2,,,,US_NY_36005,45697,11490,3586
2020-05-30,110,29,10,75,25,12,39,12,12,107,24,17,15,3,1,,,,US_NY_36005,45772,11515,3598
2020-05-31,81,26,11,30,18,6,24,14,5,69,31,15,11,2,2,,,,US_NY_36005,45802,11533,3604
2020-06-01,253,37,10,151,26,3,81,23,3,139,35,14,39,2,3,,,,US_NY_36005,45953,11559,3607
2020-06-02,200,31,6,110,26,7,72,25,8,160,37,15,33,6,1,,,,US_NY_36005,46063,11585,3614
2020-06-03,144,39,13,100,19,10,78,25,7,146,26,8,42,5,3,,,,US_NY_36005,46163,11604,3624
2020-06-04,144,31,9,113,26,3,89,15,7,137,15,10,28,1,2,,,,US_NY_36005,46276,11630,3627
2020-06-05,132,19,6,102,16,7,60,10,7,104,17,5,9,1,1,,,,US_NY_36005,46378,11646,3634
2020-06-06,59,12,9,51,19,11,31,8,3,98,9,10,7,0,0,,,,US_NY_36005,46429,11665,3645
2020-06-07,53,15,5,42,18,7,23,7,1,74,6,10,4,0,1,,,,US_NY_36005,46471,11683,3652
2020-06-08,113,20,12,97,16,10,73,7,2,143,15,13,16,2,0,,,,US_NY_36005,46568,11699,3662
2020-06-09,131,18,7,79,16,5,67,7,7,127,8,9,19,1,2,,,,US_NY_36005,46647,11715,3667
2020-06-10,99,9,11,74,17,8,66,8,2,111,11,7,13,2,2,,,,US_NY_36005,46721,11732,3675
2020-06-11,107,13,5,60,11,5,61,4,2,110,9,7,15,0,1,,,,US_NY_36005,46781,11743,3680
2020-06-12,122,20,6,75,11,5,62,7,3,126,10,7,18,1,0,,,,US_NY_36005,46856,11754,3685
2020-06-13,52,9,4,41,6,4,24,3,2,73,7,1,1,1,1,,,,US_NY_36005,46897,11760,3689
2020-06-14,54,11,6,27,12,6,29,4,2,66,14,6,4,0,2,,,,US_NY_36005,46924,11772,3695
2020-06-15,97,21,4,65,13,4,61,5,2,115,10,3,17,0,1,,,,US_NY_36005,46989,11785,3699
2020-06-16,127,15,6,66,12,3,69,5,2,115,15,7,11,0,0,,,,US_NY_36005,47055,11797,3702
2020-06-17,92,13,4,61,12,2,57,4,3,86,12,7,12,0,0,,,,US_NY_36005,47116,11809,3704
2020-06-18,87,12,4,43,7,1,50,4,3,98,14,5,22,0,1,,,,US_NY_36005,47159,11816,3705
2020-06-19,68,21,3,54,7,3,44,4,3,88,3,3,2,0,2,,,,US_NY_36005,47213,11823,3708
2020-06-20,32,10,3,38,6,5,28,5,2,38,5,2,2,0,1,,,,US_NY_36005,47251,11829,3713
2020-06-21,31,11,2,14,6,4,12,3,3,36,7,7,6,2,0,,,,US_NY_36005,47265,11835,3717
2020-06-22,47,8,1,51,7,0,29,5,2,47,4,1,7,1,1,,,,US_NY_36005,47316,11842,3717
2020-06-23,18,1,1,23,3,1,16,0,1,26,5,0,2,1,0,,,,US_NY_36005,47339,11845,3718
2020-06-24,3,0,0,3,0,0,0,0,0,2,0,0,1,0,0,,,,US_NY_36005,47342,11845,3718
2020-02-29,,,,0,4,0,1,2,0,0,2,0,0,0,0,0,3,0,US_NY_36047,0,4,0
2020-03-01,,,,0,0,0,0,0,0,0,2,0,0,1,0,1,1,0,US_NY_36047,0,4,0
2020-03-02,,,,0,4,0,0,4,0,0,5,0,0,0,0,0,9,0,US_NY_36047,0,8,0
2020-03-03,,,,0,5,0,0,2,0,1,5,0,0,1,0,1,7,0,US_NY_36047,0,13,0
2020-03-04,,,,1,5,0,2,6,0,2,3,0,0,2,0,0,6,0,US_NY_36047,1,18,0
2020-03-05,,,,3,5,0,0,6,0,0,6,0,0,1,0,0,2,0,US_NY_36047,4,23,0
2020-03-06,,,,1,3,0,3,3,0,1,5,0,1,2,0,2,5,0,US_NY_36047,5,26,0
2020-03-07,,,,2,6,0,1,4,0,3,3,0,1,0,0,0,2,0,US_NY_36047,7,32,0
2020-03-08,,,,5,9,0,6,1,0,5,5,0,1,0,0,4,2,0,US_NY_36047,12,41,0
2020-03-09,,,,16,15,0,25,12,0,10,8,0,3,3,0,4,11,0,US_NY_36047,28,56,0
2020-03-10,,,,11,13,0,24,13,0,24,23,0,2,5,0,8,8,0,US_NY_36047,39,69,0
2020-03-11,,,,31,15,0,61,21,0,40,30,1,3,3,0,19,20,0,US_NY_36047,70,84,0
2020-03-12,,,,96,26,0,138,11,0,80,29,0,13,5,0,29,16,0,US_NY_36047,166,110,0
2020-03-13,,,,166,36,0,182,27,0,166,48,0,26,3,0,79,34,0,US_NY_36047,332,146,0
2020-03-14,,,,163,36,1,179,28,0,194,57,1,22,8,0,86,26,0,US_NY_36047,495,182,1
2020-03-15,,,,430,43,0,209,30,2,230,64,1,46,16,1,118,34,1,US_NY_36047,925,225,1
2020-03-16,,,,739,83,1,458,40,0,530,106,4,91,17,0,303,65,3,US_NY_36047,1664,308,2
2020-03-17,,,,786,98,4,566,57,0,650,108,3,108,21,0,343,65,1,US_NY_36047,2450,406,6
2020-03-18,,,,970,111,6,540,76,4,832,152,9,150,23,0,483,100,1,US_NY_36047,3420,517,12
2020-03-19,,,,1209,147,6,554,91,4,1065,160,6,258,32,4,620,122,4,US_NY_36047,4629,664,18
2020-03-20,,,,1140,186,10,657,110,11,1184,223,9,309,30,3,719,111,13,US_NY_36047,5769,850,28
2020-03-21,,,,558,172,12,402,115,5,945,223,14,248,34,1,483,152,12,US_NY_36047,6327,1022,40
2020-03-22,,,,757,182,10,322,126,8,695,223,14,316,32,6,491,163,12,US_NY_36047,7084,1204,50
2020-03-23,,,,911,276,27,538,174,7,1189,332,28,209,46,8,723,207,12,US_NY_36047,7995,1480,77
2020-03-24,,,,1211,300,23,628,188,17,1389,361,34,349,48,6,927,253,14,US_NY_36047,9206,1780,100
2020-03-25,,,,1232,371,36,594,185,20,1571,398,30,394,49,4,1054,289,30,US_NY_36047,10438,2151,136
2020-03-26,,,,1357,441,49,627,214,34,1640,424,56,403,47,10,999,306,37,US_NY_36047,11795,2592,185
2020-03-27,,,,1406,400,73,659,202,41,1574,411,56,371,57,7,1087,306,34,US_NY_36047,13201,2992,258
2020-03-28,,,,849,354,75,387,204,28,1202,435,89,266,53,13,763,301,61,US_NY_36047,14050,3346,333
2020-03-29,,,,1121,412,87,408,160,35,1075,452,92,230,57,17,699,310,54,US_NY_36047,15171,3758,420
2020-03-30,,,,1747,496,106,826,265,35,1838,548,96,397,68,10,1310,322,74,US_NY_36047,16918,4254,526
2020-03-31,,,,1494,472,122,642,224,43,1790,552,93,234,69,21,1285,357,93,US_NY_36047,18412,4726,648
2020-04-01,,,,1593,468,131,588,176,60,1765,522,135,263,73,16,1237,340,90,US_NY_36047,20005,5194,779
2020-04-02,,,,1639,404,163,659,230,63,1811,562,134,370,79,30,1284,339,95,US_NY_36047,21644,5598,942
2020-04-03,,,,1443,403,136,688,259,52,1752,517,154,344,64,29,1445,354,114,US_NY_36047,23087,6001,1078
2020-04-04,,,,917,342,152,391,198,63,1199,465,148,347,51,20,1007,283,106,US_NY_36047,24004,6343,1230
2020-04-05,,,,1150,373,162,358,183,86,1136,387,177,323,65,22,818,318,122,US_NY_36047,25154,6716,1392
2020-04-06,,,,1501,466,164,719,260,69,1914,530,199,730,81,24,1512,383,109,US_NY_36047,26655,7182,1556
2020-04-07,,,,1417,480,177,607,195,90,1943,521,180,629,70,28,1466,333,114,US_NY_36047,28072,7662,1733
2020-04-08,,,,1323,421,170,557,177,65,1846,509,172,560,56,34,1295,370,106,US_NY_36047,29395,8083,1903
2020-04-09,,,,1369,413,186,567,201,64,1557,455,156,297,56,25,1280,302,108,US_NY_36047,30764,8496,2089
2020-04-10,,,,1153,339,168,505,195,68,1326,444,146,300,54,19,1232,304,118,US_NY_36047,31917,8835,2257
2020-04-11,,,,1126,300,155,315,134,59,982,352,155,312,48,27,993,266,132,US_NY_36047,33043,9135,2412
2020-04-12,,,,701,260,199,254,143,63,920,307,163,252,45,26,758,237,106,US_NY_36047,33744,9395,2611
2020-04-13,,,,1063,340,157,394,187,73,974,350,178,185,56,25,693,279,118,US_NY_36047,34807,9735,2768
2020-04-14,,,,1035,274,153,445,161,59,1299,382,160,290,52,24,1074,216,109,US_NY_36047,35842,10009,2921
2020-04-15,,,,883,282,128,435,146,55,1177,300,139,317,33,24,1063,222,92,US_NY_36047,36725,10291,3049
2020-04-16,,,,884,247,123,360,110,58,1139,287,121,210,38,14,932,199,84,US_NY_36047,37609,10538,3172
2020-04-17,,,,958,258,116,333,125,42,1097,285,110,280,38,15,910,194,85,US_NY_36047,38567,10796,3288
2020-04-18,,,,574,175,113,188,89,56,704,213,116,153,25,19,548,156,58,US_NY_36047,39141,10971,3401
2020-04-19,,,,635,140,114,178,84,48,867,187,120,134,30,19,530,150,74,US_NY_36047,39776,11111,3515
2020-04-20,,,,980,213,94,384,94,50,1220,221,113,224,29,16,975,164,77,US_NY_36047,40756,11324,3609
2020-04-21,,,,899,174,91,374,100,47,934,210,87,216,27,11,637,148,68,US_NY_36047,41655,11498,3700
2020-04-22,,,,854,161,104,387,110,38,1109,177,76,173,20,14,922,131,67,US_NY_36047,42509,11659,3804
2020-04-23,,,,790,160,106,402,69,47,787,152,86,128,19,13,732,130,57,US_NY_36047,43299,11819,3910
2020-04-24,,,,628,141,93,413,94,50,774,165,81,143,34,13,579,115,61,US_NY_36047,43927,11960,4003
2020-04-25,,,,404,105,75,149,52,42,540,116,65,88,26,9,412,101,53,US_NY_36047,44331,12065,4078
2020-04-26,,,,332,88,60,99,51,33,332,126,78,46,23,7,194,87,52,US_NY_36047,44663,12153,4138
2020-04-27,,,,610,117,87,304,72,29,721,122,80,107,20,9,545,114,53,US_NY_36047,45273,12270,4225
2020-04-28,,,,715,123,57,324,72,36,893,119,63,129,19,8,668,109,55,US_NY_36047,45988,12393,4282
2020-04-29,,,,682,120,72,286,53,33,692,118,74,124,19,14,556,97,40,US_NY_36047,46670,12513,4354
2020-04-30,,,,599,96,65,218,42,34,592,112,57,130,19,11,478,70,45,US_NY_36047,47269,12609,4419
2020-05-01,,,,496,88,56,245,49,24,620,108,73,77,12,8,441,92,45,US_NY_36047,47765,12697,4475
2020-05-02,,,,264,63,46,141,29,23,333,88,58,60,18,12,259,63,49,US_NY_36047,48029,12760,4521
2020-05-03,,,,248,62,46,104,43,35,248,79,48,35,15,15,150,57,27,US_NY_36047,48277,12822,4567
2020-05-04,,,,463,90,42,214,54,19,432,82,49,90,15,8,347,68,35,US_NY_36047,48740,12912,4609
2020-05-05,,,,434,77,49,243,42,18,462,66,43,78,12,12,294,85,27,US_NY_36047,49174,12989,4658
2020-05-06,,,,451,76,38,166,36,17,443,66,53,60,7,8,281,71,28,US_NY_36047,49625,13065,4696
2020-05-07,,,,401,87,45,118,34,22,356,65,36,60,7,3,294,59,27,US_NY_36047,50026,13152,4741
2020-05-08,,,,349,79,42,100,41,13,342,53,45,42,10,5,252,71,21,US_NY_36047,50375,13231,4783
2020-05-09,,,,121,57,28,74,29,16,256,42,30,32,7,3,177,47,21,US_NY_36047,50496,13288,4811
2020-05-10,,,,191,43,25,94,28,20,85,38,30,14,5,8,75,36,13,US_NY_36047,50687,13331,4836
2020-05-11,,,,409,77,32,192,40,13,376,71,24,27,4,3,227,53,27,US_NY_36047,51096,13408,4868
2020-05-12,,,,400,57,33,163,30,14,314,54,15,53,8,6,354,52,20,US_NY_36047,51496,13465,4901
2020-05-13,,,,364,68,22,155,42,8,304,51,24,48,9,6,454,49,15,US_NY_36047,51860,13533,4923
2020-05-14,,,,332,61,14,149,32,16,333,63,21,41,13,6,255,47,9,US_NY_36047,52192,13594,4937
2020-05-15,,,,260,60,26,137,43,12,265,64,25,33,7,6,177,54,16,US_NY_36047,52452,13654,4963
2020-05-16,,,,164,48,23,56,18,9,135,60,20,25,9,2,110,30,27,US_NY_36047,52616,13702,4986
2020-05-17,,,,138,37,18,50,19,11,107,38,24,10,4,2,56,25,19,US_NY_36047,52754,13739,5004
2020-05-18,,,,270,59,15,133,31,10,274,49,17,38,4,2,185,35,11,US_NY_36047,53024,13798,5019
2020-05-19,,,,331,65,16,168,39,10,288,50,11,42,8,5,177,42,11,US_NY_36047,53355,13863,5035
2020-05-20,,,,326,49,20,165,25,12,247,45,22,56,6,7,276,39,15,US_NY_36047,53681,13912,5055
2020-05-21,,,,345,66,15,146,26,6,307,38,9,77,10,3,192,32,12,US_NY_36047,54026,13978,5070
2020-05-22,,,,387,61,13,156,35,5,226,51,28,32,7,5,259,42,12,US_NY_36047,54413,14039,5083
2020-05-23,,,,163,34,20,47,21,7,130,44,14,37,6,2,87,25,17,US_NY_36047,54576,14073,5103
2020-05-24,,,,181,35,12,70,28,6,118,28,11,14,4,5,96,26,13,US_NY_36047,54757,14108,5115
2020-05-25,,,,174,33,14,71,26,12,106,46,12,17,5,3,97,31,8,US_NY_36047,54931,14141,5129
2020-05-26,,,,338,34,10,126,27,7,261,45,9,56,3,1,270,41,10,US_NY_36047,55269,14175,5139
2020-05-27,,,,260,53,11,111,28,9,164,53,18,44,3,2,172,25,9,US_NY_36047,55529,14228,5150
2020-05-28,,,,227,48,13,95,29,3,172,33,9,26,8,1,110,23,12,US_NY_36047,55756,14276,5163
2020-05-29,,,,177,31,16,79,30,5,209,46,14,26,9,2,158,44,6,US_NY_36047,55933,14307,5179
2020-05-30,,,,110,29,10,39,12,12,107,24,17,15,3,1,75,25,12,US_NY_36047,56043,14336,5189
2020-05-31,,,,81,26,11,24,14,5,69,31,15,11,2,2,30,18,6,US_NY_36047,56124,14362,5200
2020-06-01,,,,253,37,10,81,23,3,139,35,14,39,2,3,151,26,3,US_NY_36047,56377,14399,5210
2020-06-02,,,,200,31,6,72,25,8,160,37,15,33,6,1,110,26,7,US_NY_36047,56577,14430,5216
2020-06-03,,,,144,39,13,78,25,7,146,26,8,42,5,3,100,19,10,US_NY_36047,56721,14469,5229
2020-06-04,,,,144,31,9,89,15,7,137,15,10,28,1,2,113,26,3,US_NY_36047,56865,14500,5238
2020-06-05,,,,132,19,6,60,10,7,104,17,5,9,1,1,102,16,7,US_NY_36047,56997,14519,5244
2020-06-06,,,,59,12,9,31,8,3,98,9,10,7,0,0,51,19,11,US_NY_36047,57056,14531,5253
2020-06-07,,,,53,15,5,23,7,1,74,6,10,4,0,1,42,18,7,US_NY_36047,57109,14546,5258
2020-06-08,,,,113,20,12,73,7,2,143,15,13,16,2,0,97,16,10,US_NY_36047,57222,14566,5270
2020-06-09,,,,131,18,7,67,7,7,127,8,9,19,1,2,79,16,5,US_NY_36047,57353,14584,5277
2020-06-10,,,,99,9,11,66,8,2,111,11,7,13,2,2,74,17,8,US_NY_36047,57452,14593,5288
2020-06-11,,,,107,13,5,61,4,2,110,9,7,15,0,1,60,11,5,US_NY_36047,57559,14606,5293
2020-06-12,,,,122,20,6,62,7,3,126,10,7,18,1,0,75,11,5,US_NY_36047,57681,14626,5299
2020-06-13,,,,52,9,4,24,3,2,73,7,1,1,1,1,41,6,4,US_NY_36047,57733,14635,5303
2020-06-14,,,,54,11,6,29,4,2,66,14,6,4,0,2,27,12,6,US_NY_36047,57787,14646,5309
2020-06-15,,,,97,21,4,61,5,2,115,10,3,17,0,1,65,13,4,US_NY_36047,57884,14667,5313
2020-06-16,,,,127,15,6,69,5,2,115,15,7,11,0,0,66,12,3,US_NY_36047,58011,14682,5319
2020-06-17,,,,92,13,4,57,4,3,86,12,7,12,0,0,61,12,2,US_NY_36047,58103,14695,5323
2020-06-18,,,,87,12,4,50,4,3,98,14,5,22,0,1,43,7,1,US_NY_36047,58190,14707,5327
2020-06-19,,,,68,21,3,44,4,3,88,3,3,2,0,2,54,7,3,US_NY_36047,58258,14728,5330
2020-06-20,,,,32,10,3,28,5,2,38,5,2,2,0,1,38,6,5,US_NY_36047,58290,14738,5333
2020-06-21,,,,31,11,2,12,3,3,36,7,7,6,2,0,14,6,4,US_NY_36047,58321,14749,5335
2020-06-22,,,,47,8,1,29,5,2,47,4,1,7,1,1,51,7,0,US_NY_36047,58368,14757,5336
2020-06-23,,,,18,1,1,16,0,1,26,5,0,2,1,0,23,3,1,US_NY_36047,58386,14758,5337
2020-06-24,,,,3,0,0,0,0,0,2,0,0,1,0,0,3,0,0,US_NY_36047,58389,14758,5337
2020-02-29,0,4,0,1,2,0,,,,0,2,0,0,0,0,0,3,0,US_NY_36061,1,2,0
2020-03-01,0,0,0,0,0,0,,,,0,2,0,0,1,0,1,1,0,US_NY_36061,1,2,0
2020-03-02,0,4,0,0,4,0,,,,0,5,0,0,0,0,0,9,0,US_NY_36061,1,6,0
2020-03-03,0,5,0,0,2,0,,,,1,5,0,0,1,0,1,7,0,US_NY_36061,1,8,0
2020-03-04,1,5,0,2,6,0,,,,2,3,0,0,2,0,0,6,0,US_NY_36061,3,14,0
2020-03-05,3,5,0,0,6,0,,,,0,6,0,0,1,0,0,2,0,US_NY_36061,3,20,0
2020-03-06,1,3,0,3,3,0,,,,1,5,0,1,2,0,2,5,0,US_NY_36061,6,23,0
2020-03-07,2,6,0,1,4,0,,,,3,3,0,1,0,0,0,2,0,US_NY_36061,7,27,0
2020-03-08,5,9,0,6,1,0,,,,5,5,0,1,0,0,4,2,0,US_NY_36061,13,28,0
2020-03-09,16,15,0,25,12,0,,,,10,8,0,3,3,0,4,11,0,US_NY_36061,38,40,0
2020-03-10,11,13,0,24,13,0,,,,24,23,0,2,5,0,8,8,0,US_NY_36061,62,53,0
2020-03-11,31,15,0,61,21,0,,,,40,30,1,3,3,0,19,20,0,US_NY_36061,123,74,0
2020-03-12,96,26,0,138,11,0,,,,80,29,0,13,5,0,29,16,0,US_NY_36061,261,85,0
2020-03-13,166,36,0,182,27,0,,,,166,48,0,26,3,0,79,34,0,US_NY_36061,443,112,0
2020-03-14,163,36,1,179,28,0,,,,194,57,1,22,8,0,86,26,0,US_NY_36061,622,140,0
2020-03-15,430,43,0,209,30,2,,,,230,64,1,46,16,1,118,34,1,US_NY_36061,831,170,2
2020-03-16,739,83,1,458,40,0,,,,530,106,4,91,17,0,303,65,3,US_NY_36061,1289,210,2
2020-03-17,786,98,4,566,57,0,,,,650,108,3,108,21,0,343,65,1,US_NY_36061,1855,267,2
2020-03-18,970,111,6,540,76,4,,,,832,152,9,150,23,0,483,100,1,US_NY_36061,2395,343,6
2020-03-19,1209,147,6,554,91,4,,,,1065,160,6,258,32,4,620,122,4,US_NY_36061,2949,434,10
2020-03-20,1140,186,10,657,110,11,,,,1184,223,9,309,30,3,719,111,13,US_NY_36061,3606,544,21
2020-03-21,558,172,12,402,115,5,,,,945,223,14,248,34,1,483,152,12,US_NY_36061,4008,659,26
2020-03-22,757,182,10,322,126,8,,,,695,223,14,316,32,6,491,163,12,US_NY_36061,4330,785,34
2020-03-23,911,276,27,538,174,7,,,,1189,332,28,209,46,8,723,207,12,US_NY_36061,4868,959,41
2020-03-24,1211,300,23,628,188,17,,,,1389,361,34,349,48,6,927,253,14,US_NY_36061,5496,1147,58
2020-03-25,1232,371,36,594,185,20,,,,1571,398,30,394,49,4,1054,289,30,US_NY_36061,6090,1332,78
2020-03-26,1357,441,49,627,214,34,,,,1640,424,56,403,47,10,999,306,37,US_NY_36061,6717,1546,112
2020-03-27,1406,400,73,659,202,41,,,,1574,411,56,371,57,7,1087,306,34,US_NY_36061,7376,1748,153
2020-03-28,849,354,75,387,204,28,,,,1202,435,89,266,53,13,763,301,61,US_NY_36061,7763,1952,181
2020-03-29,1121,412,87,408,160,35,,,,1075,452,92,230,57,17,699,310,54,US_NY_36061,8171,2112,216
2020-03-30,1747,496,106,826,265,35,,,,1838,548,96,397,68,10,1310,322,74,US_NY_36061,8997,2377,251
2020-03-31,1494,472,122,642,224,43,,,,1790,552,93,234,69,21,1285,357,93,US_NY_36061,9639,2601,294
2020-04-01,1593,468,131,588,176,60,,,,1765,522,135,263,73,16,1237,340,90,US_NY_36061,10227,2777,354
2020-04-02,1639,404,163,659,230,63,,,,1811,562,134,370,79,30,1284,339,95,US_NY_36061,10886,3007,417
2020-04-03,1443,403,136,688,259,52,,,,1752,517,154,344,64,29,1445,354,114,US_NY_36061,11574,3266,469
2020-04-04,917,342,152,391,198,63,,,,1199,465,148,347,51,20,1007,283,106,US_NY_36061,11965,3464,532
2020-04-05,1150,373,162,358,183,86,,,,1136,387,177,323,65,22,818,318,122,US_NY_36061,12323,3647,618
2020-04-06,1501,466,164,719,260,69,,,,1914,530,199,730,81,24,1512,383,109,US_NY_36061,13042,3907,687
2020-04-07,1417,480,177,607,195,90,,,,1943,521,180,629,70,28,1466,333,114,US_NY_36061,13649,4102,777
2020-04-08,1323,421,170,557,177,65,,,,1846,509,172,560,56,34,1295,370,106,US_NY_36061,14206,4279,842
2020-04-09,1369,413,186,567,201,64,,,,1557,455,156,297,56,25,1280,302,108,US_NY_36061,14773,4480,906
2020-04-10,1153,339,168,505,195,68,,,,1326,444,146,300,54,19,1232,304,118,US_NY_36061,15278,4675,974
2020-04-11,1126,300,155,315,134,59,,,,982,352,155,312,48,27,993,266,132,US_NY_36061,15593,4809,1033
2020-04-12,701,260,199,254,143,63,,,,920,307,163,252,45,26,758,237,106,US_NY_36061,15847,4952,1096
2020-04-13,1063,340,157,394,187,73,,,,974,350,178,185,56,25,693,279,118,US_NY_36061,16241,5139,1169
2020-04-14,1035,274,153,445,161,59,,,,1299,382,160,290,52,24,1074,216,109,US_NY_36061,16686,5300,1228
2020-04-15,883,282,128,435,146,55,,,,1177,300,139,317,33,24,1063,222,92,US_NY_36061,17121,5446,1283
2020-04-16,884,247,123,360,110,58,,,,1139,287,121,210,38,14,932,199,84,US_NY_36061,17481,5556,1341
2020-04-17,958,258,116,333,125,42,,,,1097,285,110,280,38,15,910,194,85,US_NY_36061,17814,5681,1383
2020-04-18,574,175,113,188,89,56,,,,704,213,116,153,25,19,548,156,58,US_NY_36061,18002,5770,1439
2020-04-19,635,140,114,178,84,48,,,,867,187,120,134,30,19,530,150,74,US_NY_36061,18180,5854,1487
2020-04-20,980,213,94,384,94,50,,,,1220,221,113,224,29,16,975,164,77,US_NY_36061,18564,5948,1537
2020-04-21,899,174,91,374,100,47,,,,934,210,87,216,27,11,637,148,68,US_NY_36061,18938,6048,1584
2020-04-22,854,161,104,387,110,38,,,,1109,177,76,173,20,14,922,131,67,US_NY_36061,19325,6158,1622
2020-04-23,790,160,106,402,69,47,,,,787,152,86,128,19,13,732,130,57,US_NY_36061,19727,6227,1669
2020-04-24,628,141,93,413,94,50,,,,774,165,81,143,34,13,579,115,61,US_NY_36061,20140,6321,1719
2020-04-25,404,105,75,149,52,42,,,,540,116,65,88,26,9,412,101,53,US_NY_36061,20289,6373,1761
2020-04-26,332,88,60,99,51,33,,,,332,126,78,46,23,7,194,87,52,US_NY_36061,20388,6424,1794
2020-04-27,610,117,87,304,72,29,,,,721,122,80,107,20,9,545,114,53,US_NY_36061,20692,6496,1823
2020-04-28,715,123,57,324,72,36,,,,893,119,63,129,19,8,668,109,55,US_NY_36061,21016,6568,1859
2020-04-29,682,120,72,286,53,33,,,,692,118,74,124,19,14,556,97,40,US_NY_36061,21302,6621,1892
2020-04-30,599,96,65,218,42,34,,,,592,112,57,130,19,11,478,70,45,US_NY_36061,21520,6663,1926
2020-05-01,496,88,56,245,49,24,,,,620,108,73,77,12,8,441,92,45,US_NY_36061,21765,6712,1950
2020-05-02,264,63,46,141,29,23,,,,333,88,58,60,18,12,259,63,49,US_NY_36061,21906,6741,1973
2020-05-03,248,62,46,104,43,35,,,,248,79,48,35,15,15,150,57,27,US_NY_36061,22010,6784,2008
2020-05-04,463,90,42,214,54,19,,,,432,82,49,90,15,8,347,68,35,US_NY_36061,22224,6838,2027
2020-05-05,434,77,49,243,42,18,,,,462,66,43,78,12,12,294,85,27,US_NY_36061,22467,6880,2045
2020-05-06,451,76,38,166,36,17,,,,443,66,53,60,7,8,281,71,28,US_NY_36061,22633,6916,2062
2020-05-07,401,87,45,118,34,22,,,,356,65,36,60,7,3,294,59,27,US_NY_36061,22751,6950,2084
2020-05-08,349,79,42,100,41,13,,,,342,53,45,42,10,5,252,71,21,US_NY_36061,22851,6991,2097
2020-05-09,121,57,28,74,29,16,,,,256,42,30,32,7,3,177,47,21,US_NY_36061,22925,7020,2113
2020-05-10,191,43,25,94,28,20,,,,85,38,30,14,5,8,75,36,13,US_NY_36061,23019,7048,2133
2020-05-11,409,77,32,192,40,13,,,,376,71,24,27,4,3,227,53,27,US_NY_36061,23211,7088,2146
2020-05-12,400,57,33,163,30,14,,,,314,54,15,53,8,6,354,52,20,US_NY_36061,23374,7118,2160
2020-05-13,364,68,22,155,42,8,,,,304,51,24,48,9,6,454,49,15,US_NY_36061,23529,7160,2168
2020-05-14,332,61,14,149,32,16,,,,333,63,21,41,13,6,255,47,9,US_NY_36061,23678,7192,2184
2020-05-15,260,60,26,137,43,12,,,,265,64,25,33,7,6,177,54,16,US_NY_36061,23815,7235,2196
2020-05-16,164,48,23,56,18,9,,,,135,60,20,25,9,2,110,30,27,US_NY_36061,23871,7253,2205
2020-05-17,138,37,18,50,19,11,,,,107,38,24,10,4,2,56,25,19,US_NY_36061,23921,7272,2216
2020-05-18,270,59,15,133,31,10,,,,274,49,17,38,4,2,185,35,11,US_NY_36061,24054,7303,2226
2020-05-19,331,65,16,168,39,10,,,,288,50,11,42,8,5,177,42,11,US_NY_36061,24222,7342,2236
2020-05-20,326,49,20,165,25,12,,,,247,45,22,56,6,7,276,39,15,US_NY_36061,24387,7367,2248
2020-05-21,345,66,15,146,26,6,,,,307,38,9,77,10,3,192,32,12,US_NY_36061,24533,7393,2254
2020-05-22,387,61,13,156,35,5,,,,226,51,28,32,7,5,259,42,12,US_NY_36061,24689,7428,2259
2020-05-23,163,34,20,47,21,7,,,,130,44,14,37,6,2,87,25,17,US_NY_36061,24736,7449,2266
2020-05-24,181,35,12,70,28,6,,,,118,28,11,14,4,5,96,26,13,US_NY_36061,24806,7477,2272
2020-05-25,174,33,14,71,26,12,,,,106,46,12,17,5,3,97,31,8,US_NY_36061,24877,7503,2284
2020-05-26,338,34,10,126,27,7,,,,261,45,9,56,3,1,270,41,10,US_NY_36061,25003,7530,2291
2020-05-27,260,53,11,111,28,9,,,,164,53,18,44,3,2,172,25,9,US_NY_36061,25114,7558,2300
2020-05-28,227,48,13,95,29,3,,,,172,33,9,26,8,1,110,23,12,US_NY_36061,25209,7587,2303
2020-05-29,177,31,16,79,30,5,,,,209,46,14,26,9,2,158,44,6,US_NY_36061,25288,7617,2308
2020-05-30,110,29,10,39,12,12,,,,107,24,17,15,3,1,75,25,12,US_NY_36061,25327,7629,2320
2020-05-31,81,26,11,24,14,5,,,,69,31,15,11,2,2,30,18,6,US_NY_36061,25351,7643,2325
2020-06-01,253,37,10,81,23,3,,,,139,35,14,39,2,3,151,26,3,US_NY_36061,25432,7666,2328
2020-06-02,200,31,6,72,25,8,,,,160,37,15,33,6,1,110,26,7,US_NY_36061,25504,7691,2336
2020-06-03,144,39,13,78,25,7,,,,146,26,8,42,5,3,100,19,10,US_NY_36061,25582,7716,2343
2020-06-04,144,31,9,89,15,7,,,,137,15,10,28,1,2,113,26,3,US_NY_36061,25671,7731,2350
2020-06-05,132,19,6,60,10,7,,,,104,17,5,9,1,1,102,16,7,US_NY_36061,25731,7741,2357
2020-06-06,59,12,9,31,8,3,,,,98,9,10,7,0,0,51,19,11,US_NY_36061,25762,7749,2360
2020-06-07,53,15,5,23,7,1,,,,74,6,10,4,0,1,42,18,7,US_NY_36061,25785,7756,2361
2020-06-08,113,20,12,73,7,2,,,,143,15,13,16,2,0,97,16,10,US_NY_36061,25858,7763,2363
2020-06-09,131,18,7,67,7,7,,,,127,8,9,19,1,2,79,16,5,US_NY_36061,25925,7770,2370
2020-06-10,99,9,11,66,8,2,,,,111,11,7,13,2,2,74,17,8,US_NY_36061,25991,7778,2372
2020-06-11,107,13,5,61,4,2,,,,110,9,7,15,0,1,60,11,5,US_NY_36061,26052,7782,2374
2020-06-12,122,20,6,62,7,3,,,,126,10,7,18,1,0,75,11,5,US_NY_36061,26114,7789,2377
2020-06-13,52,9,4,24,3,2,,,,73,7,1,1,1,1,41,6,4,US_NY_36061,26138,7792,2379
2020-06-14,54,11,6,29,4,2,,,,66,14,6,4,0,2,27,12,6,US_NY_36061,26167,7796,2381
2020-06-15,97,21,4,61,5,2,,,,115,10,3,17,0,1,65,13,4,US_NY_36061,26228,7801,2383
2020-06-16,127,15,6,69,5,2,,,,115,15,7,11,0,0,66,12,3,US_NY_36061,26297,7806,2385
2020-06-17,92,13,4,57,4,3,,,,86,12,7,12,0,0,61,12,2,US_NY_36061,26354,7810,2388
2020-06-18,87,12,4,50,4,3,,,,98,14,5,22,0,1,43,7,1,US_NY_36061,26404,7814,2391
2020-06-19,68,21,3,44,4,3,,,,88,3,3,2,0,2,54,7,3,US_NY_36061,26448,7818,2394
2020-06-20,32,10,3,28,5,2,,,,38,5,2,2,0,1,38,6,5,US_NY_36061,26476,7823,2396
2020-06-21,31,11,2,12,3,3,,,,36,7,7,6,2,0,14,6,4,US_NY_36061,26488,7826,2399
2020-06-22,47,8,1,29,5,2,,,,47,4,1,7,1,1,51,7,0,US_NY_36061,26517,7831,2401
2020-06-23,18,1,1,16,0,1,,,,26,5,0,2,1,0,23,3,1,US_NY_36061,26533,7831,2402
2020-06-24,3,0,0,0,0,0,,,,2,0,0,1,0,0,3,0,0,US_NY_36061,26533,7831,2402
2020-02-29,0,4,0,0,2,0,1,2,0,,,,0,0,0,0,3,0,US_NY_36081,0,2,0
2020-03-01,0,0,0,0,2,0,0,0,0,,,,0,1,0,1,1,0,US_NY_36081,0,4,0
2020-03-02,0,4,0,0,5,0,0,4,0,,,,0,0,0,0,9,0,US_NY_36081,0,9,0
2020-03-03,0,5,0,1,5,0,0,2,0,,,,0,1,0,1,7,0,US_NY_36081,1,14,0
2020-03-04,1,5,0,2,3,0,2,6,0,,,,0,2,0,0,6,0,US_NY_36081,3,17,0
2020-03-05,3,5,0,0,6,0,0,6,0,,,,0,1,0,0,2,0,US_NY_36081,3,23,0
2020-03-06,1,3,0,1,5,0,3,3,0,,,,1,2,0,2,5,0,US_NY_36081,4,28,0
2020-03-07,2,6,0,3,3,0,1,4,0,,,,1,0,0,0,2,0,US_NY_36081,7,31,0
2020-03-08,5,9,0,5,5,0,6,1,0,,,,1,0,0,4,2,0,US_NY_36081,12,36,0
2020-03-09,16,15,0,10,8,0,25,12,0,,,,3,3,0,4,11,0,US_NY_36081,22,44,0
2020-03-10,11,13,0,24,23,0,24,13,0,,,,2,5,0,8,8,0,US_NY_36081,46,67,0
2020-03-11,31,15,0,40,30,1,61,21,0,,,,3,3,0,19,20,0,US_NY_36081,86,97,1
2020-03-12,96,26,0,80,29,0,138,11,0,,,,13,5,0,29,16,0,US_NY_36081,166,126,1
2020-03-13,166,36,0,166,48,0,182,27,0,,,,26,3,0,79,34,0,US_NY_36081,332,174,1
2020-03-14,163,36,1,194,57,1,179,28,0,,,,22,8,0,86,26,0,US_NY_36081,526,231,2
2020-03-15,430,43,0,230,64,1,209,30,2,,,,46,16,1,118,34,1,US_NY_36081,756,295,3
2020-03-16,739,83,1,530,106,4,458,40,0,,,,91,17,0,303,65,3,US_NY_36081,1286,401,7
2020-03-17,786,98,4,650,108,3,566,57,0,,,,108,21,0,343,65,1,US_NY_36081,1936,509,10
2020-03-18,970,111,6,832,152,9,540,76,4,,,,150,23,0,483,100,1,US_NY_36081,2768,661,19
2020-03-19,1209,147,6,1065,160,6,554,91,4,,,,258,32,4,620,122,4,US_NY_36081,3833,821,25
2020-03-20,1140,186,10,1184,223,9,657,110,11,,,,309,30,3,719,111,13,US_NY_36081,5017,1044,34
2020-03-21,558,172,12,945,223,14,402,115,5,,,,248,34,1,483,152,12,US_NY_36081,5962,1267,48
2020-03-22,757,182,10,695,223,14,322,126,8,,,,316,32,6,491,163,12,US_NY_36081,6657,1490,62
2020-03-23,911,276,27,1189,332,28,538,174,7,,,,209,46,8,723,207,12,US_NY_36081,7846,1822,90
2020-03-24,1211,300,23,1389,361,34,628,188,17,,,,349,48,6,927,253,14,US_NY_36081,9235,2183,124
2020-03-25,1232,371,36,1571,398,30,594,185,20,,,,394,49,4,1054,289,30,US_NY_36081,10806,2581,154
2020-03-26,1357,441,49,1640,424,56,627,214,34,,,,403,47,10,999,306,37,US_NY_36081,12446,3005,210
2020-03-27,1406,400,73,1574,411,56,659,202,41,,,,371,57,7,1087,306,34,US_NY_36081,14020,3416,266
2020-03-28,849,354,75,1202,435,89,387,204,28,,,,266,53,13,763,301,61,US_NY_36081,15222,3851,355
2020-03-29,1121,412,87,1075,452,92,408,160,35,,,,230,57,17,699,310,54,US_NY_36081,16297,4303,447
2020-03-30,1747,496,106,1838,548,96,826,265,35,,,,397,68,10,1310,322,74,US_NY_36081,18135,4851,543
2020-03-31,1494,472,122,1790,552,93,642,224,43,,,,234,69,21,1285,357,93,US_NY_36081,19925,5403,636
2020-04-01,1593,468,131,1765,522,135,588,176,60,,,,263,73,16,1237,340,90,US_NY_36081,21690,5925,771
2020-04-02,1639,404,163,1811,562,134,659,230,63,,,,370,79,30,1284,339,95,US_NY_36081,23501,6487,905
2020-04-03,1443,403,136,1752,517,154,688,259,52,,,,344,64,29,1445,354,114,US_NY_36081,25253,7004,1059
2020-04-04,917,342,152,1199,465,148,391,198,63,,,,347,51,20,1007,283,106,US_NY_36081,26452,7469,1207
2020-04-05,1150,373,162,1136,387,177,358,183,86,,,,323,65,22,818,318,122,US_NY_36081,27588,7856,1384
2020-04-06,1501,466,164,1914,530,199,719,260,69,,,,730,81,24,1512,383,109,US_NY_36081,29502,8386,1583
2020-04-07,1417,480,177,1943,521,180,607,195,90,,,,629,70,28,1466,333,114,US_NY_36081,31445,8907,1763
2020-04-08,1323,421,170,1846,509,172,557,177,65,,,,560,56,34,1295,370,106,US_NY_36081,33291,9416,1935
2020-04-09,1369,413,186,1557,455,156,567,201,64,,,,297,56,25,1280,302,108,US_NY_36081,34848,9871,2091
2020-04-10,1153,339,168,1326,444,146,505,195,68,,,,300,54,19,1232,304,118,US_NY_36081,36174,10315,2237
2020-04-11,1126,300,155,982,352,155,315,134,59,,,,312,48,27,993,266,132,US_NY_36081,37156,10667,2392
2020-04-12,701,260,199,920,307,163,254,143,63,,,,252,45,26,758,237,106,US_NY_36081,38076,10974,2555
2020-04-13,1063,340,157,974,350,178,394,187,73,,,,185,56,25,693,279,118,US_NY_36081,39050,11324,2733
2020-04-14,1035,274,153,1299,382,160,445,161,59,,,,290,52,24,1074,216,109,US_NY_36081,40349,11706,2893
2020-04-15,883,282,128,1177,300,139,435,146,55,,,,317,33,24,1063,222,92,US_NY_36081,41526,12006,3032
2020-04-16,884,247,123,1139,287,121,360,110,58,,,,210,38,14,932,199,84,US_NY_36081,42665,12293,3153
2020-04-17,958,258,116,1097,285,110,333,125,42,,,,280,38,15,910,194,85,US_NY_36081,43762,12578,3263
2020-04-18,574,175,113,704,213,116,188,89,56,,,,153,25,19,548,156,58,US_NY_36081,44466,12791,3379
2020-04-19,635,140,114,867,187,120,178,84,48,,,,134,30,19,530,150,74,US_NY_36081,45333,12978,3499
2020-04-20,980,213,94,1220,221,113,384,94,50,,,,224,29,16,975,164,77,US_NY_36081,46553,13199,3612
2020-04-21,899,174,91,934,210,87,374,100,47,,,,216,27,11,637,148,68,US_NY_36081,47487,13409,3699
2020-04-22,854,161,104,1109,177,76,387,110,38,,,,173,20,14,922,131,67,US_NY_36081,48596,13586,3775
2020-04-23,790,160,106,787,152,86,402,69,47,,,,128,19,13,732,130,57,US_NY_36081,49383,13738,3861
2020-04-24,628,141,93,774,165,81,413,94,50,,,,143,34,13,579,115,61,US_NY_36081,50157,13903,3942
2020-04-25,404,105,75,540,116,65,149,52,42,,,,88,26,9,412,101,53,US_NY_36081,50697,14019,4007
2020-04-26,332,88,60,332,126,78,99,51,33,,,,46,23,7,194,87,52,US_NY_36081,51029,14145,4085
2020-04-27,610,117,87,721,122,80,304,72,29,,,,107,20,9,545,114,53,US_NY_36081,51750,14267,4165
2020-04-28,715,123,57,893,119,63,324,72,36,,,,129,19,8,668,109,55,US_NY_36081,52643,14386,4228
2020-04-29,682,120,72,692,118,74,286,53,33,,,,124,19,14,556,97,40,US_NY_36081,53335,14504,4302
2020-04-30,599,96,65,592,112,57,218,42,34,,,,130,19,11,478,70,45,US_NY_36081,53927,14616,4359
2020-05-01,496,88,56,620,108,73,245,49,24,,,,77,12,8,441,92,45,US_NY_36081,54547,14724,4432
2020-05-02,264,63,46,333,88,58,141,29,23,,,,60,18,12,259,63,49,US_NY_36081,54880,14812,4490
2020-05-03,248,62,46,248,79,48,104,43,35,,,,35,15,15,150,57,27,US_NY_36081,55128,14891,4538
2020-05-04,463,90,42,432,82,49,214,54,19,,,,90,15,8,347,68,35,US_NY_36081,55560,14973,4587
2020-05-05,434,77,49,462,66,43,243,42,18,,,,78,12,12,294,85,27,US_NY_36081,56022,15039,4630
2020-05-06,451,76,38,443,66,53,166,36,17,,,,60,7,8,281,71,28,US_NY_36081,56465,15105,4683
2020-05-07,401,87,45,356,65,36,118,34,22,,,,60,7,3,294,59,27,US_NY_36081,56821,15170,4719
2020-05-08,349,79,42,342,53,45,100,41,13,,,,42,10,5,252,71,21,US_NY_36081,57163,15223,4764
2020-05-09,121,57,28,256,42,30,74,29,16,,,,32,7,3,177,47,21,US_NY_36081,57419,15265,4794
2020-05-10,191,43,25,85,38,30,94,28,20,,,,14,5,8,75,36,13,US_NY_36081,57504,15303,4824
2020-05-11,409,77,32,376,71,24,192,40,13,,,,27,4,3,227,53,27,US_NY_36081,57880,15374,4848
2020-05-12,400,57,33,314,54,15,163,30,14,,,,53,8,6,354,52,20,US_NY_36081,58194,15428,4863
2020-05-13,364,68,22,304,51,24,155,42,8,,,,48,9,6,454,49,15,US_NY_36081,58498,15479,4887
2020-05-14,332,61,14,333,63,21,149,32,16,,,,41,13,6,255,47,9,US_NY_36081,58831,15542,4908
2020-05-15,260,60,26,265,64,25,137,43,12,,,,33,7,6,177,54,16,US_NY_36081,59096,15606,4933
2020-05-16,164,48,23,135,60,20,56,18,9,,,,25,9,2,110,30,27,US_NY_36081,59231,15666,4953
2020-05-17,138,37,18,107,38,24,50,19,11,,,,10,4,2,56,25,19,US_NY_36081,59338,15704,4977
2020-05-18,270,59,15,274,49,17,133,31,10,,,,38,4,2,185,35,11,US_NY_36081,59612,15753,4994
2020-05-19,331,65,16,288,50,11,168,39,10,,,,42,8,5,177,42,11,US_NY_36081,59900,15803,5005
2020-05-20,326,49,20,247,45,22,165,25,12,,,,56,6,7,276,39,15,US_NY_36081,60147,15848,5027
2020-05-21,345,66,15,307,38,9,146,26,6,,,,77,10,3,192,32,12,US_NY_36081,60454,15886,5036
2020-05-22,387,61,13,226,51,28,156,35,5,,,,32,7,5,259,42,12,US_NY_36081,60680,15937,5064
2020-05-23,163,34,20,130,44,14,47,21,7,,,,37,6,2,87,25,17,US_NY_36081,60810,15981,5078
2020-05-24,181,35,12,118,28,11,70,28,6,,,,14,4,5,96,26,13,US_NY_36081,60928,16009,5089
2020-05-25,174,33,14,106,46,12,71,26,12,,,,17,5,3,97,31,8,US_NY_36081,61034,16055,5101
2020-05-26,338,34,10,261,45,9,126,27,7,,,,56,3,1,270,41,10,US_NY_36081,61295,16100,5110
2020-05-27,260,53,11,164,53,18,111,28,9,,,,44,3,2,172,25,9,US_NY_36081,61459,16153,5128
2020-05-28,227,48,13,172,33,9,95,29,3,,,,26,8,1,110,23,12,US_NY_36081,61631,16186,5137
2020-05-29,177,31,16,209,46,14,79,30,5,,,,26,9,2,158,44,6,US_NY_36081,61840,16232,5151
2020-05-30,110,29,10,107,24,17,39,12,12,,,,15,3,1,75,25,12,US_NY_36081,61947,16256,5168
2020-05-31,81,26,11,69,31,15,24,14,5,,,,11,2,2,30,18,6,US_NY_36081,62016,16287,5183
2020-06-01,253,37,10,139,35,14,81,23,3,,,,39,2,3,151,26,3,US_NY_36081,62155,16322,5197
2020-06-02,200,31,6,160,37,15,72,25,8,,,,33,6,1,110,26,7,US_NY_36081,62315,16359,5212
2020-06-03,144,39,13,146,26,8,78,25,7,,,,42,5,3,100,19,10,US_NY_36081,62461,16385,5220
2020-06-04,144,31,9,137,15,10,89,15,7,,,,28,1,2,113,26,3,US_NY_36081,62598,16400,5230
2020-06-05,132,19,6,104,17,5,60,10,7,,,,9,1,1,102,16,7,US_NY_36081,62702,16417,5235
2020-06-06,59,12,9,98,9,10,31,8,3,,,,7,0,0,51,19,11,US_NY_36081,62800,16426,5245
2020-06-07,53,15,5,74,6,10,23,7,1,,,,4,0,1,42,18,7,US_NY_36081,62874,16432,5255
2020-06-08,113,20,12,143,15,13,73,7,2,,,,16,2,0,97,16,10,US_NY_36081,63017,16447,5268
2020-06-09,131,18,7,127,8,9,67,7,7,,,,19,1,2,79,16,5,US_NY_36081,63144,16455,5277
2020-06-10,99,9,11,111,11,7,66,8,2,,,,13,2,2,74,17,8,US_NY_36081,63255,16466,5284
2020-06-11,107,13,5,110,9,7,61,4,2,,,,15,0,1,60,11,5,US_NY_36081,63365,16475,5291
2020-06-12,122,20,6,126,10,7,62,7,3,,,,18,1,0,75,11,5,US_NY_36081,63491,16485,5298
2020-06-13,52,9,4,73,7,1,24,3,2,,,,1,1,1,41,6,4,US_NY_36081,63564,16492,5299
2020-06-14,54,11,6,66,14,6,29,4,2,,,,4,0,2,27,12,6,US_NY_36081,63630,16506,5305
2020-06-15,97,21,4,115,10,3,61,5,2,,,,17,0,1,65,13,4,US_NY_36081,63745,16516,5308
2020-06-16,127,15,6,115,15,7,69,5,2,,,,11,0,0,66,12,3,US_NY_36081,63860,16531,5315
2020-06-17,92,13,4,86,12,7,57,4,3,,,,12,0,0,61,12,2,US_NY_36081,63946,16543,5322
2020-06-18,87,12,4,98,14,5,50,4,3,,,,22,0,1,43,7,1,US_NY_36081,64044,16557,5327
2020-06-19,68,21,3,88,3,3,44,4,3,,,,2,0,2,54,7,3,US_NY_36081,64132,16560,5330
2020-06-20,32,10,3,38,5,2,28,5,2,,,,2,0,1,38,6,5,US_NY_36081,64170,16565,5332
2020-06-21,31,11,2,36,7,7,12,3,3,,,,6,2,0,14,6,4,US_NY_36081,64206,16572,5339
2020-06-22,47,8,1,47,4,1,29,5,2,,,,7,1,1,51,7,0,US_NY_36081,64253,16576,5340
2020-06-23,18,1,1,26,5,0,16,0,1,,,,2,1,0,23,3,1,US_NY_36081,64279,16581,5340
2020-06-24,3,0,0,2,0,0,0,0,0,,,,1,0,0,3,0,0,US_NY_36081,64281,16581,5340
2020-02-29,0,4,0,0,0,0,1,2,0,0,2,0,,,,0,3,0,US_NY_36085,0,0,0
2020-03-01,0,0,0,0,1,0,0,0,0,0,2,0,,,,1,1,0,US_NY_36085,0,1,0
2020-03-02,0,4,0,0,0,0,0,4,0,0,5,0,,,,0,9,0,US_NY_36085,0,1,0
2020-03-03,0,5,0,0,1,0,0,2,0,1,5,0,,,,1,7,0,US_NY_36085,0,2,0
2020-03-04,1,5,0,0,2,0,2,6,0,2,3,0,,,,0,6,0,US_NY_36085,0,4,0
2020-03-05,3,5,0,0,1,0,0,6,0,0,6,0,,,,0,2,0,US_NY_36085,0,5,0
2020-03-06,1,3,0,1,2,0,3,3,0,1,5,0,,,,2,5,0,US_NY_36085,1,7,0
2020-03-07,2,6,0,1,0,0,1,4,0,3,3,0,,,,0,2,0,US_NY_36085,2,7,0
2020-03-08,5,9,0,1,0,0,6,1,0,5,5,0,,,,4,2,0,US_NY_36085,3,7,0
2020-03-09,16,15,0,3,3,0,25,12,0,10,8,0,,,,4,11,0,US_NY_36085,6,10,0
2020-03-10,11,13,0,2,5,0,24,13,0,24,23,0,,,,8,8,0,US_NY_36085,8,15,0
2020-03-11,31,15,0,3,3,0,61,21,0,40,30,1,,,,19,20,0,US_NY_36085,11,18,0
2020-03-12,96,26,0,13,5,0,138,11,0,80,29,0,,,,29,16,0,US_NY_36085,24,23,0
2020-03-13,166,36,0,26,3,0,182,27,0,166,48,0,,,,79,34,0,US_NY_36085,50,26,0
2020-03-14,163,36,1,22,8,0,179,28,0,194,57,1,,,,86,26,0,US_NY_36085,72,34,0
2020-03-15,430,43,0,46,16,1,209,30,2,230,64,1,,,,118,34,1,US_NY_36085,118,50,1
2020-03-16,739,83,1,91,17,0,458,40,0,530,106,4,,,,303,65,3,US_NY_36085,209,67,1
2020-03-17,786,98,4,108,21,0,566,57,0,650,108,3,,,,343,65,1,US_NY_36085,317,88,1
2020-03-18,970,111,6,150,23,0,540,76,4,832,152,9,,,,483,100,1,US_NY_36085,467,111,1
2020-03-19,1209,147,6,258,32,4,554,91,4,1065,160,6,,,,620,122,4,US_NY_36085,725,143,5
2020-03-20,1140,186,10,309,30,3,657,110,11,1184,223,9,,,,719,111,13,US_NY_36085,1034,173,8
2020-03-21,558,172,12,248,34,1,402,115,5,945,223,14,,,,483,152,12,US_NY_36085,1282,207,9
2020-03-22,757,182,10,316,32,6,322,126,8,695,223,14,,,,491,163,12,US_NY_36085,1598,239,15
2020-03-23,911,276,27,209,46,8,538,174,7,1189,332,28,,,,723,207,12,US_NY_36085,1807,285,23
2020-03-24,1211,300,23,349,48,6,628,188,17,1389,361,34,,,,927,253,14,US_NY_36085,2156,333,29
2020-03-25,1232,371,36,394,49,4,594,185,20,1571,398,30,,,,1054,289,30,US_NY_36085,2550,382,33
2020-03-26,1357,441,49,403,47,10,627,214,34,1640,424,56,,,,999,306,37,US_NY_36085,2953,429,43
2020-03-27,1406,400,73,371,57,7,659,202,41,1574,411,56,,,,1087,306,34,US_NY_36085,3324,486,50
2020-03-28,849,354,75,266,53,13,387,204,28,1202,435,89,,,,763,301,61,US_NY_36085,3590,539,63
2020-03-29,1121,412,87,230,57,17,408,160,35,1075,452,92,,,,699,310,54,US_NY_36085,3820,596,80
2020-03-30,1747,496,106,397,68,10,826,265,35,1838,548,96,,,,1310,322,74,US_NY_36085,4217,664,90
2020-03-31,1494,472,122,234,69,21,642,224,43,1790,552,93,,,,1285,357,93,US_NY_36085,4451,733,111
2020-04-01,1593,468,131,263,73,16,588,176,60,1765,522,135,,,,1237,340,90,US_NY_36085,4714,806,127
2020-04-02,1639,404,163,370,79,30,659,230,63,1811,562,134,,,,1284,339,95,US_NY_36085,5084,885,157
2020-04-03,1443,403,136,344,64,29,688,259,52,1752,517,154,,,,1445,354,114,US_NY_36085,5428,949,186
2020-04-04,917,342,152,347,51,20,391,198,63,1199,465,148,,,,1007,283,106,US_NY_36085,5775,1000,206
2020-04-05,1150,373,162,323,65,22,358,183,86,1136,387,177,,,,818,318,122,US_NY_36085,6098,1065,228
2020-04-06,1501,466,164,730,81,24,719,260,69,1914,530,199,,,,1512,383,109,US_NY_36085,6828,1146,252
2020-04-07,1417,480,177,629,70,28,607,195,90,1943,521,180,,,,1466,333,114,US_NY_36085,7457,1216,280
2020-04-08,1323,421,170,560,56,34,557,177,65,1846,509,172,,,,1295,370,106,US_NY_36085,8017,1272,314
2020-04-09,1369,413,186,297,56,25,567,201,64,1557,455,156,,,,1280,302,108,US_NY_36085,8314,1328,339
2020-04-10,1153,339,168,300,54,19,505,195,68,1326,444,146,,,,1232,304,118,US_NY_36085,8614,1382,358
2020-04-11,1126,300,155,312,48,27,315,134,59,982,352,155,,,,993,266,132,US_NY_36085,8926,1430,385
2020-04-12,701,260,199,252,45,26,254,143,63,920,307,163,,,,758,237,106,US_NY_36085,9178,1475,411
2020-04-13,1063,340,157,185,56,25,394,187,73,974,350,178,,,,693,279,118,US_NY_36085,9363,1531,436
2020-04-14,1035,274,153,290,52,24,445,161,59,1299,382,160,,,,1074,216,109,US_NY_36085,9653,1583,460
2020-04-15,883,282,128,317,33,24,435,146,55,1177,300,139,,,,1063,222,92,US_NY_36085,9970,1616,484
2020-04-16,884,247,123,210,38,14,360,110,58,1139,287,121,,,,932,199,84,US_NY_36085,10180,1654,498
2020-04-17,958,258,116,280,38,15,333,125,42,1097,285,110,,,,910,194,85,US_NY_36085,10460,1692,513
2020-04-18,574,175,113,153,25,19,188,89,56,704,213,116,,,,548,156,58,US_NY_36085,10613,1717,532
2020-04-19,635,140,114,134,30,19,178,84,48,867,187,120,,,,530,150,74,US_NY_36085,10747,1747,551
2020-04-20,980,213,94,224,29,16,384,94,50,1220,221,113,,,,975,164,77,US_NY_36085,10971,1776,567
2020-04-21,899,174,91,216,27,11,374,100,47,934,210,87,,,,637,148,68,US_NY_36085,11187,1803,578
2020-04-22,854,161,104,173,20,14,387,110,38,1109,177,76,,,,922,131,67,US_NY_36085,11360,1823,592
2020-04-23,790,160,106,128,19,13,402,69,47,787,152,86,,,,732,130,57,US_NY_36085,11488,1842,605
2020-04-24,628,141,93,143,34,13,413,94,50,774,165,81,,,,579,115,61,US_NY_36085,11631,1876,618
2020-04-25,404,105,75,88,26,9,149,52,42,540,116,65,,,,412,101,53,US_NY_36085,11719,1902,627
2020-04-26,332,88,60,46,23,7,99,51,33,332,126,78,,,,194,87,52,US_NY_36085,11765,1925,634
2020-04-27,610,117,87,107,20,9,304,72,29,721,122,80,,,,545,114,53,US_NY_36085,11872,1945,643
2020-04-28,715,123,57,129,19,8,324,72,36,893,119,63,,,,668,109,55,US_NY_36085,12001,1964,651
2020-04-29,682,120,72,124,19,14,286,53,33,692,118,74,,,,556,97,40,US_NY_36085,12125,1983,665
2020-04-30,599,96,65,130,19,11,218,42,34,592,112,57,,,,478,70,45,US_NY_36085,12255,2002,676
2020-05-01,496,88,56,77,12,8,245,49,24,620,108,73,,,,441,92,45,US_NY_36085,12332,2014,684
2020-05-02,264,63,46,60,18,12,141,29,23,333,88,58,,,,259,63,49,US_NY_36085,12392,2032,696
2020-05-03,248,62,46,35,15,15,104,43,35,248,79,48,,,,150,57,27,US_NY_36085,12427,2047,711
2020-05-04,463,90,42,90,15,8,214,54,19,432,82,49,,,,347,68,35,US_NY_36085,12517,2062,719
2020-05-05,434,77,49,78,12,12,243,42,18,462,66,43,,,,294,85,27,US_NY_36085,12595,2074,731
2020-05-06,451,76,38,60,7,8,166,36,17,443,66,53,,,,281,71,28,US_NY_36085,12655,2081,739
2020-05-07,401,87,45,60,7,3,118,34,22,356,65,36,,,,294,59,27,US_NY_36085,12715,2088,742
2020-05-08,349,79,42,42,10,5,100,41,13,342,53,45,,,,252,71,21,US_NY_36085,12757,2098,747
2020-05-09,121,57,28,32,7,3,74,29,16,256,42,30,,,,177,47,21,US_NY_36085,12789,2105,750
2020-05-10,191,43,25,14,5,8,94,28,20,85,38,30,,,,75,36,13,US_NY_36085,12803,2110,758
2020-05-11,409,77,32,27,4,3,192,40,13,376,71,24,,,,227,53,27,US_NY_36085,12830,2114,761
2020-05-12,400,57,33,53,8,6,163,30,14,314,54,15,,,,354,52,20,US_NY_36085,12883,2122,767
2020-05-13,364,68,22,48,9,6,155,42,8,304,51,24,,,,454,49,15,US_NY_36085,12931,2131,773
2020-05-14,332,61,14,41,13,6,149,32,16,333,63,21,,,,255,47,9,US_NY_36085,12972,2144,779
2020-05-15,260,60,26,33,7,6,137,43,12,265,64,25,,,,177,54,16,US_NY_36085,13005,2151,785
2020-05-16,164,48,23,25,9,2,56,18,9,135,60,20,,,,110,30,27,US_NY_36085,13030,2160,787
2020-05-17,138,37,18,10,4,2,50,19,11,107,38,24,,,,56,25,19,US_NY_36085,13040,2164,789
2020-05-18,270,59,15,38,4,2,133,31,10,274,49,17,,,,185,35,11,US_NY_36085,13078,2168,791
2020-05-19,331,65,16,42,8,5,168,39,10,288,50,11,,,,177,42,11,US_NY_36085,13120,2176,796
2020-05-20,326,49,20,56,6,7,165,25,12,247,45,22,,,,276,39,15,US_NY_36085,13176,2182,803
2020-05-21,345,66,15,77,10,3,146,26,6,307,38,9,,,,192,32,12,US_NY_36085,13253,2192,806
2020-05-22,387,61,13,32,7,5,156,35,5,226,51,28,,,,259,42,12,US_NY_36085,13285,2199,811
2020-05-23,163,34,20,37,6,2,47,21,7,130,44,14,,,,87,25,17,US_NY_36085,13322,2205,813
2020-05-24,181,35,12,14,4,5,70,28,6,118,28,11,,,,96,26,13,US_NY_36085,13336,2209,818
2020-05-25,174,33,14,17,5,3,71,26,12,106,46,12,,,,97,31,8,US_NY_36085,13353,2214,821
2020-05-26,338,34,10,56,3,1,126,27,7,261,45,9,,,,270,41,10,US_NY_36085,13409,2217,822
2020-05-27,260,53,11,44,3,2,111,28,9,164,53,18,,,,172,25,9,US_NY_36085,13453,2220,824
2020-05-28,227,48,13,26,8,1,95,29,3,172,33,9,,,,110,23,12,US_NY_36085,13479,2228,825
2020-05-29,177,31,16,26,9,2,79,30,5,209,46,14,,,,158,44,6,US_NY_36085,13505,2237,827
2020-05-30,110,29,10,15,3,1,39,12,12,107,24,17,,,,75,25,12,US_NY_36085,13520,2240,828
2020-05-31,81,26,11,11,2,2,24,14,5,69,31,15,,,,30,18,6,US_NY_36085,13531,2242,830
2020-06-01,253,37,10,39,2,3,81,23,3,139,35,14,,,,151,26,3,US_NY_36085,13570,2244,833
2020-06-02,200,31,6,33,6,1,72,25,8,160,37,15,,,,110,26,7,US_NY_36085,13603,2250,834
2020-06-03,144,39,13,42,5,3,78,25,7,146,26,8,,,,100,19,10,US_NY_36085,13645,2255,837
2020-06-04,144,31,9,28,1,2,89,15,7,137,15,10,,,,113,26,3,US_NY_36085,13673,2256,839
2020-06-05,132,19,6,9,1,1,60,10,7,104,17,5,,,,102,16,7,US_NY_36085,13682,2257,840
2020-06-06,59,12,9,7,0,0,31,8,3,98,9,10,,,,51,19,11,US_NY_36085,13689,2257,840
2020-06-07,53,15,5,4,0,1,23,7,1,74,6,10,,,,42,18,7,US_NY_36085,13693,2257,841
2020-06-08,113,20,12,16,2,0,73,7,2,143,15,13,,,,97,16,10,US_NY_36085,13709,2259,841
2020-06-09,131,18,7,19,1,2,67,7,7,127,8,9,,,,79,16,5,US_NY_36085,13728,2260,843
2020-06-10,99,9,11,13,2,2,66,8,2,111,11,7,,,,74,17,8,US_NY_36085,13741,2262,845
2020-06-11,107,13,5,15,0,1,61,4,2,110,9,7,,,,60,11,5,US_NY_36085,13756,2262,846
2020-06-12,122,20,6,18,1,0,62,7,3,126,10,7,,,,75,11,5,US_NY_36085,13774,2263,846
2020-06-13,52,9,4,1,1,1,24,3,2,73,7,1,,,,41,6,4,US_NY_36085,13775,2264,847
2020-06-14,54,11,6,4,0,2,29,4,2,66,14,6,,,,27,12,6,US_NY_36085,13779,2264,849
2020-06-15,97,21,4,17,0,1,61,5,2,115,10,3,,,,65,13,4,US_NY_36085,13796,2264,850
2020-06-16,127,15,6,11,0,0,69,5,2,115,15,7,,,,66,12,3,US_NY_36085,13807,2264,850
2020-06-17,92,13,4,12,0,0,57,4,3,86,12,7,,,,61,12,2,US_NY_36085,13819,2264,850
2020-06-18,87,12,4,22,0,1,50,4,3,98,14,5,,,,43,7,1,US_NY_36085,13841,2264,851
2020-06-19,68,21,3,2,0,2,44,4,3,88,3,3,,,,54,7,3,US_NY_36085,13843,2264,853
2020-06-20,32,10,3,2,0,1,28,5,2,38,5,2,,,,38,6,5,US_NY_36085,13845,2264,854
2020-06-21,31,11,2,6,2,0,12,3,3,36,7,7,,,,14,6,4,US_NY_36085,13851,2266,854
2020-06-22,47,8,1,7,1,1,29,5,2,47,4,1,,,,51,7,0,US_NY_36085,13858,2267,855
2020-06-23,18,1,1,2,1,0,16,0,1,26,5,0,,,,23,3,1,US_NY_36085,13860,2268,855
2020-06-24,3,0,0,1,0,0,0,0,0,2,0,0,,,,3,0,0,US_NY_36085,13861,2268,855
